Date,Time,Name,Amount,Location,Zip,Balance,Fraud
2012-01-01,08:00:00,Paycheck,3000.0,Oviedo FL,32765,6745.87,0
2012-01-01,09:00:00,Rent,-1428.57,Oviedo FL,32765,5317.3,0
2012-01-01,09:00:00,Insurance,-200.0,Oviedo FL,32765,5117.3,0
2012-01-01,09:00:00,Car,-281.69,Oviedo FL,32765,4835.61,0
2012-01-01,09:00:00,Utilities,-142.86,Oviedo FL,32765,4692.75,0
2012-01-01,16:55:00,AutoZone,-135.39,Winter Park FL,32789,4557.36,0
2012-01-01,04:14:00,CVS,-7.74,Oviedo FL,32765,4549.62,0
2012-01-01,11:14:00,Kroger,-74.38,Winter Park FL,32789,4475.24,0
2012-01-01,11:44:00,Five Below,-19.41,Winter Park FL,32789,4455.83,0
2012-01-01,14:05:00,Amazon,-110.33,Winter Park FL,32789,4345.5,0
2012-01-02,13:21:00,Qdoba,-20.52,Orlando FL,32816,4324.98,0
2012-01-02,06:38:00,Qdoba,-42.56,Orlando FL,32816,4282.42,0
2012-01-02,17:05:00,Five Below,-47.76,Winter Park FL,32789,4234.66,0
2012-01-04,02:39:00,Exxon,-12.56,Orlando FL,32816,4222.1,0
2012-01-04,02:47:00,Walmart,-122.74,Winter Park FL,32789,4099.36,0
2012-01-05,18:11:00,Movie Rental,-63.03,Orlando FL,32816,4036.33,0
2012-01-07,09:00:00,Spotify,-12.0,Oviedo FL,32765,4024.33,0
2012-01-07,09:00:00,Internet,-70.0,Oviedo FL,32765,3954.33,0
2012-01-07,09:00:00,Streaming,-23.81,Oviedo FL,32765,3930.52,0
2012-01-08,04:56:00,7-Eleven,-27.14,Winter Park FL,32789,3903.38,0
2012-01-08,09:01:00,Subway,-44.75,Winter Park FL,32789,3858.63,0
2012-01-08,18:28:00,Petco,-15.68,Winter Park FL,32789,3842.95,0
2012-01-08,17:56:00,BP,-18.99,Winter Park FL,32789,3823.96,0
2012-01-10,12:39:00,Five Below,-19.19,Orlando FL,32816,3804.77,0
2012-01-10,04:48:00,McDonald's,-16.44,Orlando FL,32816,3788.33,0
2012-01-10,16:01:00,Subway,-23.18,Orlando FL,32816,3765.15,0
2012-01-11,12:47:00,Whole Foods,-50.6,Orlando FL,32816,3714.55,0
2012-01-11,15:17:00,Panera,-32.89,Oviedo FL,32765,3681.66,0
2012-01-11,06:19:00,Lowes Foods,-69.39,Oviedo FL,32765,3612.27,0
2012-01-11,08:10:00,Subway,-36.83,Oviedo FL,32765,3575.44,0
2012-01-11,09:07:00,Publix,-68.08,Orlando FL,32816,3507.36,0
2012-01-12,09:47:00,7-Eleven,-13.22,Orlando FL,32816,3494.14,0
2012-01-12,08:17:00,Petco,-129.89,Orlando FL,32816,3364.25,0
2012-01-13,10:38:00,Pep Boys,-212.63,Winter Park FL,32789,3151.62,0
2012-01-13,07:23:00,Disney World,-18.52,Orlando FL,32816,3133.1,0
2012-01-13,10:18:00,Kroger,-62.24,Winter Park FL,32789,3070.86,0
2012-01-13,04:46:00,7-Eleven,-17.23,Oviedo FL,32765,3053.63,0
2012-01-13,09:58:00,Disney World,-53.18,Orlando FL,32816,3000.45,0
2012-01-14,00:40:00,Movie Theater,-26.73,Winter Park FL,32789,2973.72,0
2012-01-14,12:55:00,Shell,-21.08,Oviedo FL,32765,2952.64,0
2012-01-15,08:00:00,Paycheck,3000.0,Oviedo FL,32765,5952.64,0
2012-01-15,18:49:00,Starbucks,-31.93,Orlando FL,32816,5920.71,0
2012-01-16,01:33:00,Panera,-41.39,Winter Park FL,32789,5879.32,0
2012-01-16,13:53:00,Starbucks,-36.7,Oviedo FL,32765,5842.62,0
2012-01-16,11:14:00,Movie Rental,-60.14,Oviedo FL,32765,5782.48,0
2012-01-16,04:44:00,Online,-793.66,London EN,96839,4988.82,1
2012-01-17,02:09:00,Qdoba,-26.51,Winter Park FL,32789,5755.97,0
2012-01-18,03:45:00,Smoothie King,-21.42,Orlando FL,32816,5734.55,0
2012-01-18,16:02:00,Smoothie King,-13.14,Orlando FL,32816,5721.41,0
2012-01-18,11:51:00,Concert Tickets,-25.69,Winter Park FL,32789,5695.72,0
2012-01-18,14:46:00,Walmart,-46.61,Orlando FL,32816,5649.11,0
2012-01-18,17:26:00,BP,-15.68,Winter Park FL,32789,5633.43,0
2012-01-19,13:03:00,Dollar Tree,-13.87,Oviedo FL,32765,5619.56,0
2012-01-19,11:11:00,Starbucks,-44.43,Winter Park FL,32789,5575.13,0
2012-01-20,01:32:00,Smoothie King,-44.86,Orlando FL,32816,5530.27,0
2012-01-20,00:26:00,Petco,-72.92,Winter Park FL,32789,5457.35,0
2012-01-20,01:43:00,Home Depot,-132.74,Winter Park FL,32789,5324.61,0
2012-01-21,07:14:00,McDonald's,-9.08,Orlando FL,32816,5315.53,0
2012-01-21,03:34:00,AutoZone,-67.66,Orlando FL,32816,5247.87,0
2012-01-21,07:47:00,Home Depot,-143.05,Oviedo FL,32765,5104.82,0
2012-01-23,02:22:00,Five Below,-7.55,Winter Park FL,32789,5097.27,0
2012-01-24,03:17:00,Publix,-112.55,Orlando FL,32816,4984.72,0
2012-01-24,05:10:00,Panera,-44.36,Winter Park FL,32789,4940.36,0
2012-01-24,14:45:00,Petco,-82.73,Orlando FL,32816,4857.63,0
2012-01-25,07:09:00,Walgreens,-13.67,Winter Park FL,32789,4843.96,0
2012-01-25,07:12:00,CVS,-10.16,Oviedo FL,32765,4833.8,0
2012-01-25,00:11:00,Subway,-18.49,Oviedo FL,32765,4815.31,0
2012-01-25,02:10:00,Shell,-13.35,Oviedo FL,32765,4801.96,0
2012-01-25,14:42:00,Take5,-176.07,Winter Park FL,32789,4625.89,0
2012-01-26,00:57:00,Petco,-22.12,Orlando FL,32816,4603.77,0
2012-01-28,00:06:00,CVS,-8.62,Winter Park FL,32789,4595.15,0
2012-01-28,14:28:00,Gamestop,-13.69,Oviedo FL,32765,4581.46,0
2012-01-29,08:00:00,Paycheck,3000.0,Oviedo FL,32765,7581.46,0
2012-01-29,09:38:00,Qdoba,-67.25,Oviedo FL,32765,7514.21,0
2012-01-29,10:50:00,CVS,-28.65,Oviedo FL,32765,7485.56,0
2012-01-29,02:38:00,Starbucks,-64.48,Orlando FL,32816,7421.08,0
2012-01-29,00:12:00,Concert Tickets,-74.03,Winter Park FL,32789,7347.05,0
2012-01-29,13:14:00,Panera,-17.49,Oviedo FL,32765,7329.56,0
2012-01-30,09:11:00,Chevron,-33.33,Winter Park FL,32789,7296.23,0
2012-01-30,02:43:00,Walgreens,-43.55,Oviedo FL,32765,7252.68,0
2012-01-31,09:38:00,Pep Boys,-105.01,Orlando FL,32816,7147.67,0
2012-01-31,04:47:00,Kroger,-60.42,Oviedo FL,32765,7087.25,0
2012-01-31,03:41:00,Starbucks,-41.09,Oviedo FL,32765,7046.16,0
2012-02-01,09:00:00,Rent,-1428.57,Oviedo FL,32765,5617.59,0
2012-02-01,09:00:00,Insurance,-200.0,Oviedo FL,32765,5417.59,0
2012-02-01,09:00:00,Car,-281.69,Oviedo FL,32765,5135.9,0
2012-02-01,09:00:00,Utilities,-142.86,Oviedo FL,32765,4993.04,0
2012-02-01,00:49:00,Petco,-90.6,Winter Park FL,32789,4902.44,0
2012-02-01,13:10:00,Panera,-30.92,Orlando FL,32816,4871.52,0
2012-02-02,10:31:00,Subway,-9.5,Winter Park FL,32789,4862.02,0
2012-02-02,11:05:00,Smoothie King,-30.7,Oviedo FL,32765,4831.32,0
2012-02-02,05:58:00,McDonald's,-32.74,Orlando FL,32816,4798.58,0
2012-02-03,01:29:00,CVS,-34.34,Orlando FL,32816,4764.24,0
2012-02-03,06:48:00,Starbucks,-31.49,Oviedo FL,32765,4732.75,0
2012-02-03,17:58:00,Panera,-28.68,Oviedo FL,32765,4704.07,0
2012-02-03,16:08:00,Best Buy,-31.47,Oviedo FL,32765,4672.6,0
2012-02-03,06:05:00,Trader Joe's,-70.04,Orlando FL,32816,4602.56,0
2012-02-04,05:00:00,Publix,-49.07,Oviedo FL,32765,4553.49,0
2012-02-04,01:43:00,Qdoba,-38.38,Orlando FL,32816,4515.11,0
2012-02-04,11:29:00,Starbucks,-42.46,Oviedo FL,32765,4472.65,0
2012-02-05,04:55:00,Movie Theater,-64.8,Oviedo FL,32765,4407.85,0
2012-02-05,06:03:00,CVS,-18.46,Winter Park FL,32789,4389.39,0
2012-02-05,07:46:00,Movie Rental,-39.43,Winter Park FL,32789,4349.96,0
2012-02-06,08:20:00,BP,-13.88,Winter Park FL,32789,4336.08,0
2012-02-06,12:21:00,Home Depot,-23.74,Oviedo FL,32765,4312.34,0
2012-02-06,07:46:00,Publix,-38.39,Oviedo FL,32765,4273.95,0
2012-02-06,14:46:00,McDonald's,-19.34,Winter Park FL,32789,4254.61,0
2012-02-06,14:50:00,BP,-16.41,Winter Park FL,32789,4238.2,0
2012-02-07,09:00:00,Spotify,-12.0,Oviedo FL,32765,4226.2,0
2012-02-07,09:00:00,Internet,-70.0,Oviedo FL,32765,4156.2,0
2012-02-07,09:00:00,Streaming,-23.81,Oviedo FL,32765,4132.39,0
2012-02-07,15:15:00,Petco,-97.55,Orlando FL,32816,4034.84,0
2012-02-07,13:31:00,Five Below,-12.51,Winter Park FL,32789,4022.33,0
2012-02-07,05:15:00,Concert Tickets,-34.97,Oviedo FL,32765,3987.36,0
2012-02-07,15:09:00,Home Depot,-136.03,Oviedo FL,32765,3851.33,0
2012-02-07,03:24:00,Petco,-90.57,Oviedo FL,32765,3760.76,0
2012-02-08,14:09:00,Starbucks,-20.56,Orlando FL,32816,3740.2,0
2012-02-08,18:59:00,Movie Theater,-17.03,Winter Park FL,32789,3723.17,0
2012-02-08,11:12:00,Walgreens,-43.29,Oviedo FL,32765,3679.88,0
2012-02-08,14:51:00,Concert Tickets,-29.54,Orlando FL,32816,3650.34,0
2012-02-09,01:49:00,Home Depot,-168.65,Orlando FL,32816,3481.69,0
2012-02-10,13:26:00,Panera,-10.54,Oviedo FL,32765,3471.15,0
2012-02-10,07:55:00,BP,-11.93,Winter Park FL,32789,3459.22,0
2012-02-10,04:02:00,Petco,-110.05,Orlando FL,32816,3349.17,0
2012-02-10,14:06:00,Five Below,-21.43,Winter Park FL,32789,3327.74,0
2012-02-10,02:24:00,7-Eleven,-23.4,Winter Park FL,32789,3304.34,0
2012-02-11,13:17:00,Amazon,-77.27,Orlando FL,32816,3227.07,0
2012-02-11,05:15:00,Subway,-33.39,Winter Park FL,32789,3193.68,0
2012-02-11,09:59:00,Midas,-207.46,Oviedo FL,32765,2986.22,0
2012-02-12,08:00:00,Paycheck,3000.0,Oviedo FL,32765,5986.22,0
2012-02-12,15:58:00,Exxon,-13.84,Winter Park FL,32789,5972.38,0
2012-02-12,13:19:00,McDonald's,-34.29,Orlando FL,32816,5938.09,0
2012-02-12,04:11:00,Subway,-23.97,Winter Park FL,32789,5914.12,0
2012-02-12,11:38:00,Lowes Foods,-63.37,Oviedo FL,32765,5850.75,0
2012-02-13,11:05:00,Petco,-160.34,Winter Park FL,32789,5690.41,0
2012-02-13,10:34:00,Publix,-59.9,Winter Park FL,32789,5630.51,0
2012-02-14,09:02:00,Movie Theater,-44.56,Oviedo FL,32765,5585.95,0
2012-02-14,17:39:00,Lowes Foods,-93.88,Orlando FL,32816,5492.07,0
2012-02-15,14:41:00,Panera,-25.39,Winter Park FL,32789,5466.68,0
2012-02-15,10:29:00,Take5,-205.06,Orlando FL,32816,5261.62,0
2012-02-16,07:01:00,Trader Joe's,-93.41,Oviedo FL,32765,5168.21,0
2012-02-16,01:19:00,Qdoba,-41.72,Winter Park FL,32789,5126.49,0
2012-02-18,01:39:00,Lowes Foods,-59.47,Oviedo FL,32765,5067.02,0
2012-02-19,01:22:00,Publix,-80.25,Winter Park FL,32789,4986.77,0
2012-02-19,16:03:00,Dollar Tree,-20.47,Oviedo FL,32765,4966.3,0
2012-02-19,10:24:00,Five Below,-27.05,Oviedo FL,32765,4939.25,0
2012-02-20,09:20:00,Panera,-25.51,Orlando FL,32816,4913.74,0
2012-02-20,13:57:00,Disney World,-49.0,Oviedo FL,32765,4864.74,0
2012-02-21,12:38:00,Smoothie King,-8.98,Oviedo FL,32765,4855.76,0
2012-02-21,04:33:00,Pep Boys,-94.58,Orlando FL,32816,4761.18,0
2012-02-22,16:05:00,7-Eleven,-26.22,Oviedo FL,32765,4734.96,0
2012-02-22,12:47:00,Starbucks,-13.16,Orlando FL,32816,4721.8,0
2012-02-22,03:28:00,Qdoba,-15.74,Winter Park FL,32789,4706.06,0
2012-02-22,02:51:00,Shell,-18.61,Oviedo FL,32765,4687.45,0
2012-02-23,07:25:00,Lowes Foods,-65.77,Winter Park FL,32789,4621.68,0
2012-02-23,00:10:00,Petco,-111.37,Orlando FL,32816,4510.31,0
2012-02-23,03:42:00,7-Eleven,-29.5,Orlando FL,32816,4480.81,0
2012-02-23,03:02:00,Starbucks,-27.92,Oviedo FL,32765,4452.89,0
2012-02-24,05:38:00,Kroger,-63.09,Winter Park FL,32789,4389.8,0
2012-02-24,18:40:00,Subway,-7.72,Orlando FL,32816,4382.08,0
2012-02-24,10:50:00,Panera,-12.06,Oviedo FL,32765,4370.02,0
2012-02-24,14:59:00,Starbucks,-16.77,Oviedo FL,32765,4353.25,0
2012-02-24,07:53:00,Smoothie King,-29.66,Winter Park FL,32789,4323.59,0
2012-02-25,18:08:00,Panera,-12.44,Winter Park FL,32789,4311.15,0
2012-02-25,10:35:00,Take5,-202.06,Winter Park FL,32789,4109.09,0
2012-02-25,03:25:00,7-Eleven,-25.49,Winter Park FL,32789,4083.6,0
2012-02-25,11:08:00,Panera,-9.57,Orlando FL,32816,4074.03,0
2012-02-26,08:00:00,Paycheck,3000.0,Oviedo FL,32765,7074.03,0
2012-02-26,17:22:00,Pep Boys,-269.63,Winter Park FL,32789,6804.4,0
2012-02-26,05:28:00,Target,-61.01,Oviedo FL,32765,6743.39,0
2012-02-26,11:43:00,Take5,-220.48,Orlando FL,32816,6522.91,0
2012-02-27,17:21:00,Qdoba,-46.48,Orlando FL,32816,6476.43,0
2012-02-27,13:27:00,Lowes Foods,-133.94,Winter Park FL,32789,6342.49,0
2012-02-27,10:49:00,Walgreens,-15.92,Oviedo FL,32765,6326.57,0
2012-02-27,07:55:00,Subway,-62.96,Orlando FL,32816,6263.61,0
2012-02-28,02:18:00,Publix,-161.02,Orlando FL,32816,6102.59,0
2012-02-28,17:51:00,Starbucks,-64.68,Oviedo FL,32765,6037.91,0
2012-02-29,03:58:00,Panera,-19.05,Orlando FL,32816,6018.86,0
2012-02-29,09:52:00,Panera,-21.43,Winter Park FL,32789,5997.43,0
2012-02-29,00:18:00,Panera,-9.71,Winter Park FL,32789,5987.72,0
2012-02-29,15:10:00,Wawa,-16.19,Orlando FL,32816,5971.53,0
2012-02-29,07:02:00,CVS,-47.54,Orlando FL,32816,5923.99,0
2012-02-29,00:55:00,Valley,-1201.79,London EN,98803,4722.2,1
2012-03-01,09:00:00,Rent,-1428.57,Oviedo FL,32765,4495.42,0
2012-03-01,09:00:00,Insurance,-200.0,Oviedo FL,32765,4295.42,0
2012-03-01,09:00:00,Car,-281.69,Oviedo FL,32765,4013.73,0
2012-03-01,09:00:00,Utilities,-142.86,Oviedo FL,32765,3870.87,0
2012-03-01,03:04:00,Qdoba,-12.28,Winter Park FL,32789,3858.59,0
2012-03-01,07:10:00,Movie Theater,-31.27,Orlando FL,32816,3827.32,0
2012-03-01,06:55:00,7-Eleven,-20.03,Winter Park FL,32789,3807.29,0
2012-03-01,05:28:00,ComputerPart,-1066.22,London EN,84140,2741.07,1
2012-03-02,05:22:00,Subway,-38.39,Winter Park FL,32789,3768.9,0
2012-03-03,16:49:00,Starbucks,-15.2,Winter Park FL,32789,3753.7,0
2012-03-03,03:07:00,Gamestop,-21.17,Orlando FL,32816,3732.53,0
2012-03-03,12:13:00,Starbucks,-21.83,Oviedo FL,32765,3710.7,0
2012-03-03,00:55:00,Best Buy,-45.23,Winter Park FL,32789,3665.47,0
2012-03-03,16:00:00,Movie Rental,-63.03,Orlando FL,32816,3602.44,0
2012-03-04,05:49:00,Exxon,-13.92,Winter Park FL,32789,3588.52,0
2012-03-04,13:30:00,Concert Tickets,-67.4,Orlando FL,32816,3521.12,0
2012-03-04,06:21:00,Movie Rental,-54.49,Orlando FL,32816,3466.63,0
2012-03-04,08:21:00,Qdoba,-35.34,Oviedo FL,32765,3431.29,0
2012-03-04,16:53:00,Qdoba,-18.95,Winter Park FL,32789,3412.34,0
2012-03-04,00:25:00,ComputerPart,-553.08,Mexico City MC,22972,2859.26,1
2012-03-05,01:44:00,Starbucks,-40.29,Oviedo FL,32765,3372.05,0
2012-03-05,14:47:00,Wawa,-28.08,Winter Park FL,32789,3343.97,0
2012-03-06,01:49:00,Movie Theater,-42.21,Orlando FL,32816,3301.76,0
2012-03-06,03:21:00,Walmart,-52.28,Winter Park FL,32789,3249.48,0
2012-03-06,15:21:00,Amazon,-121.19,Orlando FL,32816,3128.29,0
2012-03-06,17:58:00,Movie Rental,-11.48,Oviedo FL,32765,3116.81,0
2012-03-07,09:00:00,Spotify,-12.0,Oviedo FL,32765,3104.81,0
2012-03-07,09:00:00,Internet,-70.0,Oviedo FL,32765,3034.81,0
2012-03-07,09:00:00,Streaming,-23.81,Oviedo FL,32765,3011.0,0
2012-03-07,13:10:00,CVS,-18.79,Oviedo FL,32765,2992.21,0
2012-03-07,14:07:00,CVS,-36.63,Orlando FL,32816,2955.58,0
2012-03-07,10:50:00,Whole Foods,-82.83,Oviedo FL,32765,2872.75,0
2012-03-07,01:53:00,Online,-161.33,London EN,94704,2711.42,1
2012-03-08,04:32:00,Target,-55.94,Orlando FL,32816,2816.81,0
2012-03-08,05:11:00,Kroger,-107.3,Orlando FL,32816,2709.51,0
2012-03-08,11:22:00,Qdoba,-39.75,Oviedo FL,32765,2669.76,0
2012-03-08,09:36:00,Petco,-55.44,Oviedo FL,32765,2614.32,0
2012-03-09,15:10:00,Walgreens,-32.01,Oviedo FL,32765,2582.31,0
2012-03-09,11:15:00,Publix,-82.15,Winter Park FL,32789,2500.16,0
2012-03-10,15:05:00,Disney World,-24.92,Oviedo FL,32765,2475.24,0
2012-03-11,08:00:00,Paycheck,3000.0,Oviedo FL,32765,5475.24,0
2012-03-11,18:34:00,Lowes Foods,-98.93,Orlando FL,32816,5376.31,0
2012-03-11,03:05:00,BP,-18.16,Winter Park FL,32789,5358.15,0
2012-03-13,06:29:00,McDonald's,-24.83,Oviedo FL,32765,5333.32,0
2012-03-13,18:52:00,Walgreens,-45.36,Winter Park FL,32789,5287.96,0
2012-03-13,14:23:00,Exxon,-25.19,Winter Park FL,32789,5262.77,0
2012-03-13,17:57:00,Movie Rental,-42.59,Winter Park FL,32789,5220.18,0
2012-03-13,05:11:00,Paypal,-830.06,Charleston SC,50357,4390.12,1
2012-03-14,11:49:00,Subway,-12.83,Orlando FL,32816,5207.35,0
2012-03-15,05:35:00,Trader Joe's,-97.34,Orlando FL,32816,5110.01,0
2012-03-16,11:57:00,Walmart,-52.69,Oviedo FL,32765,5057.32,0
2012-03-16,01:46:00,Panera,-24.03,Orlando FL,32816,5033.29,0
2012-03-16,11:42:00,Dollar Tree,-35.81,Orlando FL,32816,4997.48,0
2012-03-16,14:42:00,Subway,-40.16,Winter Park FL,32789,4957.32,0
2012-03-17,08:59:00,Walmart,-146.7,Oviedo FL,32765,4810.62,0
2012-03-17,16:05:00,Trader Joe's,-50.04,Orlando FL,32816,4760.58,0
2012-03-18,00:47:00,Subway,-41.92,Winter Park FL,32789,4718.66,0
2012-03-18,05:30:00,ComputerPart,-1301.98,Mexico City MC,96474,3416.68,1
2012-03-19,12:24:00,Walmart,-112.09,Oviedo FL,32765,4606.57,0
2012-03-19,02:12:00,Five Below,-42.85,Orlando FL,32816,4563.72,0
2012-03-19,17:48:00,Midas,-180.64,Orlando FL,32816,4383.08,0
2012-03-21,04:55:00,Amazon,-40.78,Winter Park FL,32789,4342.3,0
2012-03-21,16:59:00,Best Buy,-23.65,Orlando FL,32816,4318.65,0
2012-03-21,01:48:00,Online,-656.77,Tokyo JP,32997,3661.88,1
2012-03-22,04:21:00,Starbucks,-19.38,Oviedo FL,32765,4299.27,0
2012-03-22,14:07:00,Lowes Foods,-87.08,Oviedo FL,32765,4212.19,0
2012-03-22,10:03:00,Panera,-33.39,Orlando FL,32816,4178.8,0
2012-03-22,18:15:00,Movie Rental,-44.77,Orlando FL,32816,4134.03,0
2012-03-23,13:49:00,Subway,-9.65,Orlando FL,32816,4124.38,0
2012-03-25,08:00:00,Paycheck,3000.0,Oviedo FL,32765,7124.38,0
2012-03-26,13:45:00,Movie Theater,-98.4,Winter Park FL,32789,7025.98,0
2012-03-26,05:02:00,Chevron,-36.12,Oviedo FL,32765,6989.86,0
2012-03-26,14:39:00,Disney World,-22.17,Oviedo FL,32765,6967.69,0
2012-03-26,07:52:00,CVS,-73.45,Oviedo FL,32765,6894.24,0
2012-03-27,14:11:00,McDonald's,-31.06,Orlando FL,32816,6863.18,0
2012-03-27,06:46:00,Panera,-58.55,Winter Park FL,32789,6804.63,0
2012-03-27,03:53:00,Whole Foods,-123.19,Oviedo FL,32765,6681.44,0
2012-03-27,06:28:00,Starbucks,-57.43,Oviedo FL,32765,6624.01,0
2012-03-27,12:53:00,Concert Tickets,-44.43,Winter Park FL,32789,6579.58,0
2012-03-28,04:06:00,Panera,-35.97,Orlando FL,32816,6543.61,0
2012-03-28,18:42:00,Trader Joe's,-158.62,Oviedo FL,32765,6384.99,0
2012-03-28,04:21:00,Gamestop,-82.9,Orlando FL,32816,6302.09,0
2012-03-29,15:28:00,Valvoline,-134.23,Oviedo FL,32765,6167.86,0
2012-03-30,02:46:00,Home Depot,-177.52,Orlando FL,32816,5990.34,0
2012-03-30,02:26:00,Subway,-24.91,Orlando FL,32816,5965.43,0
2012-03-30,11:49:00,BP,-31.85,Oviedo FL,32765,5933.58,0
2012-03-31,09:38:00,Panera,-35.05,Winter Park FL,32789,5898.53,0
2012-03-31,16:52:00,Walmart,-68.74,Oviedo FL,32765,5829.79,0
2012-04-01,09:00:00,Rent,-1428.57,Oviedo FL,32765,4401.22,0
2012-04-01,09:00:00,Insurance,-200.0,Oviedo FL,32765,4201.22,0
2012-04-01,09:00:00,Car,-281.69,Oviedo FL,32765,3919.53,0
2012-04-01,09:00:00,Utilities,-142.86,Oviedo FL,32765,3776.67,0
2012-04-02,12:39:00,Walgreens,-39.57,Winter Park FL,32789,3737.1,0
2012-04-02,04:25:00,Best Buy,-97.59,Winter Park FL,32789,3639.51,0
2012-04-03,01:31:00,Kroger,-110.39,Oviedo FL,32765,3529.12,0
2012-04-03,10:42:00,7-Eleven,-15.58,Orlando FL,32816,3513.54,0
2012-04-03,09:55:00,Smoothie King,-36.2,Orlando FL,32816,3477.34,0
2012-04-03,04:16:00,Online,-1433.25,Mexico City MC,79393,2044.09,1
2012-04-04,13:54:00,Subway,-18.11,Winter Park FL,32789,3459.23,0
2012-04-04,13:02:00,Midas,-176.99,Oviedo FL,32765,3282.24,0
2012-04-04,11:03:00,Petco,-19.47,Winter Park FL,32789,3262.77,0
2012-04-04,09:55:00,Whole Foods,-53.35,Orlando FL,32816,3209.42,0
2012-04-05,10:51:00,Subway,-28.64,Oviedo FL,32765,3180.78,0
2012-04-05,04:50:00,Movie Rental,-41.43,Oviedo FL,32765,3139.35,0
2012-04-05,02:21:00,Wawa,-20.55,Orlando FL,32816,3118.8,0
2012-04-05,01:02:00,Unknown,-1188.3,Anchorage AL,96793,1930.5,1
2012-04-06,03:16:00,Trader Joe's,-72.46,Orlando FL,32816,3046.34,0
2012-04-06,07:40:00,Qdoba,-12.06,Winter Park FL,32789,3034.28,0
2012-04-06,17:51:00,Qdoba,-15.44,Winter Park FL,32789,3018.84,0
2012-04-06,04:46:00,Smoothie King,-44.74,Orlando FL,32816,2974.1,0
2012-04-06,16:22:00,Target,-15.23,Winter Park FL,32789,2958.87,0
2012-04-06,04:26:00,Online,-1670.56,Groton CT,76115,1288.31,1
2012-04-07,09:00:00,Spotify,-12.0,Oviedo FL,32765,2946.87,0
2012-04-07,09:00:00,Internet,-70.0,Oviedo FL,32765,2876.87,0
2012-04-07,09:00:00,Streaming,-23.81,Oviedo FL,32765,2853.06,0
2012-04-07,08:31:00,Dollar Tree,-37.31,Oviedo FL,32765,2815.75,0
2012-04-07,02:41:00,McDonald's,-13.36,Oviedo FL,32765,2802.39,0
2012-04-07,08:11:00,Qdoba,-19.92,Oviedo FL,32765,2782.47,0
2012-04-08,08:00:00,Paycheck,3000.0,Oviedo FL,32765,5782.47,0
2012-04-08,07:13:00,Qdoba,-34.37,Orlando FL,32816,5748.1,0
2012-04-08,11:04:00,Amazon,-136.38,Winter Park FL,32789,5611.72,0
2012-04-09,01:54:00,Exxon,-26.83,Orlando FL,32816,5584.89,0
2012-04-09,13:33:00,CVS,-9.43,Orlando FL,32816,5575.46,0
2012-04-09,12:59:00,Exxon,-33.65,Winter Park FL,32789,5541.81,0
2012-04-09,09:00:00,Qdoba,-25.35,Winter Park FL,32789,5516.46,0
2012-04-09,13:33:00,Publix,-47.44,Orlando FL,32816,5469.02,0
2012-04-10,02:56:00,Trader Joe's,-59.13,Orlando FL,32816,5409.89,0
2012-04-10,02:28:00,Paypal,-1195.68,Pittsburgh PA,13242,4214.21,1
2012-04-11,08:15:00,Publix,-67.58,Orlando FL,32816,5342.31,0
2012-04-11,03:44:00,Smoothie King,-6.01,Oviedo FL,32765,5336.3,0
2012-04-12,15:31:00,Shell,-30.85,Winter Park FL,32789,5305.45,0
2012-04-12,18:13:00,Chevron,-27.71,Oviedo FL,32765,5277.74,0
2012-04-12,04:03:00,Trader Joe's,-61.37,Orlando FL,32816,5216.37,0
2012-04-12,03:30:00,Five Below,-14.73,Winter Park FL,32789,5201.64,0
2012-04-12,00:39:00,Paypal,-987.51,Honolulu HI,78369,4214.13,1
2012-04-13,04:46:00,Smoothie King,-28.63,Winter Park FL,32789,5173.01,0
2012-04-13,03:18:00,Paypal,-1499.59,Mexico City MC,24886,3673.42,1
2012-04-15,09:02:00,CVS,-19.23,Orlando FL,32816,5153.78,0
2012-04-15,02:04:00,Starbucks,-36.85,Oviedo FL,32765,5116.93,0
2012-04-15,14:28:00,Subway,-30.86,Orlando FL,32816,5086.07,0
2012-04-18,02:49:00,Home Depot,-126.48,Orlando FL,32816,4959.59,0
2012-04-18,05:14:00,Smoothie King,-25.89,Oviedo FL,32765,4933.7,0
2012-04-18,09:05:00,Movie Rental,-48.46,Orlando FL,32816,4885.24,0
2012-04-18,08:18:00,Midas,-172.85,Oviedo FL,32765,4712.39,0
2012-04-19,05:10:00,Lowes Foods,-71.34,Oviedo FL,32765,4641.05,0
2012-04-19,08:43:00,Exxon,-12.78,Winter Park FL,32789,4628.27,0
2012-04-19,02:46:00,Panera,-35.84,Orlando FL,32816,4592.43,0
2012-04-20,01:43:00,Concert Tickets,-17.3,Winter Park FL,32789,4575.13,0
2012-04-20,11:12:00,Chevron,-33.71,Orlando FL,32816,4541.42,0
2012-04-22,08:00:00,Paycheck,3000.0,Oviedo FL,32765,7541.42,0
2012-04-22,08:46:00,Walmart,-58.9,Winter Park FL,32789,7482.52,0
2012-04-22,14:33:00,Best Buy,-181.15,Winter Park FL,32789,7301.37,0
2012-04-22,10:32:00,Smoothie King,-58.23,Winter Park FL,32789,7243.14,0
2012-04-22,10:49:00,Pep Boys,-162.71,Oviedo FL,32765,7080.43,0
2012-04-23,08:37:00,Gamestop,-31.45,Oviedo FL,32765,7048.98,0
2012-04-23,00:20:00,Starbucks,-57.36,Winter Park FL,32789,6991.62,0
2012-04-23,04:41:00,Take5,-171.16,Oviedo FL,32765,6820.46,0
2012-04-23,00:07:00,Unknown,-1138.45,Los Angeles CA,17741,5682.01,1
2012-04-24,16:55:00,Chevron,-45.58,Orlando FL,32816,6774.88,0
2012-04-25,05:52:00,Starbucks,-46.66,Oviedo FL,32765,6728.22,0
2012-04-25,11:19:00,Petco,-247.3,Oviedo FL,32765,6480.92,0
2012-04-25,16:03:00,CVS,-51.97,Winter Park FL,32789,6428.95,0
2012-04-25,17:45:00,Movie Rental,-25.3,Winter Park FL,32789,6403.65,0
2012-04-25,11:23:00,Disney World,-76.01,Winter Park FL,32789,6327.64,0
2012-04-26,11:35:00,Concert Tickets,-97.89,Orlando FL,32816,6229.75,0
2012-04-26,07:48:00,Kroger,-122.54,Winter Park FL,32789,6107.21,0
2012-04-26,09:14:00,Publix,-88.28,Winter Park FL,32789,6018.93,0
2012-04-26,08:40:00,Target,-191.73,Oviedo FL,32765,5827.2,0
2012-04-27,03:03:00,Subway,-36.64,Orlando FL,32816,5790.56,0
2012-04-28,10:08:00,AutoZone,-216.39,Orlando FL,32816,5574.17,0
2012-04-28,15:13:00,Panera,-34.51,Winter Park FL,32789,5539.66,0
2012-04-29,18:05:00,Concert Tickets,-26.85,Orlando FL,32816,5512.81,0
2012-04-29,08:36:00,Publix,-41.96,Winter Park FL,32789,5470.85,0
2012-04-29,05:50:00,Five Below,-37.05,Orlando FL,32816,5433.8,0
2012-04-30,15:56:00,Take5,-202.32,Orlando FL,32816,5231.48,0
2012-04-30,00:55:00,Valvoline,-63.76,Orlando FL,32816,5167.72,0
2012-04-30,03:39:00,Racetrac,-32.39,Orlando FL,32816,5135.33,0
2012-04-30,14:21:00,Chevron,-13.7,Oviedo FL,32765,5121.63,0
2012-04-30,05:37:00,Walmart,-128.48,Winter Park FL,32789,4993.15,0
2012-05-01,09:00:00,Rent,-1428.57,Oviedo FL,32765,3564.58,0
2012-05-01,09:00:00,Insurance,-200.0,Oviedo FL,32765,3364.58,0
2012-05-01,09:00:00,Car,-281.69,Oviedo FL,32765,3082.89,0
2012-05-01,09:00:00,Utilities,-142.86,Oviedo FL,32765,2940.03,0
2012-05-01,04:29:00,McDonald's,-43.85,Winter Park FL,32789,2896.18,0
2012-05-03,17:31:00,Starbucks,-11.58,Orlando FL,32816,2884.6,0
2012-05-03,10:44:00,7-Eleven,-16.25,Winter Park FL,32789,2868.35,0
2012-05-04,06:06:00,Best Buy,-124.48,Oviedo FL,32765,2743.87,0
2012-05-05,12:30:00,Disney World,-48.48,Winter Park FL,32789,2695.39,0
2012-05-05,06:07:00,Whole Foods,-60.38,Orlando FL,32816,2635.01,0
2012-05-05,06:09:00,Movie Rental,-51.0,Oviedo FL,32765,2584.01,0
2012-05-05,15:46:00,Walgreens,-9.93,Oviedo FL,32765,2574.08,0
2012-05-06,08:00:00,Paycheck,3000.0,Oviedo FL,32765,5574.08,0
2012-05-06,11:34:00,CVS,-27.12,Oviedo FL,32765,5546.96,0
2012-05-06,02:39:00,Movie Rental,-52.92,Oviedo FL,32765,5494.04,0
2012-05-06,04:54:00,Trader Joe's,-109.01,Orlando FL,32816,5385.03,0
2012-05-06,00:36:00,Whole Foods,-100.34,Oviedo FL,32765,5284.69,0
2012-05-07,09:00:00,Spotify,-12.0,Oviedo FL,32765,5272.69,0
2012-05-07,09:00:00,Internet,-70.0,Oviedo FL,32765,5202.69,0
2012-05-07,09:00:00,Streaming,-23.81,Oviedo FL,32765,5178.88,0
2012-05-07,16:39:00,Movie Theater,-66.74,Orlando FL,32816,5112.14,0
2012-05-07,04:30:00,Take5,-138.96,Winter Park FL,32789,4973.18,0
2012-05-07,08:32:00,Gamestop,-26.26,Orlando FL,32816,4946.92,0
2012-05-07,04:43:00,Best Buy,-22.21,Oviedo FL,32765,4924.71,0
2012-05-07,18:04:00,Qdoba,-21.4,Oviedo FL,32765,4903.31,0
2012-05-08,07:43:00,Racetrac,-23.57,Winter Park FL,32789,4879.74,0
2012-05-08,03:37:00,7-Eleven,-25.57,Oviedo FL,32765,4854.17,0
2012-05-09,09:49:00,Subway,-23.41,Orlando FL,32816,4830.76,0
2012-05-10,05:38:00,CVS,-23.45,Winter Park FL,32789,4807.31,0
2012-05-10,06:27:00,Movie Rental,-40.57,Winter Park FL,32789,4766.74,0
2012-05-10,02:59:00,Smoothie King,-21.18,Orlando FL,32816,4745.56,0
2012-05-10,06:07:00,Qdoba,-22.96,Orlando FL,32816,4722.6,0
2012-05-12,17:04:00,Subway,-33.99,Oviedo FL,32765,4688.61,0
2012-05-12,05:13:00,Movie Theater,-17.5,Winter Park FL,32789,4671.11,0
2012-05-13,13:35:00,Trader Joe's,-49.99,Winter Park FL,32789,4621.12,0
2012-05-13,16:04:00,Starbucks,-22.7,Orlando FL,32816,4598.42,0
2012-05-13,14:35:00,Five Below,-55.75,Oviedo FL,32765,4542.67,0
2012-05-14,00:37:00,Panera,-21.43,Winter Park FL,32789,4521.24,0
2012-05-14,12:28:00,Racetrac,-18.75,Winter Park FL,32789,4502.49,0
2012-05-14,14:49:00,Five Below,-44.8,Winter Park FL,32789,4457.69,0
2012-05-14,17:14:00,Subway,-35.28,Orlando FL,32816,4422.41,0
2012-05-14,11:00:00,McDonald's,-45.03,Oviedo FL,32765,4377.38,0
2012-05-15,09:42:00,McDonald's,-15.22,Orlando FL,32816,4362.16,0
2012-05-15,03:55:00,Panera,-33.26,Winter Park FL,32789,4328.9,0
2012-05-15,18:20:00,Smoothie King,-15.54,Winter Park FL,32789,4313.36,0
2012-05-15,08:06:00,Movie Rental,-61.44,Orlando FL,32816,4251.92,0
2012-05-15,08:39:00,Take5,-121.55,Oviedo FL,32765,4130.37,0
2012-05-16,11:36:00,Home Depot,-127.06,Orlando FL,32816,4003.31,0
2012-05-16,12:06:00,Starbucks,-22.72,Oviedo FL,32765,3980.59,0
2012-05-16,01:13:00,Kroger,-85.24,Orlando FL,32816,3895.35,0
2012-05-16,02:31:00,Panera,-14.38,Orlando FL,32816,3880.97,0
2012-05-16,10:32:00,Movie Rental,-33.87,Oviedo FL,32765,3847.1,0
2012-05-16,04:55:00,User,-675.65,Honolulu HI,64925,3171.45,1
2012-05-18,02:09:00,AutoZone,-176.3,Winter Park FL,32789,3670.8,0
2012-05-18,13:56:00,Panera,-7.09,Oviedo FL,32765,3663.71,0
2012-05-18,03:44:00,CVS,-29.48,Orlando FL,32816,3634.23,0
2012-05-19,16:08:00,Trader Joe's,-107.39,Winter Park FL,32789,3526.84,0
2012-05-19,08:53:00,Starbucks,-15.8,Orlando FL,32816,3511.04,0
2012-05-19,05:57:00,Five Below,-18.85,Orlando FL,32816,3492.19,0
2012-05-19,17:25:00,Pep Boys,-205.46,Oviedo FL,32765,3286.73,0
2012-05-19,02:43:00,McDonald's,-23.04,Winter Park FL,32789,3263.69,0
2012-05-20,08:00:00,Paycheck,3000.0,Oviedo FL,32765,6263.69,0
2012-05-20,04:48:00,Lowes Foods,-55.71,Oviedo FL,32765,6207.98,0
2012-05-22,03:30:00,Movie Theater,-57.04,Oviedo FL,32765,6150.94,0
2012-05-22,01:42:00,Exxon,-47.1,Winter Park FL,32789,6103.84,0
2012-05-23,13:48:00,Home Depot,-204.25,Winter Park FL,32789,5899.59,0
2012-05-23,14:09:00,Subway,-43.64,Oviedo FL,32765,5855.95,0
2012-05-23,11:20:00,Midas,-177.48,Oviedo FL,32765,5678.47,0
2012-05-25,16:45:00,Walgreens,-16.11,Winter Park FL,32789,5662.36,0
2012-05-25,17:21:00,Starbucks,-8.19,Oviedo FL,32765,5654.17,0
2012-05-25,05:21:00,Movie Theater,-45.72,Winter Park FL,32789,5608.45,0
2012-05-26,18:07:00,Petco,-77.63,Winter Park FL,32789,5530.82,0
2012-05-26,01:58:00,Walgreens,-23.21,Winter Park FL,32789,5507.61,0
2012-05-27,13:42:00,Pep Boys,-200.44,Orlando FL,32816,5307.17,0
2012-05-27,18:30:00,Gamestop,-20.86,Orlando FL,32816,5286.31,0
2012-05-27,06:55:00,CVS,-54.59,Orlando FL,32816,5231.72,0
2012-05-27,02:36:00,ComputerPart,-574.87,Charleston SC,98393,4656.85,1
2012-05-28,06:46:00,Qdoba,-29.98,Orlando FL,32816,5201.74,0
2012-05-28,18:24:00,Trader Joe's,-58.41,Oviedo FL,32765,5143.33,0
2012-05-28,08:06:00,Qdoba,-44.38,Orlando FL,32816,5098.95,0
2012-05-28,16:21:00,Qdoba,-37.61,Oviedo FL,32765,5061.34,0
2012-05-29,03:12:00,McDonald's,-42.97,Oviedo FL,32765,5018.37,0
2012-05-29,16:32:00,Whole Foods,-62.14,Orlando FL,32816,4956.23,0
2012-05-30,02:21:00,Racetrac,-32.0,Winter Park FL,32789,4924.23,0
2012-05-31,03:25:00,Gamestop,-11.06,Orlando FL,32816,4913.17,0
2012-05-31,14:12:00,Subway,-18.28,Winter Park FL,32789,4894.89,0
2012-05-31,01:30:00,Target,-21.13,Orlando FL,32816,4873.76,0
2012-05-31,05:19:00,Panera,-10.3,Oviedo FL,32765,4863.46,0
2012-06-01,09:00:00,Rent,-1428.57,Oviedo FL,32765,3434.89,0
2012-06-01,09:00:00,Insurance,-200.0,Oviedo FL,32765,3234.89,0
2012-06-01,09:00:00,Car,-281.69,Oviedo FL,32765,2953.2,0
2012-06-01,09:00:00,Utilities,-142.86,Oviedo FL,32765,2810.34,0
2012-06-01,07:49:00,Whole Foods,-89.6,Winter Park FL,32789,2720.74,0
2012-06-01,13:30:00,CVS,-51.88,Orlando FL,32816,2668.86,0
2012-06-01,12:32:00,Subway,-13.99,Oviedo FL,32765,2654.87,0
2012-06-01,05:48:00,Wawa,-21.67,Orlando FL,32816,2633.2,0
2012-06-02,11:02:00,McDonald's,-17.41,Orlando FL,32816,2615.79,0
2012-06-02,14:29:00,McDonald's,-42.99,Orlando FL,32816,2572.8,0
2012-06-02,03:11:00,Take5,-145.98,Oviedo FL,32765,2426.82,0
2012-06-02,06:22:00,McDonald's,-44.24,Winter Park FL,32789,2382.58,0
2012-06-03,08:00:00,Paycheck,3000.0,Oviedo FL,32765,5382.58,0
2012-06-05,03:18:00,Gamestop,-13.61,Oviedo FL,32765,5368.97,0
2012-06-05,12:23:00,Valvoline,-212.81,Oviedo FL,32765,5156.16,0
2012-06-05,02:19:00,CVS,-54.83,Orlando FL,32816,5101.33,0
2012-06-07,09:00:00,Spotify,-12.0,Oviedo FL,32765,5089.33,0
2012-06-07,09:00:00,Internet,-70.0,Oviedo FL,32765,5019.33,0
2012-06-07,09:00:00,Streaming,-23.81,Oviedo FL,32765,4995.52,0
2012-06-08,15:46:00,Subway,-9.0,Orlando FL,32816,4986.52,0
2012-06-08,07:01:00,Gamestop,-37.74,Orlando FL,32816,4948.78,0
2012-06-08,07:02:00,Best Buy,-29.07,Winter Park FL,32789,4919.71,0
2012-06-08,13:06:00,Chevron,-20.51,Orlando FL,32816,4899.2,0
2012-06-08,08:16:00,Midas,-124.9,Winter Park FL,32789,4774.3,0
2012-06-09,03:09:00,Exxon,-13.17,Winter Park FL,32789,4761.13,0
2012-06-10,08:51:00,Take5,-224.97,Oviedo FL,32765,4536.16,0
2012-06-11,06:51:00,Home Depot,-137.6,Oviedo FL,32765,4398.56,0
2012-06-11,18:12:00,McDonald's,-28.97,Winter Park FL,32789,4369.59,0
2012-06-12,17:27:00,Amazon,-74.52,Winter Park FL,32789,4295.07,0
2012-06-12,16:56:00,Target,-75.74,Winter Park FL,32789,4219.33,0
2012-06-12,17:35:00,Walmart,-109.69,Oviedo FL,32765,4109.64,0
2012-06-12,17:44:00,Midas,-111.1,Winter Park FL,32789,3998.54,0
2012-06-13,14:59:00,Whole Foods,-64.75,Orlando FL,32816,3933.79,0
2012-06-13,14:06:00,Qdoba,-20.23,Winter Park FL,32789,3913.56,0
2012-06-13,18:23:00,Whole Foods,-37.76,Oviedo FL,32765,3875.8,0
2012-06-14,10:37:00,Chevron,-18.81,Winter Park FL,32789,3856.99,0
2012-06-15,01:47:00,Smoothie King,-16.21,Winter Park FL,32789,3840.78,0
2012-06-15,17:51:00,Five Below,-44.78,Orlando FL,32816,3796.0,0
2012-06-15,01:25:00,Home Depot,-157.74,Orlando FL,32816,3638.26,0
2012-06-16,15:39:00,Smoothie King,-36.01,Oviedo FL,32765,3602.25,0
2012-06-16,18:30:00,Valvoline,-164.88,Orlando FL,32816,3437.37,0
2012-06-16,00:43:00,Online,-259.73,Anchorage AL,28130,3177.64,1
2012-06-17,08:00:00,Paycheck,3000.0,Oviedo FL,32765,6437.37,0
2012-06-17,14:30:00,Walgreens,-79.15,Oviedo FL,32765,6358.22,0
2012-06-17,18:04:00,Disney World,-36.83,Orlando FL,32816,6321.39,0
2012-06-17,03:32:00,Shell,-43.25,Winter Park FL,32789,6278.14,0
2012-06-17,05:48:00,Best Buy,-50.03,Orlando FL,32816,6228.11,0
2012-06-17,14:57:00,Kroger,-59.83,Winter Park FL,32789,6168.28,0
2012-06-18,02:16:00,Disney World,-82.33,Oviedo FL,32765,6085.95,0
2012-06-18,12:47:00,Smoothie King,-57.9,Oviedo FL,32765,6028.05,0
2012-06-18,07:34:00,Petco,-80.48,Orlando FL,32816,5947.57,0
2012-06-18,06:11:00,Starbucks,-36.87,Oviedo FL,32765,5910.7,0
2012-06-18,13:07:00,Best Buy,-146.91,Oviedo FL,32765,5763.79,0
2012-06-19,16:19:00,Smoothie King,-14.74,Winter Park FL,32789,5749.05,0
2012-06-19,16:49:00,Movie Rental,-21.28,Winter Park FL,32789,5727.77,0
2012-06-19,08:20:00,Petco,-99.57,Winter Park FL,32789,5628.2,0
2012-06-19,06:20:00,Wawa,-28.0,Orlando FL,32816,5600.2,0
2012-06-19,01:32:00,Smoothie King,-20.24,Orlando FL,32816,5579.96,0
2012-06-21,08:57:00,Disney World,-51.82,Oviedo FL,32765,5528.14,0
2012-06-21,04:38:00,Best Buy,-58.37,Orlando FL,32816,5469.77,0
2012-06-22,06:29:00,Starbucks,-21.66,Oviedo FL,32765,5448.11,0
2012-06-22,15:03:00,Best Buy,-105.12,Orlando FL,32816,5342.99,0
2012-06-22,17:26:00,Whole Foods,-106.28,Orlando FL,32816,5236.71,0
2012-06-22,17:08:00,Target,-112.35,Oviedo FL,32765,5124.36,0
2012-06-23,08:28:00,Disney World,-42.79,Winter Park FL,32789,5081.57,0
2012-06-23,18:10:00,Subway,-40.42,Winter Park FL,32789,5041.15,0
2012-06-23,14:14:00,Qdoba,-26.1,Winter Park FL,32789,5015.05,0
2012-06-23,04:12:00,McDonald's,-44.55,Oviedo FL,32765,4970.5,0
2012-06-24,14:28:00,Five Below,-37.09,Winter Park FL,32789,4933.41,0
2012-06-24,10:42:00,Lowes Foods,-84.73,Orlando FL,32816,4848.68,0
2012-06-24,15:07:00,Dollar Tree,-9.33,Orlando FL,32816,4839.35,0
2012-06-24,00:27:00,Dollar Tree,-16.37,Orlando FL,32816,4822.98,0
2012-06-24,10:54:00,Walgreens,-22.01,Oviedo FL,32765,4800.97,0
2012-06-25,08:56:00,Gamestop,-38.59,Oviedo FL,32765,4762.38,0
2012-06-25,11:37:00,Petco,-112.42,Oviedo FL,32765,4649.96,0
2012-06-26,10:12:00,Subway,-40.08,Winter Park FL,32789,4609.88,0
2012-06-26,07:21:00,Subway,-37.8,Oviedo FL,32765,4572.08,0
2012-06-27,11:23:00,Chevron,-28.05,Winter Park FL,32789,4544.03,0
2012-06-27,12:00:00,Midas,-93.37,Oviedo FL,32765,4450.66,0
2012-06-27,03:58:00,Paypal,-873.55,Mexico City MC,82105,3577.11,1
2012-06-28,14:03:00,McDonald's,-18.35,Orlando FL,32816,4432.31,0
2012-06-28,06:28:00,Panera,-9.43,Winter Park FL,32789,4422.88,0
2012-06-28,12:03:00,McDonald's,-9.83,Orlando FL,32816,4413.05,0
2012-06-28,15:06:00,Walgreens,-39.17,Orlando FL,32816,4373.88,0
2012-06-28,16:23:00,Gamestop,-24.95,Oviedo FL,32765,4348.93,0
2012-06-29,07:51:00,Walmart,-166.69,Winter Park FL,32789,4182.24,0
2012-06-29,01:12:00,Trader Joe's,-77.59,Orlando FL,32816,4104.65,0
2012-06-30,10:27:00,Subway,-18.32,Oviedo FL,32765,4086.33,0
2012-06-30,15:55:00,Trader Joe's,-57.6,Orlando FL,32816,4028.73,0
2012-07-01,08:00:00,Paycheck,3000.0,Oviedo FL,32765,7028.73,0
2012-07-01,09:00:00,Rent,-1428.57,Oviedo FL,32765,5600.16,0
2012-07-01,09:00:00,Insurance,-200.0,Oviedo FL,32765,5400.16,0
2012-07-01,09:00:00,Car,-281.69,Oviedo FL,32765,5118.47,0
2012-07-01,09:00:00,Utilities,-142.86,Oviedo FL,32765,4975.61,0
2012-07-01,06:53:00,Qdoba,-32.79,Oviedo FL,32765,4942.82,0
2012-07-01,14:22:00,Subway,-43.01,Oviedo FL,32765,4899.81,0
2012-07-01,15:17:00,Smoothie King,-31.84,Orlando FL,32816,4867.97,0
2012-07-01,14:25:00,Walgreens,-19.54,Orlando FL,32816,4848.43,0
2012-07-02,04:38:00,Subway,-25.95,Oviedo FL,32765,4822.48,0
2012-07-03,02:56:00,Amazon,-154.22,Orlando FL,32816,4668.26,0
2012-07-03,00:32:00,Subway,-30.14,Oviedo FL,32765,4638.12,0
2012-07-04,00:51:00,Take5,-56.16,Oviedo FL,32765,4581.96,0
2012-07-04,08:18:00,Subway,-32.24,Orlando FL,32816,4549.72,0
2012-07-04,03:47:00,Trader Joe's,-87.08,Orlando FL,32816,4462.64,0
2012-07-04,01:46:00,CVS,-46.95,Orlando FL,32816,4415.69,0
2012-07-04,02:58:00,Amazon,-55.7,Oviedo FL,32765,4359.99,0
2012-07-05,04:47:00,Target,-161.74,Orlando FL,32816,4198.25,0
2012-07-05,09:56:00,Walgreens,-54.22,Winter Park FL,32789,4144.03,0
2012-07-06,13:28:00,Kroger,-63.32,Winter Park FL,32789,4080.71,0
2012-07-06,14:35:00,Walgreens,-21.83,Winter Park FL,32789,4058.88,0
2012-07-06,15:27:00,Dollar Tree,-20.64,Orlando FL,32816,4038.24,0
2012-07-06,02:42:00,Online,-1610.04,Mexico City MC,69426,2428.2,1
2012-07-07,09:00:00,Spotify,-12.0,Oviedo FL,32765,4026.24,0
2012-07-07,09:00:00,Internet,-70.0,Oviedo FL,32765,3956.24,0
2012-07-07,09:00:00,Streaming,-23.81,Oviedo FL,32765,3932.43,0
2012-07-07,18:24:00,Racetrac,-18.48,Orlando FL,32816,3913.95,0
2012-07-07,04:04:00,McDonald's,-42.66,Oviedo FL,32765,3871.29,0
2012-07-07,13:57:00,Subway,-42.16,Winter Park FL,32789,3829.13,0
2012-07-07,03:48:00,McDonald's,-29.51,Orlando FL,32816,3799.62,0
2012-07-07,15:53:00,Amazon,-19.52,Oviedo FL,32765,3780.1,0
2012-07-08,01:13:00,Midas,-96.17,Oviedo FL,32765,3683.93,0
2012-07-08,13:21:00,Smoothie King,-34.1,Oviedo FL,32765,3649.83,0
2012-07-08,12:02:00,Publix,-65.19,Oviedo FL,32765,3584.64,0
2012-07-08,04:53:00,Movie Rental,-19.8,Orlando FL,32816,3564.84,0
2012-07-09,03:38:00,Trader Joe's,-39.99,Oviedo FL,32765,3524.85,0
2012-07-09,16:21:00,Qdoba,-36.73,Oviedo FL,32765,3488.12,0
2012-07-09,03:51:00,Subway,-30.56,Oviedo FL,32765,3457.56,0
2012-07-09,01:10:00,Starbucks,-13.3,Winter Park FL,32789,3444.26,0
2012-07-10,00:08:00,Take5,-61.18,Oviedo FL,32765,3383.08,0
2012-07-10,05:40:00,Amazon,-50.08,Orlando FL,32816,3333.0,0
2012-07-10,16:23:00,Starbucks,-37.89,Orlando FL,32816,3295.11,0
2012-07-11,00:06:00,Qdoba,-21.65,Orlando FL,32816,3273.46,0
2012-07-11,11:16:00,Wawa,-25.21,Oviedo FL,32765,3248.25,0
2012-07-11,08:37:00,McDonald's,-30.33,Orlando FL,32816,3217.92,0
2012-07-11,18:09:00,Walgreens,-23.91,Oviedo FL,32765,3194.01,0
2012-07-12,03:03:00,Starbucks,-17.24,Winter Park FL,32789,3176.77,0
2012-07-13,16:12:00,Walmart,-80.96,Orlando FL,32816,3095.81,0
2012-07-13,15:44:00,Trader Joe's,-90.42,Oviedo FL,32765,3005.39,0
2012-07-13,00:21:00,Publix,-74.7,Oviedo FL,32765,2930.69,0
2012-07-13,03:40:00,Valley,-1146.79,Charleston SC,70874,1783.9,1
2012-07-14,08:09:00,BP,-31.7,Winter Park FL,32789,2898.99,0
2012-07-14,11:52:00,Qdoba,-18.08,Oviedo FL,32765,2880.91,0
2012-07-14,08:40:00,Target,-82.69,Oviedo FL,32765,2798.22,0
2012-07-14,06:04:00,Panera,-30.97,Orlando FL,32816,2767.25,0
2012-07-15,08:00:00,Paycheck,3000.0,Oviedo FL,32765,5767.25,0
2012-07-15,10:53:00,Smoothie King,-29.0,Winter Park FL,32789,5738.25,0
2012-07-15,16:14:00,AutoZone,-80.41,Oviedo FL,32765,5657.84,0
2012-07-15,11:11:00,Movie Rental,-39.35,Oviedo FL,32765,5618.49,0
2012-07-15,03:04:00,Publix,-102.2,Winter Park FL,32789,5516.29,0
2012-07-16,11:51:00,Movie Theater,-18.9,Oviedo FL,32765,5497.39,0
2012-07-16,12:14:00,CVS,-14.7,Winter Park FL,32789,5482.69,0
2012-07-16,14:11:00,Exxon,-28.27,Winter Park FL,32789,5454.42,0
2012-07-16,06:37:00,Publix,-61.23,Oviedo FL,32765,5393.19,0
2012-07-16,13:58:00,Panera,-33.72,Oviedo FL,32765,5359.47,0
2012-07-17,14:07:00,Smoothie King,-19.77,Oviedo FL,32765,5339.7,0
2012-07-17,15:01:00,CVS,-26.24,Winter Park FL,32789,5313.46,0
2012-07-17,18:01:00,Shell,-22.66,Orlando FL,32816,5290.8,0
2012-07-18,15:16:00,Best Buy,-93.08,Oviedo FL,32765,5197.72,0
2012-07-18,12:25:00,Movie Rental,-45.14,Orlando FL,32816,5152.58,0
2012-07-18,05:43:00,Paypal,-1206.46,Honolulu HI,54879,3946.12,1
2012-07-19,09:39:00,Qdoba,-5.72,Oviedo FL,32765,5146.86,0
2012-07-19,02:06:00,Subway,-17.63,Oviedo FL,32765,5129.23,0
2012-07-19,02:02:00,Wawa,-15.27,Winter Park FL,32789,5113.96,0
2012-07-19,11:38:00,AutoZone,-129.31,Orlando FL,32816,4984.65,0
2012-07-19,13:35:00,Disney World,-30.43,Winter Park FL,32789,4954.22,0
2012-07-20,04:13:00,Panera,-16.66,Orlando FL,32816,4937.56,0
2012-07-20,16:39:00,Smoothie King,-38.7,Oviedo FL,32765,4898.86,0
2012-07-20,08:50:00,Smoothie King,-15.83,Winter Park FL,32789,4883.03,0
2012-07-20,17:14:00,Smoothie King,-25.94,Oviedo FL,32765,4857.09,0
2012-07-20,12:46:00,McDonald's,-22.31,Winter Park FL,32789,4834.78,0
2012-07-22,08:00:00,Qdoba,-22.69,Winter Park FL,32789,4812.09,0
2012-07-22,09:16:00,Subway,-43.46,Oviedo FL,32765,4768.63,0
2012-07-22,12:56:00,Home Depot,-151.9,Orlando FL,32816,4616.73,0
2012-07-22,01:01:00,Five Below,-23.86,Winter Park FL,32789,4592.87,0
2012-07-22,02:10:00,Online,-1552.95,Groton CT,11513,3039.92,1
2012-07-23,14:49:00,Racetrac,-29.65,Oviedo FL,32765,4563.22,0
2012-07-23,04:37:00,Walmart,-132.0,Winter Park FL,32789,4431.22,0
2012-07-23,04:43:00,McDonald's,-21.8,Orlando FL,32816,4409.42,0
2012-07-23,13:16:00,Amazon,-30.16,Winter Park FL,32789,4379.26,0
2012-07-23,06:56:00,Five Below,-7.27,Oviedo FL,32765,4371.99,0
2012-07-24,11:35:00,Whole Foods,-102.99,Winter Park FL,32789,4269.0,0
2012-07-24,15:33:00,Starbucks,-39.21,Oviedo FL,32765,4229.79,0
2012-07-25,06:28:00,Valvoline,-189.18,Orlando FL,32816,4040.61,0
2012-07-25,09:01:00,Petco,-19.34,Winter Park FL,32789,4021.27,0
2012-07-25,07:22:00,Smoothie King,-27.86,Winter Park FL,32789,3993.41,0
2012-07-25,02:10:00,AutoZone,-173.54,Orlando FL,32816,3819.87,0
2012-07-25,07:55:00,Concert Tickets,-65.03,Oviedo FL,32765,3754.84,0
2012-07-26,01:11:00,Movie Rental,-32.78,Oviedo FL,32765,3722.06,0
2012-07-26,03:03:00,Amazon,-116.03,Winter Park FL,32789,3606.03,0
2012-07-26,15:10:00,Subway,-22.83,Winter Park FL,32789,3583.2,0
2012-07-26,01:53:00,Trader Joe's,-41.28,Oviedo FL,32765,3541.92,0
2012-07-28,01:19:00,Best Buy,-45.5,Winter Park FL,32789,3496.42,0
2012-07-28,01:39:00,Starbucks,-20.6,Orlando FL,32816,3475.82,0
2012-07-28,14:53:00,BP,-33.48,Winter Park FL,32789,3442.34,0
2012-07-28,12:33:00,Five Below,-44.52,Winter Park FL,32789,3397.82,0
2012-07-28,01:25:00,McDonald's,-30.19,Orlando FL,32816,3367.63,0
2012-07-29,08:00:00,Paycheck,3000.0,Oviedo FL,32765,6367.63,0
2012-07-29,07:31:00,Lowes Foods,-130.43,Winter Park FL,32789,6237.2,0
2012-07-30,07:15:00,Subway,-18.73,Winter Park FL,32789,6218.47,0
2012-07-30,02:10:00,Shell,-33.09,Orlando FL,32816,6185.38,0
2012-07-30,13:24:00,Amazon,-212.4,Oviedo FL,32765,5972.98,0
2012-07-31,05:21:00,Best Buy,-150.76,Orlando FL,32816,5822.22,0
2012-07-31,09:09:00,Smoothie King,-36.68,Oviedo FL,32765,5785.54,0
2012-07-31,09:58:00,Smoothie King,-7.45,Oviedo FL,32765,5778.09,0
2012-07-31,11:29:00,Walgreens,-21.22,Winter Park FL,32789,5756.87,0
2012-08-01,09:00:00,Rent,-1428.57,Oviedo FL,32765,4328.3,0
2012-08-01,09:00:00,Insurance,-200.0,Oviedo FL,32765,4128.3,0
2012-08-01,09:00:00,Car,-281.69,Oviedo FL,32765,3846.61,0
2012-08-01,09:00:00,Utilities,-142.86,Oviedo FL,32765,3703.75,0
2012-08-01,02:48:00,Movie Theater,-67.22,Orlando FL,32816,3636.53,0
2012-08-02,18:03:00,Kroger,-59.25,Winter Park FL,32789,3577.28,0
2012-08-02,16:46:00,Disney World,-49.12,Orlando FL,32816,3528.16,0
2012-08-02,17:30:00,Petco,-64.21,Oviedo FL,32765,3463.95,0
2012-08-02,02:12:00,Gamestop,-56.17,Orlando FL,32816,3407.78,0
2012-08-02,08:24:00,Kroger,-112.56,Winter Park FL,32789,3295.22,0
2012-08-03,14:56:00,Starbucks,-8.28,Orlando FL,32816,3286.94,0
2012-08-03,05:05:00,Gamestop,-50.69,Orlando FL,32816,3236.25,0
2012-08-03,01:52:00,Movie Rental,-64.0,Winter Park FL,32789,3172.25,0
2012-08-03,08:40:00,Kroger,-96.59,Orlando FL,32816,3075.66,0
2012-08-04,09:02:00,Subway,-20.97,Winter Park FL,32789,3054.69,0
2012-08-04,10:54:00,Whole Foods,-74.6,Winter Park FL,32789,2980.09,0
2012-08-04,15:49:00,Starbucks,-26.16,Winter Park FL,32789,2953.93,0
2012-08-04,01:54:00,Panera,-18.28,Orlando FL,32816,2935.65,0
2012-08-06,13:25:00,Kroger,-101.88,Oviedo FL,32765,2833.77,0
2012-08-06,13:08:00,Midas,-133.48,Winter Park FL,32789,2700.29,0
2012-08-06,14:25:00,Smoothie King,-13.59,Oviedo FL,32765,2686.7,0
2012-08-06,15:25:00,Starbucks,-44.71,Orlando FL,32816,2641.99,0
2012-08-07,09:00:00,Spotify,-12.0,Oviedo FL,32765,2629.99,0
2012-08-07,09:00:00,Internet,-70.0,Oviedo FL,32765,2559.99,0
2012-08-07,09:00:00,Streaming,-23.81,Oviedo FL,32765,2536.18,0
2012-08-07,13:36:00,Walgreens,-32.56,Orlando FL,32816,2503.62,0
2012-08-07,00:00:00,Unknown,-290.19,Charleston SC,29221,2213.43,1
2012-08-08,02:28:00,Pep Boys,-168.37,Winter Park FL,32789,2335.25,0
2012-08-08,09:10:00,Subway,-32.51,Oviedo FL,32765,2302.74,0
2012-08-08,16:37:00,AutoZone,-83.72,Oviedo FL,32765,2219.02,0
2012-08-08,06:01:00,Starbucks,-35.41,Winter Park FL,32789,2183.61,0
2012-08-09,17:23:00,Qdoba,-44.8,Orlando FL,32816,2138.81,0
2012-08-09,12:37:00,Take5,-94.28,Orlando FL,32816,2044.53,0
2012-08-09,07:50:00,Dollar Tree,-15.3,Orlando FL,32816,2029.23,0
2012-08-10,10:24:00,Panera,-14.51,Oviedo FL,32765,2014.72,0
2012-08-10,14:50:00,Movie Rental,-52.03,Orlando FL,32816,1962.69,0
2012-08-10,06:32:00,Walgreens,-44.57,Oviedo FL,32765,1918.12,0
2012-08-10,17:19:00,Walgreens,-51.48,Oviedo FL,32765,1866.64,0
2012-08-11,13:43:00,Take5,-141.41,Oviedo FL,32765,1725.23,0
2012-08-11,05:21:00,Movie Theater,-65.88,Winter Park FL,32789,1659.35,0
2012-08-11,17:54:00,Walgreens,-10.72,Winter Park FL,32789,1648.63,0
2012-08-11,01:26:00,Petco,-123.4,Winter Park FL,32789,1525.23,0
2012-08-11,05:32:00,Panera,-32.45,Winter Park FL,32789,1492.78,0
2012-08-12,08:00:00,Paycheck,3000.0,Oviedo FL,32765,4492.78,0
2012-08-12,03:19:00,Take5,-71.94,Oviedo FL,32765,4420.84,0
2012-08-12,00:37:00,Gamestop,-33.48,Winter Park FL,32789,4387.36,0
2012-08-13,00:12:00,Kroger,-56.64,Orlando FL,32816,4330.72,0
2012-08-13,00:02:00,ComputerPart,-261.82,Tokyo JP,52679,4068.9,1
2012-08-14,03:37:00,Smoothie King,-26.06,Orlando FL,32816,4304.66,0
2012-08-14,06:00:00,Kroger,-89.3,Orlando FL,32816,4215.36,0
2012-08-14,18:28:00,Smoothie King,-8.05,Orlando FL,32816,4207.31,0
2012-08-15,05:32:00,Whole Foods,-81.77,Oviedo FL,32765,4125.54,0
2012-08-15,07:03:00,Starbucks,-26.33,Winter Park FL,32789,4099.21,0
2012-08-15,03:28:00,Best Buy,-27.21,Winter Park FL,32789,4072.0,0
2012-08-15,14:05:00,Starbucks,-33.51,Oviedo FL,32765,4038.49,0
2012-08-16,14:37:00,CVS,-29.54,Oviedo FL,32765,4008.95,0
2012-08-16,01:29:00,Movie Theater,-62.79,Orlando FL,32816,3946.16,0
2012-08-16,05:27:00,Online,-463.77,New York NY,68067,3482.39,1
2012-08-17,06:08:00,Gamestop,-12.33,Orlando FL,32816,3933.83,0
2012-08-17,17:39:00,Wawa,-24.36,Oviedo FL,32765,3909.47,0
2012-08-17,06:28:00,Amazon,-153.22,Oviedo FL,32765,3756.25,0
2012-08-17,14:51:00,Whole Foods,-52.35,Orlando FL,32816,3703.9,0
2012-08-19,02:09:00,Publix,-108.11,Oviedo FL,32765,3595.79,0
2012-08-19,05:36:00,McDonald's,-22.23,Oviedo FL,32765,3573.56,0
2012-08-19,09:29:00,Best Buy,-85.33,Oviedo FL,32765,3488.23,0
2012-08-20,11:05:00,Midas,-163.06,Orlando FL,32816,3325.17,0
2012-08-20,04:09:00,McDonald's,-7.86,Orlando FL,32816,3317.31,0
2012-08-20,11:04:00,McDonald's,-26.34,Orlando FL,32816,3290.97,0
2012-08-20,11:51:00,Subway,-39.4,Winter Park FL,32789,3251.57,0
2012-08-21,00:50:00,Qdoba,-7.15,Winter Park FL,32789,3244.42,0
2012-08-21,11:38:00,Target,-26.99,Orlando FL,32816,3217.43,0
2012-08-21,09:37:00,Smoothie King,-24.45,Oviedo FL,32765,3192.98,0
2012-08-22,05:12:00,McDonald's,-31.39,Orlando FL,32816,3161.59,0
2012-08-22,03:14:00,Panera,-22.63,Oviedo FL,32765,3138.96,0
2012-08-22,14:51:00,Home Depot,-19.53,Orlando FL,32816,3119.43,0
2012-08-23,11:42:00,Qdoba,-34.65,Oviedo FL,32765,3084.78,0
2012-08-23,17:30:00,Smoothie King,-34.91,Oviedo FL,32765,3049.87,0
2012-08-24,06:07:00,Movie Rental,-62.85,Winter Park FL,32789,2987.02,0
2012-08-24,12:23:00,Gamestop,-11.92,Winter Park FL,32789,2975.1,0
2012-08-24,05:53:00,Smoothie King,-15.7,Oviedo FL,32765,2959.4,0
2012-08-24,09:18:00,Kroger,-111.38,Orlando FL,32816,2848.02,0
2012-08-26,08:00:00,Paycheck,3000.0,Oviedo FL,32765,5848.02,0
2012-08-26,13:20:00,Whole Foods,-70.41,Oviedo FL,32765,5777.61,0
2012-08-26,04:59:00,Dollar Tree,-14.54,Oviedo FL,32765,5763.07,0
2012-08-26,05:25:00,Target,-50.55,Orlando FL,32816,5712.52,0
2012-08-26,01:48:00,Best Buy,-123.45,Orlando FL,32816,5589.07,0
2012-08-26,11:05:00,Qdoba,-18.04,Oviedo FL,32765,5571.03,0
2012-08-28,00:56:00,Best Buy,-16.36,Oviedo FL,32765,5554.67,0
2012-08-28,06:25:00,Exxon,-19.66,Orlando FL,32816,5535.01,0
2012-08-28,01:18:00,Kroger,-80.25,Orlando FL,32816,5454.76,0
2012-08-28,13:54:00,Smoothie King,-8.57,Oviedo FL,32765,5446.19,0
2012-08-29,04:06:00,Smoothie King,-29.14,Winter Park FL,32789,5417.05,0
2012-08-30,18:50:00,Disney World,-52.01,Oviedo FL,32765,5365.04,0
2012-08-30,01:17:00,Five Below,-36.99,Oviedo FL,32765,5328.05,0
2012-08-31,10:02:00,Publix,-40.14,Winter Park FL,32789,5287.91,0
2012-08-31,01:45:00,Smoothie King,-35.92,Oviedo FL,32765,5251.99,0
2012-08-31,07:08:00,Home Depot,-157.58,Winter Park FL,32789,5094.41,0
2012-08-31,07:40:00,Qdoba,-14.76,Oviedo FL,32765,5079.65,0
2012-09-01,09:00:00,Rent,-1428.57,Oviedo FL,32765,3651.08,0
2012-09-01,09:00:00,Insurance,-200.0,Oviedo FL,32765,3451.08,0
2012-09-01,09:00:00,Car,-281.69,Oviedo FL,32765,3169.39,0
2012-09-01,09:00:00,Utilities,-142.86,Oviedo FL,32765,3026.53,0
2012-09-01,12:10:00,Starbucks,-32.19,Orlando FL,32816,2994.34,0
2012-09-01,16:48:00,Petco,-71.5,Winter Park FL,32789,2922.84,0
2012-09-01,01:57:00,Five Below,-52.06,Orlando FL,32816,2870.78,0
2012-09-01,06:22:00,Target,-75.97,Oviedo FL,32765,2794.81,0
2012-09-01,17:17:00,McDonald's,-8.42,Winter Park FL,32789,2786.39,0
2012-09-02,03:51:00,Valley,-856.09,London EN,19798,1930.3,1
2012-09-03,09:42:00,Subway,-40.11,Orlando FL,32816,2746.28,0
2012-09-03,04:13:00,Amazon,-43.84,Orlando FL,32816,2702.44,0
2012-09-03,18:53:00,Subway,-40.43,Oviedo FL,32765,2662.01,0
2012-09-03,13:40:00,McDonald's,-34.95,Orlando FL,32816,2627.06,0
2012-09-03,02:38:00,Lowes Foods,-84.2,Winter Park FL,32789,2542.86,0
2012-09-04,07:18:00,Movie Rental,-35.41,Winter Park FL,32789,2507.45,0
2012-09-05,15:18:00,Dollar Tree,-13.9,Winter Park FL,32789,2493.55,0
2012-09-05,02:16:00,Walgreens,-21.9,Orlando FL,32816,2471.65,0
2012-09-05,03:41:00,Subway,-19.06,Orlando FL,32816,2452.59,0
2012-09-06,07:55:00,Walmart,-97.67,Winter Park FL,32789,2354.92,0
2012-09-06,18:12:00,Home Depot,-164.45,Oviedo FL,32765,2190.47,0
2012-09-06,14:09:00,Home Depot,-95.22,Winter Park FL,32789,2095.25,0
2012-09-06,02:50:00,Paypal,-929.93,New York NY,38460,1165.32,1
2012-09-07,09:00:00,Spotify,-12.0,Oviedo FL,32765,2083.25,0
2012-09-07,09:00:00,Internet,-70.0,Oviedo FL,32765,2013.25,0
2012-09-07,09:00:00,Streaming,-23.81,Oviedo FL,32765,1989.44,0
2012-09-07,08:13:00,Starbucks,-30.24,Winter Park FL,32789,1959.2,0
2012-09-07,03:49:00,Qdoba,-30.55,Oviedo FL,32765,1928.65,0
2012-09-07,10:13:00,Subway,-26.59,Winter Park FL,32789,1902.06,0
2012-09-09,08:00:00,Paycheck,3000.0,Oviedo FL,32765,4902.06,0
2012-09-09,14:02:00,Shell,-17.14,Winter Park FL,32789,4884.92,0
2012-09-09,06:21:00,Starbucks,-36.47,Oviedo FL,32765,4848.45,0
2012-09-09,07:51:00,Movie Rental,-18.16,Oviedo FL,32765,4830.29,0
2012-09-11,00:57:00,Publix,-100.2,Orlando FL,32816,4730.09,0
2012-09-11,06:09:00,Qdoba,-31.68,Oviedo FL,32765,4698.41,0
2012-09-11,12:44:00,AutoZone,-54.13,Oviedo FL,32765,4644.28,0
2012-09-11,02:29:00,Online,-1041.26,London EN,90474,3603.02,1
2012-09-12,04:40:00,Subway,-19.02,Orlando FL,32816,4625.26,0
2012-09-12,02:39:00,Petco,-135.98,Winter Park FL,32789,4489.28,0
2012-09-13,07:58:00,Shell,-13.96,Oviedo FL,32765,4475.32,0
2012-09-13,02:26:00,McDonald's,-27.05,Orlando FL,32816,4448.27,0
2012-09-13,09:34:00,Best Buy,-28.6,Oviedo FL,32765,4419.67,0
2012-09-14,08:34:00,Starbucks,-14.65,Orlando FL,32816,4405.02,0
2012-09-14,09:38:00,Starbucks,-37.19,Orlando FL,32816,4367.83,0
2012-09-14,11:50:00,Gamestop,-40.55,Oviedo FL,32765,4327.28,0
2012-09-14,03:38:00,Exxon,-16.87,Oviedo FL,32765,4310.41,0
2012-09-14,17:08:00,Gamestop,-48.29,Orlando FL,32816,4262.12,0
2012-09-15,11:17:00,Amazon,-107.72,Winter Park FL,32789,4154.4,0
2012-09-16,11:17:00,Panera,-18.9,Orlando FL,32816,4135.5,0
2012-09-16,11:52:00,Smoothie King,-40.88,Winter Park FL,32789,4094.62,0
2012-09-16,01:19:00,Best Buy,-89.35,Oviedo FL,32765,4005.27,0
2012-09-17,17:18:00,BP,-23.76,Oviedo FL,32765,3981.51,0
2012-09-18,01:06:00,Petco,-53.04,Oviedo FL,32765,3928.47,0
2012-09-18,14:42:00,Panera,-18.96,Orlando FL,32816,3909.51,0
2012-09-19,00:52:00,Movie Rental,-45.94,Winter Park FL,32789,3863.57,0
2012-09-19,03:29:00,Home Depot,-69.54,Oviedo FL,32765,3794.03,0
2012-09-19,06:39:00,Target,-42.64,Orlando FL,32816,3751.39,0
2012-09-20,06:06:00,Petco,-13.3,Winter Park FL,32789,3738.09,0
2012-09-20,10:33:00,Dollar Tree,-46.91,Orlando FL,32816,3691.18,0
2012-09-20,14:37:00,Movie Theater,-46.5,Orlando FL,32816,3644.68,0
2012-09-20,09:52:00,BP,-23.08,Winter Park FL,32789,3621.6,0
2012-09-20,01:31:00,Gamestop,-26.03,Orlando FL,32816,3595.57,0
2012-09-21,11:56:00,Best Buy,-38.21,Orlando FL,32816,3557.36,0
2012-09-21,02:17:00,Subway,-41.19,Winter Park FL,32789,3516.17,0
2012-09-22,01:25:00,Disney World,-14.92,Winter Park FL,32789,3501.25,0
2012-09-22,16:34:00,Racetrac,-23.97,Orlando FL,32816,3477.28,0
2012-09-23,08:00:00,Paycheck,3000.0,Oviedo FL,32765,6477.28,0
2012-09-23,04:16:00,Panera,-52.65,Oviedo FL,32765,6424.63,0
2012-09-24,00:13:00,Petco,-74.01,Oviedo FL,32765,6350.62,0
2012-09-24,02:19:00,Paypal,-1520.24,Pittsburgh PA,85447,4830.38,1
2012-09-26,14:32:00,Amazon,-241.96,Oviedo FL,32765,6108.66,0
2012-09-26,04:32:00,AutoZone,-142.31,Winter Park FL,32789,5966.35,0
2012-09-26,01:58:00,Target,-76.07,Oviedo FL,32765,5890.28,0
2012-09-26,10:39:00,Wawa,-27.21,Orlando FL,32816,5863.07,0
2012-09-27,12:42:00,Shell,-18.7,Orlando FL,32816,5844.37,0
2012-09-27,16:56:00,McDonald's,-19.17,Oviedo FL,32765,5825.2,0
2012-09-27,12:55:00,Walmart,-160.2,Oviedo FL,32765,5665.0,0
2012-09-27,09:27:00,BP,-15.21,Orlando FL,32816,5649.79,0
2012-09-28,15:55:00,Midas,-172.47,Orlando FL,32816,5477.32,0
2012-09-28,17:56:00,Walmart,-133.33,Oviedo FL,32765,5343.99,0
2012-09-29,01:54:00,CVS,-38.12,Winter Park FL,32789,5305.87,0
2012-09-29,16:56:00,Kroger,-63.53,Orlando FL,32816,5242.34,0
2012-09-29,10:03:00,Starbucks,-25.16,Orlando FL,32816,5217.18,0
2012-09-30,12:50:00,Lowes Foods,-70.88,Orlando FL,32816,5146.3,0
2012-09-30,00:14:00,Smoothie King,-37.88,Orlando FL,32816,5108.42,0
2012-09-30,12:50:00,Starbucks,-14.07,Orlando FL,32816,5094.35,0
2012-10-01,09:00:00,Rent,-1428.57,Oviedo FL,32765,3665.78,0
2012-10-01,09:00:00,Insurance,-200.0,Oviedo FL,32765,3465.78,0
2012-10-01,09:00:00,Car,-281.69,Oviedo FL,32765,3184.09,0
2012-10-01,09:00:00,Utilities,-142.86,Oviedo FL,32765,3041.23,0
2012-10-01,03:15:00,ComputerPart,-1055.44,Honolulu HI,18667,1985.79,1
2012-10-02,07:41:00,Disney World,-13.6,Oviedo FL,32765,3027.63,0
2012-10-02,13:35:00,Walmart,-17.98,Oviedo FL,32765,3009.65,0
2012-10-02,12:33:00,Amazon,-50.92,Winter Park FL,32789,2958.73,0
2012-10-03,02:36:00,Best Buy,-21.89,Oviedo FL,32765,2936.84,0
2012-10-04,00:18:00,Smoothie King,-27.3,Winter Park FL,32789,2909.54,0
2012-10-04,04:39:00,Subway,-16.21,Orlando FL,32816,2893.33,0
2012-10-04,18:31:00,Qdoba,-38.43,Winter Park FL,32789,2854.9,0
2012-10-04,16:47:00,Best Buy,-136.5,Winter Park FL,32789,2718.4,0
2012-10-05,03:38:00,Smoothie King,-11.99,Orlando FL,32816,2706.41,0
2012-10-05,05:47:00,Petco,-17.35,Orlando FL,32816,2689.06,0
2012-10-05,00:00:00,Valley,-904.51,Pittsburgh PA,22455,1784.55,1
2012-10-06,06:34:00,Panera,-28.03,Oviedo FL,32765,2661.03,0
2012-10-06,18:20:00,Smoothie King,-37.48,Oviedo FL,32765,2623.55,0
2012-10-06,07:32:00,Subway,-26.59,Winter Park FL,32789,2596.96,0
2012-10-07,08:00:00,Paycheck,3000.0,Oviedo FL,32765,5596.96,0
2012-10-07,09:00:00,Spotify,-12.0,Oviedo FL,32765,5584.96,0
2012-10-07,09:00:00,Internet,-70.0,Oviedo FL,32765,5514.96,0
2012-10-07,09:00:00,Streaming,-23.81,Oviedo FL,32765,5491.15,0
2012-10-07,16:57:00,McDonald's,-36.39,Orlando FL,32816,5454.76,0
2012-10-07,11:43:00,Walmart,-28.16,Winter Park FL,32789,5426.6,0
2012-10-07,02:21:00,Whole Foods,-42.69,Oviedo FL,32765,5383.91,0
2012-10-07,12:28:00,McDonald's,-25.63,Winter Park FL,32789,5358.28,0
2012-10-07,11:54:00,Racetrac,-22.69,Oviedo FL,32765,5335.59,0
2012-10-09,10:11:00,Shell,-29.48,Orlando FL,32816,5306.11,0
2012-10-10,02:54:00,McDonald's,-23.5,Oviedo FL,32765,5282.61,0
2012-10-10,11:04:00,Starbucks,-18.39,Orlando FL,32816,5264.22,0
2012-10-11,08:14:00,Movie Rental,-45.7,Orlando FL,32816,5218.52,0
2012-10-11,02:52:00,Walmart,-119.12,Winter Park FL,32789,5099.4,0
2012-10-11,02:55:00,Smoothie King,-13.15,Orlando FL,32816,5086.25,0
2012-10-12,09:29:00,Smoothie King,-22.59,Oviedo FL,32765,5063.66,0
2012-10-12,14:54:00,Best Buy,-152.44,Orlando FL,32816,4911.22,0
2012-10-12,05:07:00,Subway,-44.98,Oviedo FL,32765,4866.24,0
2012-10-12,03:42:00,Qdoba,-43.76,Orlando FL,32816,4822.48,0
2012-10-13,04:31:00,7-Eleven,-20.82,Orlando FL,32816,4801.66,0
2012-10-14,16:24:00,Disney World,-44.8,Winter Park FL,32789,4756.86,0
2012-10-15,10:09:00,Starbucks,-18.4,Orlando FL,32816,4738.46,0
2012-10-15,16:31:00,Shell,-17.19,Oviedo FL,32765,4721.27,0
2012-10-15,18:59:00,Target,-18.76,Winter Park FL,32789,4702.51,0
2012-10-15,04:08:00,Unknown,-108.0,Los Angeles CA,17620,4594.51,1
2012-10-16,03:57:00,Movie Theater,-60.36,Winter Park FL,32789,4642.15,0
2012-10-16,01:14:00,Qdoba,-39.27,Winter Park FL,32789,4602.88,0
2012-10-16,02:58:00,Movie Rental,-35.9,Oviedo FL,32765,4566.98,0
2012-10-18,08:29:00,7-Eleven,-32.41,Orlando FL,32816,4534.57,0
2012-10-18,11:55:00,Smoothie King,-45.04,Winter Park FL,32789,4489.53,0
2012-10-18,04:04:00,Lowes Foods,-69.83,Winter Park FL,32789,4419.7,0
2012-10-18,17:46:00,Qdoba,-11.08,Oviedo FL,32765,4408.62,0
2012-10-19,13:57:00,7-Eleven,-28.3,Oviedo FL,32765,4380.32,0
2012-10-19,01:09:00,Midas,-117.5,Orlando FL,32816,4262.82,0
2012-10-19,18:57:00,Movie Theater,-16.73,Oviedo FL,32765,4246.09,0
2012-10-19,16:45:00,Qdoba,-21.7,Orlando FL,32816,4224.39,0
2012-10-19,18:51:00,Valvoline,-200.94,Winter Park FL,32789,4023.45,0
2012-10-20,09:08:00,Qdoba,-44.44,Oviedo FL,32765,3979.01,0
2012-10-20,15:27:00,Pep Boys,-169.23,Winter Park FL,32789,3809.78,0
2012-10-20,01:19:00,Smoothie King,-30.17,Orlando FL,32816,3779.61,0
2012-10-21,08:00:00,Paycheck,3000.0,Oviedo FL,32765,6779.61,0
2012-10-21,09:38:00,Panera,-23.83,Winter Park FL,32789,6755.78,0
2012-10-21,09:43:00,Whole Foods,-114.96,Winter Park FL,32789,6640.82,0
2012-10-22,07:21:00,Panera,-25.01,Orlando FL,32816,6615.81,0
2012-10-24,17:25:00,Target,-196.95,Winter Park FL,32789,6418.86,0
2012-10-24,02:53:00,Qdoba,-26.82,Orlando FL,32816,6392.04,0
2012-10-24,14:20:00,Walgreens,-23.53,Oviedo FL,32765,6368.51,0
2012-10-25,08:38:00,Smoothie King,-53.19,Winter Park FL,32789,6315.32,0
2012-10-25,03:05:00,Movie Theater,-57.89,Oviedo FL,32765,6257.43,0
2012-10-26,01:36:00,Panera,-52.33,Orlando FL,32816,6205.1,0
2012-10-26,02:10:00,Qdoba,-23.66,Orlando FL,32816,6181.44,0
2012-10-27,08:08:00,Amazon,-96.42,Oviedo FL,32765,6085.02,0
2012-10-27,15:30:00,Trader Joe's,-66.69,Winter Park FL,32789,6018.33,0
2012-10-27,05:07:00,Panera,-31.47,Orlando FL,32816,5986.86,0
2012-10-27,16:41:00,Concert Tickets,-39.14,Winter Park FL,32789,5947.72,0
2012-10-27,12:34:00,Five Below,-31.44,Orlando FL,32816,5916.28,0
2012-10-28,14:32:00,Panera,-44.41,Oviedo FL,32765,5871.87,0
2012-10-28,05:55:00,McDonald's,-23.39,Oviedo FL,32765,5848.48,0
2012-10-28,02:24:00,Walmart,-85.12,Oviedo FL,32765,5763.36,0
2012-10-28,12:01:00,Gamestop,-20.64,Oviedo FL,32765,5742.72,0
2012-10-29,07:57:00,Pep Boys,-99.58,Winter Park FL,32789,5643.14,0
2012-10-29,14:26:00,Five Below,-46.31,Oviedo FL,32765,5596.83,0
2012-10-29,11:08:00,McDonald's,-24.72,Winter Park FL,32789,5572.11,0
2012-10-29,18:44:00,Subway,-16.47,Oviedo FL,32765,5555.64,0
2012-10-29,15:42:00,Subway,-7.98,Orlando FL,32816,5547.66,0
2012-10-29,01:31:00,Valley,-502.78,Pittsburgh PA,29118,5044.88,1
2012-10-30,12:51:00,Walmart,-74.07,Oviedo FL,32765,5473.59,0
2012-10-31,03:09:00,Home Depot,-160.74,Orlando FL,32816,5312.85,0
2012-10-31,16:43:00,Chevron,-18.82,Orlando FL,32816,5294.03,0
2012-10-31,08:07:00,Walmart,-34.17,Winter Park FL,32789,5259.86,0
2012-10-31,16:04:00,Smoothie King,-38.83,Winter Park FL,32789,5221.03,0
2012-10-31,16:52:00,Petco,-51.06,Winter Park FL,32789,5169.97,0
2012-11-01,09:00:00,Rent,-1428.57,Oviedo FL,32765,3741.4,0
2012-11-01,09:00:00,Insurance,-200.0,Oviedo FL,32765,3541.4,0
2012-11-01,09:00:00,Car,-281.69,Oviedo FL,32765,3259.71,0
2012-11-01,09:00:00,Utilities,-142.86,Oviedo FL,32765,3116.85,0
2012-11-01,13:44:00,Subway,-31.57,Orlando FL,32816,3085.28,0
2012-11-02,15:36:00,Pep Boys,-192.97,Oviedo FL,32765,2892.31,0
2012-11-02,05:50:00,Lowes Foods,-112.18,Oviedo FL,32765,2780.13,0
2012-11-02,08:05:00,Walgreens,-13.76,Winter Park FL,32789,2766.37,0
2012-11-02,05:32:00,Unknown,-1434.85,Charleston SC,68090,1331.52,1
2012-11-03,09:52:00,Walmart,-94.7,Winter Park FL,32789,2671.67,0
2012-11-03,18:35:00,Wawa,-29.25,Orlando FL,32816,2642.42,0
2012-11-04,08:00:00,Paycheck,3000.0,Oviedo FL,32765,5642.42,0
2012-11-04,18:41:00,Concert Tickets,-39.52,Winter Park FL,32789,5602.9,0
2012-11-04,08:23:00,McDonald's,-21.42,Winter Park FL,32789,5581.48,0
2012-11-04,11:11:00,Publix,-107.85,Oviedo FL,32765,5473.63,0
2012-11-06,03:04:00,Publix,-79.49,Winter Park FL,32789,5394.14,0
2012-11-07,09:00:00,Spotify,-12.0,Oviedo FL,32765,5382.14,0
2012-11-07,09:00:00,Internet,-70.0,Oviedo FL,32765,5312.14,0
2012-11-07,09:00:00,Streaming,-23.81,Oviedo FL,32765,5288.33,0
2012-11-07,00:26:00,Concert Tickets,-57.23,Orlando FL,32816,5231.1,0
2012-11-07,09:54:00,Publix,-82.79,Orlando FL,32816,5148.31,0
2012-11-07,02:48:00,Valvoline,-209.53,Oviedo FL,32765,4938.78,0
2012-11-07,17:52:00,Movie Rental,-18.94,Orlando FL,32816,4919.84,0
2012-11-07,00:52:00,ComputerPart,-353.24,New York NY,11712,4566.6,1
2012-11-08,07:14:00,Petco,-59.59,Winter Park FL,32789,4860.25,0
2012-11-08,01:09:00,Walgreens,-29.27,Orlando FL,32816,4830.98,0
2012-11-09,09:33:00,Movie Theater,-62.4,Oviedo FL,32765,4768.58,0
2012-11-09,17:03:00,7-Eleven,-31.65,Oviedo FL,32765,4736.93,0
2012-11-09,15:01:00,Racetrac,-27.93,Winter Park FL,32789,4709.0,0
2012-11-10,01:33:00,Home Depot,-88.02,Orlando FL,32816,4620.98,0
2012-11-10,15:58:00,Subway,-36.32,Oviedo FL,32765,4584.66,0
2012-11-10,15:09:00,Starbucks,-14.88,Orlando FL,32816,4569.78,0
2012-11-11,02:22:00,Wawa,-17.83,Oviedo FL,32765,4551.95,0
2012-11-11,00:35:00,Best Buy,-32.42,Orlando FL,32816,4519.53,0
2012-11-12,15:03:00,Disney World,-30.04,Orlando FL,32816,4489.49,0
2012-11-12,00:27:00,7-Eleven,-31.47,Orlando FL,32816,4458.02,0
2012-11-12,08:31:00,Gamestop,-34.93,Oviedo FL,32765,4423.09,0
2012-11-12,08:46:00,BP,-18.92,Oviedo FL,32765,4404.17,0
2012-11-13,12:55:00,Midas,-166.12,Orlando FL,32816,4238.05,0
2012-11-13,18:49:00,Trader Joe's,-35.27,Orlando FL,32816,4202.78,0
2012-11-13,14:01:00,Exxon,-24.01,Orlando FL,32816,4178.77,0
2012-11-13,11:56:00,Target,-160.86,Orlando FL,32816,4017.91,0
2012-11-13,05:08:00,Smoothie King,-11.46,Winter Park FL,32789,4006.45,0
2012-11-14,09:36:00,Midas,-133.42,Winter Park FL,32789,3873.03,0
2012-11-14,12:47:00,Subway,-15.49,Oviedo FL,32765,3857.54,0
2012-11-15,03:24:00,Trader Joe's,-72.1,Orlando FL,32816,3785.44,0
2012-11-16,08:16:00,Walgreens,-12.54,Orlando FL,32816,3772.9,0
2012-11-16,13:57:00,Starbucks,-25.45,Winter Park FL,32789,3747.45,0
2012-11-16,00:18:00,McDonald's,-6.45,Orlando FL,32816,3741.0,0
2012-11-16,13:48:00,Midas,-51.5,Oviedo FL,32765,3689.5,0
2012-11-16,09:54:00,Starbucks,-11.26,Winter Park FL,32789,3678.24,0
2012-11-16,05:46:00,Paypal,-969.8,New York NY,35121,2708.44,1
2012-11-17,12:31:00,McDonald's,-20.09,Winter Park FL,32789,3658.15,0
2012-11-17,13:13:00,Concert Tickets,-66.76,Orlando FL,32816,3591.39,0
2012-11-17,06:25:00,Amazon,-166.96,Orlando FL,32816,3424.43,0
2012-11-17,17:52:00,Kroger,-34.47,Orlando FL,32816,3389.96,0
2012-11-17,04:54:00,AutoZone,-212.87,Winter Park FL,32789,3177.09,0
2012-11-18,08:00:00,Paycheck,3000.0,Oviedo FL,32765,6177.09,0
2012-11-19,07:03:00,McDonald's,-66.07,Oviedo FL,32765,6111.02,0
2012-11-19,16:49:00,Target,-134.5,Orlando FL,32816,5976.52,0
2012-11-20,08:41:00,Dollar Tree,-39.43,Orlando FL,32816,5937.09,0
2012-11-20,10:57:00,Qdoba,-17.81,Orlando FL,32816,5919.28,0
2012-11-20,16:05:00,Wawa,-20.27,Orlando FL,32816,5899.01,0
2012-11-21,09:28:00,Kroger,-55.13,Orlando FL,32816,5843.88,0
2012-11-21,18:53:00,Lowes Foods,-66.3,Oviedo FL,32765,5777.58,0
2012-11-21,05:13:00,Amazon,-136.77,Winter Park FL,32789,5640.81,0
2012-11-22,17:14:00,Panera,-22.23,Winter Park FL,32789,5618.58,0
2012-11-22,04:45:00,Kroger,-48.21,Winter Park FL,32789,5570.37,0
2012-11-22,00:35:00,Target,-22.78,Oviedo FL,32765,5547.59,0
2012-11-23,15:40:00,Racetrac,-24.69,Orlando FL,32816,5522.9,0
2012-11-23,06:43:00,Qdoba,-42.46,Orlando FL,32816,5480.44,0
2012-11-23,18:08:00,Gamestop,-7.41,Oviedo FL,32765,5473.03,0
2012-11-23,09:44:00,Five Below,-41.58,Winter Park FL,32789,5431.45,0
