Date,Time,Name,Amount,Location,Zip,Balance,Fraud
2012-01-01,08:00:00,Paycheck,3000.0,Oviedo FL,32765,6745.87,0
2012-01-01,09:00:00,Rent,-1428.57,Oviedo FL,32765,5317.3,0
2012-01-01,09:00:00,Insurance,-200.0,Oviedo FL,32765,5117.3,0
2012-01-01,09:00:00,Car,-281.69,Oviedo FL,32765,4835.61,0
2012-01-01,09:00:00,Utilities,-142.86,Oviedo FL,32765,4692.75,0
2012-01-02,14:58:00,Starbucks,-42.76,Orlando FL,32816,4649.99,0
2012-01-02,10:45:00,Dollar Tree,-18.26,Winter Park FL,32789,4631.73,0
2012-01-03,12:43:00,Starbucks,-40.44,Winter Park FL,32789,4591.29,0
2012-01-03,01:31:00,Smoothie King,-23.61,Winter Park FL,32789,4567.68,0
2012-01-03,13:23:00,Gamestop,-48.27,Oviedo FL,32765,4519.41,0
2012-01-04,05:27:00,Disney World,-30.43,Winter Park FL,32789,4488.98,0
2012-01-04,06:48:00,Pep Boys,-106.78,Oviedo FL,32765,4382.2,0
2012-01-04,05:33:00,Unknown,-916.66,Mexico City MC,58940,3465.54,1
2012-01-05,00:14:00,Starbucks,-22.24,Oviedo FL,32765,4359.96,0
2012-01-05,15:22:00,Gamestop,-8.05,Orlando FL,32816,4351.91,0
2012-01-05,15:37:00,Chevron,-20.98,Winter Park FL,32789,4330.93,0
2012-01-06,18:22:00,Petco,-48.59,Oviedo FL,32765,4282.34,0
2012-01-06,04:23:00,Paypal,-657.8,Pittsburgh PA,65953,3624.54,1
2012-01-07,09:00:00,Spotify,-12.0,Oviedo FL,32765,4270.34,0
2012-01-07,09:00:00,Internet,-70.0,Oviedo FL,32765,4200.34,0
2012-01-07,09:00:00,Streaming,-23.81,Oviedo FL,32765,4176.53,0
2012-01-07,10:22:00,Home Depot,-69.48,Winter Park FL,32789,4107.05,0
2012-01-07,16:16:00,Dollar Tree,-8.45,Winter Park FL,32789,4098.6,0
2012-01-07,02:59:00,Home Depot,-122.42,Orlando FL,32816,3976.18,0
2012-01-07,18:52:00,Petco,-142.43,Oviedo FL,32765,3833.75,0
2012-01-07,13:39:00,Walmart,-61.07,Orlando FL,32816,3772.68,0
2012-01-08,16:17:00,AutoZone,-98.03,Oviedo FL,32765,3674.65,0
2012-01-08,12:02:00,Panera,-23.53,Oviedo FL,32765,3651.12,0
2012-01-08,03:50:00,Valvoline,-163.14,Orlando FL,32816,3487.98,0
2012-01-08,13:48:00,Petco,-83.39,Oviedo FL,32765,3404.59,0
2012-01-08,07:50:00,Walmart,-18.91,Orlando FL,32816,3385.68,0
2012-01-09,05:08:00,Gamestop,-31.82,Winter Park FL,32789,3353.86,0
2012-01-09,15:24:00,Racetrac,-13.19,Oviedo FL,32765,3340.67,0
2012-01-09,03:59:00,Petco,-139.28,Winter Park FL,32789,3201.39,0
2012-01-09,05:22:00,Petco,-34.61,Orlando FL,32816,3166.78,0
2012-01-09,18:32:00,Subway,-44.06,Oviedo FL,32765,3122.72,0
2012-01-10,05:15:00,Pep Boys,-54.75,Winter Park FL,32789,3067.97,0
2012-01-12,09:27:00,BP,-26.78,Oviedo FL,32765,3041.19,0
2012-01-12,17:56:00,AutoZone,-206.92,Orlando FL,32816,2834.27,0
2012-01-12,14:04:00,Starbucks,-5.99,Winter Park FL,32789,2828.28,0
2012-01-13,01:12:00,Qdoba,-30.04,Oviedo FL,32765,2798.24,0
2012-01-14,08:17:00,Smoothie King,-18.94,Orlando FL,32816,2779.3,0
2012-01-14,03:28:00,Starbucks,-18.05,Orlando FL,32816,2761.25,0
2012-01-15,08:00:00,Paycheck,3000.0,Oviedo FL,32765,5761.25,0
2012-01-15,17:53:00,McDonald's,-41.43,Winter Park FL,32789,5719.82,0
2012-01-15,11:48:00,Subway,-29.0,Winter Park FL,32789,5690.82,0
2012-01-17,11:14:00,Racetrac,-17.09,Orlando FL,32816,5673.73,0
2012-01-18,01:26:00,Smoothie King,-30.63,Winter Park FL,32789,5643.1,0
2012-01-19,09:20:00,Movie Theater,-29.14,Winter Park FL,32789,5613.96,0
2012-01-19,02:37:00,Exxon,-23.44,Orlando FL,32816,5590.52,0
2012-01-22,15:09:00,Whole Foods,-37.04,Orlando FL,32816,5553.48,0
2012-01-22,15:38:00,Movie Theater,-30.41,Oviedo FL,32765,5523.07,0
2012-01-22,18:54:00,Five Below,-41.55,Oviedo FL,32765,5481.52,0
2012-01-22,13:09:00,7-Eleven,-30.23,Orlando FL,32816,5451.29,0
2012-01-23,03:44:00,Shell,-21.76,Oviedo FL,32765,5429.53,0
2012-01-23,17:29:00,Best Buy,-118.3,Oviedo FL,32765,5311.23,0
2012-01-23,07:05:00,Racetrac,-19.04,Winter Park FL,32789,5292.19,0
2012-01-23,10:28:00,Concert Tickets,-20.69,Orlando FL,32816,5271.5,0
2012-01-24,01:33:00,CVS,-15.4,Orlando FL,32816,5256.1,0
2012-01-24,01:33:00,Panera,-18.64,Winter Park FL,32789,5237.46,0
2012-01-24,13:28:00,Walmart,-57.93,Winter Park FL,32789,5179.53,0
2012-01-24,09:14:00,Smoothie King,-29.61,Winter Park FL,32789,5149.92,0
2012-01-26,07:41:00,Home Depot,-56.32,Oviedo FL,32765,5093.6,0
2012-01-26,14:34:00,Disney World,-39.63,Oviedo FL,32765,5053.97,0
2012-01-26,06:13:00,Best Buy,-159.56,Oviedo FL,32765,4894.41,0
2012-01-26,05:38:00,Petco,-71.75,Orlando FL,32816,4822.66,0
2012-01-26,04:45:00,Five Below,-25.13,Orlando FL,32816,4797.53,0
2012-01-28,03:46:00,Qdoba,-43.01,Winter Park FL,32789,4754.52,0
2012-01-28,18:44:00,Midas,-70.52,Orlando FL,32816,4684.0,0
2012-01-28,05:11:00,Trader Joe's,-38.21,Orlando FL,32816,4645.79,0
2012-01-28,16:46:00,Concert Tickets,-25.05,Winter Park FL,32789,4620.74,0
2012-01-29,08:00:00,Paycheck,3000.0,Oviedo FL,32765,7620.74,0
2012-01-29,14:10:00,CVS,-60.35,Orlando FL,32816,7560.39,0
2012-01-30,05:29:00,Subway,-65.78,Orlando FL,32816,7494.61,0
2012-01-30,09:41:00,Smoothie King,-44.99,Oviedo FL,32765,7449.62,0
2012-01-31,09:23:00,Walgreens,-61.4,Orlando FL,32816,7388.22,0
2012-01-31,11:47:00,Qdoba,-24.96,Winter Park FL,32789,7363.26,0
2012-01-31,13:31:00,McDonald's,-23.73,Oviedo FL,32765,7339.53,0
2012-01-31,08:54:00,Walmart,-234.68,Winter Park FL,32789,7104.85,0
2012-01-31,04:30:00,BP,-33.95,Oviedo FL,32765,7070.9,0
2012-02-01,09:00:00,Rent,-1428.57,Oviedo FL,32765,5642.33,0
2012-02-01,09:00:00,Insurance,-200.0,Oviedo FL,32765,5442.33,0
2012-02-01,09:00:00,Car,-281.69,Oviedo FL,32765,5160.64,0
2012-02-01,09:00:00,Utilities,-142.86,Oviedo FL,32765,5017.78,0
2012-02-01,08:56:00,Petco,-27.89,Oviedo FL,32765,4989.89,0
2012-02-01,11:42:00,Walgreens,-8.33,Oviedo FL,32765,4981.56,0
2012-02-01,17:18:00,Subway,-19.27,Oviedo FL,32765,4962.29,0
2012-02-01,01:29:00,McDonald's,-7.71,Oviedo FL,32765,4954.58,0
2012-02-01,00:35:00,Walgreens,-17.61,Winter Park FL,32789,4936.97,0
2012-02-02,16:16:00,Petco,-143.95,Orlando FL,32816,4793.02,0
2012-02-02,14:45:00,Concert Tickets,-46.4,Oviedo FL,32765,4746.62,0
2012-02-02,11:27:00,Trader Joe's,-75.85,Orlando FL,32816,4670.77,0
2012-02-04,09:54:00,Movie Rental,-59.72,Oviedo FL,32765,4611.05,0
2012-02-04,10:55:00,Take5,-138.57,Winter Park FL,32789,4472.48,0
2012-02-04,07:51:00,Wawa,-28.44,Winter Park FL,32789,4444.04,0
2012-02-04,16:12:00,Gamestop,-10.75,Orlando FL,32816,4433.29,0
2012-02-05,17:31:00,Disney World,-51.61,Oviedo FL,32765,4381.68,0
2012-02-05,14:39:00,Whole Foods,-88.87,Orlando FL,32816,4292.81,0
2012-02-05,03:35:00,Starbucks,-9.19,Orlando FL,32816,4283.62,0
2012-02-05,16:25:00,Chevron,-18.02,Winter Park FL,32789,4265.6,0
2012-02-06,02:09:00,McDonald's,-14.35,Orlando FL,32816,4251.25,0
2012-02-06,06:07:00,Movie Rental,-47.12,Oviedo FL,32765,4204.13,0
2012-02-06,00:08:00,Subway,-13.37,Orlando FL,32816,4190.76,0
2012-02-06,08:42:00,Smoothie King,-10.48,Winter Park FL,32789,4180.28,0
2012-02-07,09:00:00,Spotify,-12.0,Oviedo FL,32765,4168.28,0
2012-02-07,09:00:00,Internet,-70.0,Oviedo FL,32765,4098.28,0
2012-02-07,09:00:00,Streaming,-23.81,Oviedo FL,32765,4074.47,0
2012-02-07,17:54:00,Disney World,-40.59,Winter Park FL,32789,4033.88,0
2012-02-09,05:49:00,Online,-115.08,Charleston SC,44475,3918.8,1
2012-02-10,08:22:00,AutoZone,-86.26,Oviedo FL,32765,3947.62,0
2012-02-10,07:54:00,Disney World,-41.92,Winter Park FL,32789,3905.7,0
2012-02-10,10:18:00,Lowes Foods,-89.57,Winter Park FL,32789,3816.13,0
2012-02-10,02:25:00,Unknown,-575.29,Los Angeles CA,15126,3240.84,1
2012-02-11,17:01:00,Racetrac,-21.8,Winter Park FL,32789,3794.33,0
2012-02-11,09:47:00,Best Buy,-153.74,Orlando FL,32816,3640.59,0
2012-02-11,16:20:00,Subway,-37.03,Orlando FL,32816,3603.56,0
2012-02-11,00:32:00,Panera,-31.61,Winter Park FL,32789,3571.95,0
2012-02-11,17:33:00,Whole Foods,-89.6,Winter Park FL,32789,3482.35,0
2012-02-12,08:00:00,Paycheck,3000.0,Oviedo FL,32765,6482.35,0
2012-02-12,08:44:00,Dollar Tree,-75.21,Winter Park FL,32789,6407.14,0
2012-02-12,14:23:00,Starbucks,-54.83,Orlando FL,32816,6352.31,0
2012-02-12,02:17:00,Target,-146.18,Oviedo FL,32765,6206.13,0
2012-02-13,18:47:00,Wawa,-44.32,Orlando FL,32816,6161.81,0
2012-02-13,02:38:00,Valvoline,-286.65,Orlando FL,32816,5875.16,0
2012-02-13,13:22:00,Pep Boys,-109.25,Winter Park FL,32789,5765.91,0
2012-02-13,04:39:00,Movie Rental,-50.94,Winter Park FL,32789,5714.97,0
2012-02-13,08:31:00,CVS,-27.84,Orlando FL,32816,5687.13,0
2012-02-14,12:36:00,CVS,-54.88,Oviedo FL,32765,5632.25,0
2012-02-15,17:16:00,Panera,-14.61,Orlando FL,32816,5617.64,0
2012-02-16,14:53:00,Subway,-13.14,Oviedo FL,32765,5604.5,0
2012-02-16,14:34:00,Racetrac,-33.1,Winter Park FL,32789,5571.4,0
2012-02-18,01:12:00,Paypal,-717.01,New York NY,67881,4854.39,1
2012-02-20,11:09:00,Kroger,-70.56,Oviedo FL,32765,5500.84,0
2012-02-20,12:10:00,Best Buy,-162.14,Winter Park FL,32789,5338.7,0
2012-02-20,01:15:00,Lowes Foods,-60.68,Orlando FL,32816,5278.02,0
2012-02-21,09:00:00,Publix,-39.01,Orlando FL,32816,5239.01,0
2012-02-21,14:56:00,Petco,-55.93,Winter Park FL,32789,5183.08,0
2012-02-21,04:37:00,CVS,-24.14,Orlando FL,32816,5158.94,0
2012-02-21,08:02:00,Trader Joe's,-68.05,Oviedo FL,32765,5090.89,0
2012-02-21,04:40:00,Panera,-20.52,Winter Park FL,32789,5070.37,0
2012-02-21,04:02:00,Unknown,-1275.16,Anchorage AL,90608,3795.21,1
2012-02-22,12:05:00,Starbucks,-38.69,Winter Park FL,32789,5031.68,0
2012-02-22,02:17:00,ComputerPart,-1176.26,New York NY,87550,3855.42,1
2012-02-23,04:25:00,McDonald's,-23.25,Winter Park FL,32789,5008.43,0
2012-02-23,11:41:00,Panera,-27.2,Oviedo FL,32765,4981.23,0
2012-02-24,02:13:00,Movie Theater,-12.77,Orlando FL,32816,4968.46,0
2012-02-25,14:26:00,Best Buy,-72.53,Winter Park FL,32789,4895.93,0
2012-02-25,06:03:00,Pep Boys,-82.21,Winter Park FL,32789,4813.72,0
2012-02-25,14:21:00,Valvoline,-121.88,Orlando FL,32816,4691.84,0
2012-02-25,10:15:00,Best Buy,-11.99,Orlando FL,32816,4679.85,0
2012-02-25,03:51:00,Subway,-44.45,Oviedo FL,32765,4635.4,0
2012-02-26,08:00:00,Paycheck,3000.0,Oviedo FL,32765,7635.4,0
2012-02-26,05:27:00,Disney World,-45.35,Orlando FL,32816,7590.05,0
2012-02-26,10:44:00,Gamestop,-50.82,Orlando FL,32816,7539.23,0
2012-02-26,18:51:00,Smoothie King,-20.82,Oviedo FL,32765,7518.41,0
2012-02-26,11:40:00,Dollar Tree,-20.35,Oviedo FL,32765,7498.06,0
2012-02-27,07:38:00,Trader Joe's,-70.95,Oviedo FL,32765,7427.11,0
2012-02-27,02:29:00,Kroger,-70.23,Winter Park FL,32789,7356.88,0
2012-02-27,07:10:00,Starbucks,-54.51,Oviedo FL,32765,7302.37,0
2012-02-28,06:22:00,Panera,-17.31,Oviedo FL,32765,7285.06,0
2012-02-28,00:34:00,Home Depot,-145.08,Winter Park FL,32789,7139.98,0
2012-02-28,13:43:00,Smoothie King,-17.65,Oviedo FL,32765,7122.33,0
2012-02-28,02:22:00,Best Buy,-44.57,Orlando FL,32816,7077.76,0
2012-02-28,03:41:00,Panera,-31.17,Orlando FL,32816,7046.59,0
2012-02-29,02:43:00,Free Bitcoin,-1653.8,Tokyo JP,31070,5392.79,1
2012-03-01,09:00:00,Rent,-1428.57,Oviedo FL,32765,5618.02,0
2012-03-01,09:00:00,Insurance,-200.0,Oviedo FL,32765,5418.02,0
2012-03-01,09:00:00,Car,-281.69,Oviedo FL,32765,5136.33,0
2012-03-01,09:00:00,Utilities,-142.86,Oviedo FL,32765,4993.47,0
2012-03-01,13:27:00,CVS,-28.62,Oviedo FL,32765,4964.85,0
2012-03-01,09:40:00,Qdoba,-37.16,Orlando FL,32816,4927.69,0
2012-03-01,10:35:00,Dollar Tree,-19.75,Orlando FL,32816,4907.94,0
2012-03-01,05:50:00,Panera,-39.65,Orlando FL,32816,4868.29,0
2012-03-01,13:08:00,Starbucks,-27.27,Orlando FL,32816,4841.02,0
2012-03-02,05:13:00,Dollar Tree,-45.14,Orlando FL,32816,4795.88,0
2012-03-02,12:38:00,Home Depot,-19.13,Winter Park FL,32789,4776.75,0
2012-03-02,16:19:00,Whole Foods,-102.56,Winter Park FL,32789,4674.19,0
2012-03-02,07:57:00,Concert Tickets,-35.61,Orlando FL,32816,4638.58,0
2012-03-03,02:05:00,Trader Joe's,-42.24,Orlando FL,32816,4596.34,0
2012-03-03,02:22:00,Movie Theater,-51.94,Winter Park FL,32789,4544.4,0
2012-03-04,16:20:00,Petco,-154.7,Oviedo FL,32765,4389.7,0
2012-03-05,03:45:00,Home Depot,-163.17,Oviedo FL,32765,4226.53,0
2012-03-05,05:15:00,Paypal,-1749.96,Honolulu HI,34044,2476.57,1
2012-03-06,01:37:00,Pep Boys,-174.72,Winter Park FL,32789,4051.81,0
2012-03-06,05:50:00,Kroger,-84.86,Winter Park FL,32789,3966.95,0
2012-03-06,01:23:00,Unknown,-1326.7,Charleston SC,11522,2640.25,1
2012-03-07,09:00:00,Spotify,-12.0,Oviedo FL,32765,3954.95,0
2012-03-07,09:00:00,Internet,-70.0,Oviedo FL,32765,3884.95,0
2012-03-07,09:00:00,Streaming,-23.81,Oviedo FL,32765,3861.14,0
2012-03-07,17:10:00,Pep Boys,-201.25,Winter Park FL,32789,3659.89,0
2012-03-07,16:31:00,Home Depot,-112.09,Orlando FL,32816,3547.8,0
2012-03-07,07:59:00,Target,-25.67,Oviedo FL,32765,3522.13,0
2012-03-07,04:00:00,Chevron,-13.74,Winter Park FL,32789,3508.39,0
2012-03-07,00:43:00,Target,-56.41,Oviedo FL,32765,3451.98,0
2012-03-09,09:58:00,Amazon,-30.54,Winter Park FL,32789,3421.44,0
2012-03-09,05:48:00,Starbucks,-40.9,Winter Park FL,32789,3380.54,0
2012-03-09,16:41:00,Valvoline,-198.3,Winter Park FL,32789,3182.24,0
2012-03-09,11:03:00,Panera,-13.81,Orlando FL,32816,3168.43,0
2012-03-09,17:42:00,Qdoba,-28.24,Orlando FL,32816,3140.19,0
2012-03-10,11:35:00,Smoothie King,-32.02,Oviedo FL,32765,3108.17,0
2012-03-10,06:39:00,Gamestop,-24.91,Winter Park FL,32789,3083.26,0
2012-03-10,02:15:00,Disney World,-53.41,Orlando FL,32816,3029.85,0
2012-03-10,00:37:00,Concert Tickets,-47.7,Winter Park FL,32789,2982.15,0
2012-03-11,08:00:00,Paycheck,3000.0,Oviedo FL,32765,5982.15,0
2012-03-11,12:17:00,Starbucks,-43.09,Winter Park FL,32789,5939.06,0
2012-03-11,00:54:00,Chevron,-23.66,Winter Park FL,32789,5915.4,0
2012-03-13,06:07:00,Walgreens,-16.54,Oviedo FL,32765,5898.86,0
2012-03-14,04:40:00,Home Depot,-98.01,Orlando FL,32816,5800.85,0
2012-03-14,11:59:00,Panera,-34.58,Oviedo FL,32765,5766.27,0
2012-03-14,02:21:00,Best Buy,-58.57,Oviedo FL,32765,5707.7,0
2012-03-15,13:53:00,Lowes Foods,-92.94,Orlando FL,32816,5614.76,0
2012-03-15,09:28:00,Kroger,-50.07,Oviedo FL,32765,5564.69,0
2012-03-15,05:23:00,Smoothie King,-28.74,Orlando FL,32816,5535.95,0
2012-03-15,04:04:00,Whole Foods,-83.62,Oviedo FL,32765,5452.33,0
2012-03-15,00:00:00,CVS,-31.35,Oviedo FL,32765,5420.98,0
2012-03-16,10:22:00,Subway,-20.09,Oviedo FL,32765,5400.89,0
2012-03-16,05:56:00,Lowes Foods,-106.63,Orlando FL,32816,5294.26,0
2012-03-16,02:56:00,Chevron,-23.09,Oviedo FL,32765,5271.17,0
2012-03-17,12:40:00,Whole Foods,-99.63,Orlando FL,32816,5171.54,0
2012-03-18,16:37:00,Pep Boys,-103.39,Oviedo FL,32765,5068.15,0
2012-03-19,14:00:00,McDonald's,-37.5,Oviedo FL,32765,5030.65,0
2012-03-19,08:12:00,Smoothie King,-35.13,Orlando FL,32816,4995.52,0
2012-03-19,00:09:00,Free Bitcoin,-1383.44,Los Angeles CA,17440,3612.08,1
2012-03-21,10:17:00,BP,-31.9,Orlando FL,32816,4963.62,0
2012-03-21,12:41:00,Qdoba,-32.73,Winter Park FL,32789,4930.89,0
2012-03-21,01:07:00,ComputerPart,-427.52,Charleston SC,51161,4503.37,1
2012-03-22,17:17:00,Panera,-44.96,Winter Park FL,32789,4885.93,0
2012-03-22,00:18:00,ComputerPart,-142.51,London EN,45711,4743.42,1
2012-03-24,05:55:00,Walmart,-89.8,Oviedo FL,32765,4796.13,0
2012-03-24,02:23:00,Online,-1456.77,London EN,23674,3339.36,1
2012-03-25,08:00:00,Paycheck,3000.0,Oviedo FL,32765,7796.13,0
2012-03-25,12:25:00,Subway,-10.16,Winter Park FL,32789,7785.97,0
2012-03-25,17:23:00,Smoothie King,-49.01,Winter Park FL,32789,7736.96,0
2012-03-25,06:45:00,Panera,-24.63,Orlando FL,32816,7712.33,0
2012-03-25,00:39:00,Walmart,-161.34,Orlando FL,32816,7550.99,0
2012-03-25,17:07:00,Kroger,-105.23,Oviedo FL,32765,7445.76,0
2012-03-26,00:49:00,Whole Foods,-103.93,Winter Park FL,32789,7341.83,0
2012-03-26,00:55:00,Concert Tickets,-26.33,Orlando FL,32816,7315.5,0
2012-03-26,17:36:00,Subway,-25.64,Orlando FL,32816,7289.86,0
2012-03-26,14:40:00,Amazon,-177.84,Orlando FL,32816,7112.02,0
2012-03-27,08:44:00,Movie Theater,-20.75,Orlando FL,32816,7091.27,0
2012-03-27,10:55:00,Publix,-64.17,Oviedo FL,32765,7027.1,0
2012-03-28,12:20:00,Walgreens,-37.54,Orlando FL,32816,6989.56,0
2012-03-28,00:47:00,Panera,-47.59,Oviedo FL,32765,6941.97,0
2012-03-28,04:59:00,Starbucks,-32.28,Orlando FL,32816,6909.69,0
2012-03-28,16:25:00,Smoothie King,-21.4,Orlando FL,32816,6888.29,0
2012-03-28,11:05:00,Starbucks,-44.48,Oviedo FL,32765,6843.81,0
2012-03-29,05:32:00,Kroger,-143.37,Oviedo FL,32765,6700.44,0
2012-03-29,04:46:00,Smoothie King,-49.05,Orlando FL,32816,6651.39,0
2012-03-29,11:42:00,Amazon,-34.63,Winter Park FL,32789,6616.76,0
2012-03-29,04:14:00,Dollar Tree,-52.45,Oviedo FL,32765,6564.31,0
2012-03-30,07:38:00,Exxon,-17.0,Oviedo FL,32765,6547.31,0
2012-03-31,11:51:00,Home Depot,-141.35,Oviedo FL,32765,6405.96,0
2012-03-31,07:51:00,Panera,-57.6,Winter Park FL,32789,6348.36,0
2012-03-31,18:54:00,Amazon,-136.72,Winter Park FL,32789,6211.64,0
2012-03-31,09:23:00,7-Eleven,-40.92,Oviedo FL,32765,6170.72,0
2012-03-31,08:33:00,Target,-97.3,Orlando FL,32816,6073.42,0
2012-04-01,09:00:00,Rent,-1428.57,Oviedo FL,32765,4644.85,0
2012-04-01,09:00:00,Insurance,-200.0,Oviedo FL,32765,4444.85,0
2012-04-01,09:00:00,Car,-281.69,Oviedo FL,32765,4163.16,0
2012-04-01,09:00:00,Utilities,-142.86,Oviedo FL,32765,4020.3,0
2012-04-01,07:09:00,Movie Rental,-64.37,Orlando FL,32816,3955.93,0
2012-04-01,02:22:00,Shell,-20.81,Oviedo FL,32765,3935.12,0
2012-04-01,14:47:00,Starbucks,-44.69,Orlando FL,32816,3890.43,0
2012-04-01,05:45:00,Smoothie King,-36.97,Winter Park FL,32789,3853.46,0
2012-04-02,12:23:00,Home Depot,-164.81,Winter Park FL,32789,3688.65,0
2012-04-02,12:41:00,Pep Boys,-156.56,Oviedo FL,32765,3532.09,0
2012-04-02,01:50:00,AutoZone,-49.08,Orlando FL,32816,3483.01,0
2012-04-02,07:18:00,Valvoline,-195.63,Oviedo FL,32765,3287.38,0
2012-04-02,06:59:00,Walmart,-56.9,Orlando FL,32816,3230.48,0
2012-04-03,13:37:00,Smoothie King,-31.93,Orlando FL,32816,3198.55,0
2012-04-03,13:03:00,AutoZone,-86.1,Winter Park FL,32789,3112.45,0
2012-04-03,11:15:00,Walmart,-111.59,Orlando FL,32816,3000.86,0
2012-04-03,15:54:00,Movie Theater,-38.67,Winter Park FL,32789,2962.19,0
2012-04-04,11:57:00,Subway,-13.06,Winter Park FL,32789,2949.13,0
2012-04-05,15:57:00,Starbucks,-14.16,Winter Park FL,32789,2934.97,0
2012-04-05,12:40:00,Amazon,-101.67,Oviedo FL,32765,2833.3,0
2012-04-05,01:35:00,Amazon,-150.58,Winter Park FL,32789,2682.72,0
2012-04-05,02:29:00,Online,-719.86,Los Angeles CA,23292,1962.86,1
2012-04-06,07:58:00,Starbucks,-27.77,Orlando FL,32816,2654.95,0
2012-04-06,16:25:00,Disney World,-63.13,Winter Park FL,32789,2591.82,0
2012-04-06,18:46:00,Amazon,-95.99,Orlando FL,32816,2495.83,0
2012-04-06,00:18:00,Starbucks,-12.52,Oviedo FL,32765,2483.31,0
2012-04-06,13:50:00,7-Eleven,-17.83,Orlando FL,32816,2465.48,0
2012-04-07,09:00:00,Spotify,-12.0,Oviedo FL,32765,2453.48,0
2012-04-07,09:00:00,Internet,-70.0,Oviedo FL,32765,2383.48,0
2012-04-07,09:00:00,Streaming,-23.81,Oviedo FL,32765,2359.67,0
2012-04-07,06:38:00,Concert Tickets,-31.55,Oviedo FL,32765,2328.12,0
2012-04-07,18:41:00,Concert Tickets,-58.92,Winter Park FL,32789,2269.2,0
2012-04-08,08:00:00,Paycheck,3000.0,Oviedo FL,32765,5269.2,0
2012-04-08,11:00:00,Publix,-87.8,Oviedo FL,32765,5181.4,0
2012-04-08,15:05:00,7-Eleven,-12.21,Oviedo FL,32765,5169.19,0
2012-04-08,02:20:00,Lowes Foods,-39.21,Orlando FL,32816,5129.98,0
2012-04-08,15:02:00,Subway,-7.34,Orlando FL,32816,5122.64,0
2012-04-09,01:38:00,Exxon,-11.76,Winter Park FL,32789,5110.88,0
2012-04-09,10:34:00,Petco,-101.85,Oviedo FL,32765,5009.03,0
2012-04-09,17:52:00,Five Below,-8.27,Oviedo FL,32765,5000.76,0
2012-04-09,10:50:00,Movie Theater,-12.99,Orlando FL,32816,4987.77,0
2012-04-09,09:17:00,Subway,-24.1,Oviedo FL,32765,4963.67,0
2012-04-10,08:30:00,McDonald's,-6.7,Oviedo FL,32765,4956.97,0
2012-04-10,10:06:00,Starbucks,-8.56,Winter Park FL,32789,4948.41,0
2012-04-10,07:45:00,Petco,-131.83,Oviedo FL,32765,4816.58,0
2012-04-10,03:20:00,Petco,-31.06,Orlando FL,32816,4785.52,0
2012-04-10,07:49:00,Target,-80.53,Winter Park FL,32789,4704.99,0
2012-04-11,04:28:00,Amazon,-39.15,Orlando FL,32816,4665.84,0
2012-04-11,00:06:00,McDonald's,-36.48,Oviedo FL,32765,4629.36,0
2012-04-12,08:57:00,Target,-162.52,Winter Park FL,32789,4466.84,0
2012-04-13,05:59:00,Paypal,-1463.68,Anchorage AL,40297,3003.16,1
2012-04-14,04:53:00,Starbucks,-6.74,Orlando FL,32816,4460.1,0
2012-04-14,17:33:00,Target,-161.18,Orlando FL,32816,4298.92,0
2012-04-15,15:30:00,Qdoba,-36.87,Orlando FL,32816,4262.05,0
2012-04-15,10:06:00,Trader Joe's,-93.53,Orlando FL,32816,4168.52,0
2012-04-15,03:32:00,7-Eleven,-20.34,Orlando FL,32816,4148.18,0
2012-04-16,12:16:00,Panera,-8.37,Winter Park FL,32789,4139.81,0
2012-04-17,14:58:00,Movie Rental,-62.47,Oviedo FL,32765,4077.34,0
2012-04-17,04:28:00,Home Depot,-106.06,Oviedo FL,32765,3971.28,0
2012-04-17,07:32:00,Qdoba,-13.96,Oviedo FL,32765,3957.32,0
2012-04-17,02:50:00,Panera,-42.33,Oviedo FL,32765,3914.99,0
2012-04-18,16:35:00,McDonald's,-33.69,Oviedo FL,32765,3881.3,0
2012-04-18,04:21:00,Panera,-20.69,Orlando FL,32816,3860.61,0
2012-04-18,00:42:00,Concert Tickets,-58.39,Winter Park FL,32789,3802.22,0
2012-04-18,13:12:00,Starbucks,-42.54,Winter Park FL,32789,3759.68,0
2012-04-19,15:56:00,Smoothie King,-28.55,Orlando FL,32816,3731.13,0
2012-04-19,02:28:00,BP,-23.56,Orlando FL,32816,3707.57,0
2012-04-19,12:52:00,Five Below,-10.24,Winter Park FL,32789,3697.33,0
2012-04-19,04:31:00,Starbucks,-35.52,Orlando FL,32816,3661.81,0
2012-04-19,12:14:00,CVS,-53.23,Orlando FL,32816,3608.58,0
2012-04-19,05:42:00,Free Bitcoin,-650.31,Groton CT,76713,2958.27,1
2012-04-20,15:19:00,Best Buy,-29.28,Orlando FL,32816,3579.3,0
2012-04-21,07:00:00,Disney World,-36.06,Oviedo FL,32765,3543.24,0
2012-04-21,01:29:00,Panera,-33.76,Orlando FL,32816,3509.48,0
2012-04-21,08:40:00,Movie Rental,-66.65,Winter Park FL,32789,3442.83,0
2012-04-21,05:12:00,Lowes Foods,-90.08,Orlando FL,32816,3352.75,0
2012-04-21,08:28:00,Chevron,-13.78,Winter Park FL,32789,3338.97,0
2012-04-22,08:00:00,Paycheck,3000.0,Oviedo FL,32765,6338.97,0
2012-04-22,10:47:00,Movie Theater,-88.28,Orlando FL,32816,6250.69,0
2012-04-22,12:33:00,Subway,-47.17,Oviedo FL,32765,6203.52,0
2012-04-23,11:23:00,Smoothie King,-44.59,Oviedo FL,32765,6158.93,0
2012-04-23,05:15:00,Take5,-328.82,Oviedo FL,32765,5830.11,0
2012-04-25,15:20:00,Racetrac,-16.21,Oviedo FL,32765,5813.9,0
2012-04-25,06:06:00,McDonald's,-28.23,Winter Park FL,32789,5785.67,0
2012-04-25,00:02:00,Subway,-25.33,Oviedo FL,32765,5760.34,0
2012-04-25,07:12:00,Starbucks,-21.06,Winter Park FL,32789,5739.28,0
2012-04-25,07:59:00,Home Depot,-59.26,Oviedo FL,32765,5680.02,0
2012-04-27,05:38:00,Online,-1598.8,Pittsburgh PA,12870,4081.22,1
2012-04-28,01:48:00,Subway,-23.04,Oviedo FL,32765,5656.98,0
2012-04-28,02:31:00,Concert Tickets,-43.75,Oviedo FL,32765,5613.23,0
2012-04-28,00:53:00,Petco,-17.35,Winter Park FL,32789,5595.88,0
2012-04-28,13:44:00,Walgreens,-5.8,Orlando FL,32816,5590.08,0
2012-04-29,12:49:00,Qdoba,-34.65,Winter Park FL,32789,5555.43,0
2012-04-30,15:19:00,Qdoba,-30.45,Winter Park FL,32789,5524.98,0
2012-04-30,13:16:00,Five Below,-37.62,Orlando FL,32816,5487.36,0
2012-05-01,09:00:00,Rent,-1428.57,Oviedo FL,32765,4058.79,0
2012-05-01,09:00:00,Insurance,-200.0,Oviedo FL,32765,3858.79,0
2012-05-01,09:00:00,Car,-281.69,Oviedo FL,32765,3577.1,0
2012-05-01,09:00:00,Utilities,-142.86,Oviedo FL,32765,3434.24,0
2012-05-01,00:30:00,Online,-230.97,Pittsburgh PA,61368,3203.27,1
2012-05-02,05:14:00,CVS,-17.5,Orlando FL,32816,3416.74,0
2012-05-02,11:52:00,Subway,-26.3,Oviedo FL,32765,3390.44,0
2012-05-02,02:02:00,Subway,-31.38,Orlando FL,32816,3359.06,0
2012-05-03,15:49:00,Pep Boys,-174.31,Orlando FL,32816,3184.75,0
2012-05-03,04:29:00,Movie Theater,-33.77,Orlando FL,32816,3150.98,0
2012-05-03,08:14:00,Racetrac,-31.77,Orlando FL,32816,3119.21,0
2012-05-04,00:59:00,Kroger,-57.89,Oviedo FL,32765,3061.32,0
2012-05-04,06:31:00,Disney World,-61.8,Orlando FL,32816,2999.52,0
2012-05-04,09:54:00,Five Below,-46.06,Winter Park FL,32789,2953.46,0
2012-05-05,06:33:00,Walmart,-31.3,Oviedo FL,32765,2922.16,0
2012-05-05,18:20:00,Smoothie King,-40.7,Orlando FL,32816,2881.46,0
2012-05-05,15:36:00,Subway,-18.7,Winter Park FL,32789,2862.76,0
2012-05-05,00:01:00,Qdoba,-36.66,Orlando FL,32816,2826.1,0
2012-05-06,08:00:00,Paycheck,3000.0,Oviedo FL,32765,5826.1,0
2012-05-06,06:55:00,Panera,-33.08,Oviedo FL,32765,5793.02,0
2012-05-06,17:39:00,Movie Rental,-14.82,Winter Park FL,32789,5778.2,0
2012-05-06,16:00:00,Concert Tickets,-42.11,Winter Park FL,32789,5736.09,0
2012-05-06,10:12:00,Qdoba,-8.18,Oviedo FL,32765,5727.91,0
2012-05-06,05:51:00,Midas,-146.85,Oviedo FL,32765,5581.06,0
2012-05-07,09:00:00,Spotify,-12.0,Oviedo FL,32765,5569.06,0
2012-05-07,09:00:00,Internet,-70.0,Oviedo FL,32765,5499.06,0
2012-05-07,09:00:00,Streaming,-23.81,Oviedo FL,32765,5475.25,0
2012-05-07,08:43:00,Publix,-42.65,Winter Park FL,32789,5432.6,0
2012-05-07,01:32:00,Pep Boys,-128.99,Winter Park FL,32789,5303.61,0
2012-05-07,17:30:00,Panera,-21.55,Oviedo FL,32765,5282.06,0
2012-05-09,11:50:00,Petco,-149.78,Winter Park FL,32789,5132.28,0
2012-05-09,06:41:00,Movie Rental,-29.46,Winter Park FL,32789,5102.82,0
2012-05-09,18:27:00,Take5,-100.29,Oviedo FL,32765,5002.53,0
2012-05-09,10:49:00,Movie Rental,-34.75,Oviedo FL,32765,4967.78,0
2012-05-10,13:30:00,Disney World,-54.92,Orlando FL,32816,4912.86,0
2012-05-10,07:44:00,Whole Foods,-67.68,Winter Park FL,32789,4845.18,0
2012-05-10,12:14:00,BP,-33.0,Oviedo FL,32765,4812.18,0
2012-05-11,11:39:00,Lowes Foods,-78.28,Orlando FL,32816,4733.9,0
2012-05-11,11:27:00,Midas,-46.54,Orlando FL,32816,4687.36,0
2012-05-11,01:42:00,Panera,-11.98,Winter Park FL,32789,4675.38,0
2012-05-11,13:21:00,Subway,-33.85,Orlando FL,32816,4641.53,0
2012-05-11,16:38:00,Disney World,-54.77,Winter Park FL,32789,4586.76,0
2012-05-11,03:19:00,Online,-433.75,Honolulu HI,90367,4153.01,1
2012-05-13,18:21:00,Take5,-49.4,Orlando FL,32816,4537.36,0
2012-05-14,13:45:00,Wawa,-17.75,Oviedo FL,32765,4519.61,0
2012-05-14,13:37:00,Gamestop,-27.65,Oviedo FL,32765,4491.96,0
2012-05-14,06:11:00,McDonald's,-28.97,Winter Park FL,32789,4462.99,0
2012-05-14,07:32:00,Movie Theater,-17.03,Oviedo FL,32765,4445.96,0
2012-05-15,03:53:00,Target,-105.97,Oviedo FL,32765,4339.99,0
2012-05-15,16:52:00,Petco,-90.11,Winter Park FL,32789,4249.88,0
2012-05-15,06:06:00,CVS,-54.63,Winter Park FL,32789,4195.25,0
2012-05-16,03:53:00,Smoothie King,-45.01,Orlando FL,32816,4150.24,0
2012-05-17,11:37:00,Shell,-32.2,Orlando FL,32816,4118.04,0
2012-05-17,09:48:00,Walmart,-65.75,Winter Park FL,32789,4052.29,0
2012-05-17,03:16:00,Subway,-27.4,Orlando FL,32816,4024.89,0
2012-05-18,15:46:00,Trader Joe's,-51.47,Orlando FL,32816,3973.42,0
2012-05-18,10:44:00,Starbucks,-12.98,Winter Park FL,32789,3960.44,0
2012-05-19,11:11:00,Whole Foods,-66.93,Orlando FL,32816,3893.51,0
2012-05-19,15:12:00,Target,-79.29,Orlando FL,32816,3814.22,0
2012-05-19,01:09:00,Panera,-17.41,Orlando FL,32816,3796.81,0
2012-05-19,08:58:00,McDonald's,-10.9,Winter Park FL,32789,3785.91,0
2012-05-19,16:05:00,Walmart,-154.38,Orlando FL,32816,3631.53,0
2012-05-20,08:00:00,Paycheck,3000.0,Oviedo FL,32765,6631.53,0
2012-05-20,13:01:00,Publix,-72.86,Winter Park FL,32789,6558.67,0
2012-05-20,02:35:00,Whole Foods,-53.41,Orlando FL,32816,6505.26,0
2012-05-20,16:25:00,Panera,-16.68,Winter Park FL,32789,6488.58,0
2012-05-21,14:17:00,BP,-19.44,Orlando FL,32816,6469.14,0
2012-05-21,11:17:00,Shell,-45.99,Orlando FL,32816,6423.15,0
2012-05-21,01:21:00,Home Depot,-195.23,Winter Park FL,32789,6227.92,0
2012-05-22,16:41:00,Panera,-24.98,Orlando FL,32816,6202.94,0
2012-05-22,00:36:00,Target,-79.42,Orlando FL,32816,6123.52,0
2012-05-22,10:01:00,Gamestop,-21.18,Orlando FL,32816,6102.34,0
2012-05-23,11:09:00,Petco,-113.15,Oviedo FL,32765,5989.19,0
2012-05-23,05:47:00,Starbucks,-10.6,Winter Park FL,32789,5978.59,0
2012-05-23,18:58:00,Amazon,-161.76,Oviedo FL,32765,5816.83,0
2012-05-24,14:50:00,Disney World,-47.59,Winter Park FL,32789,5769.24,0
2012-05-24,16:40:00,Lowes Foods,-55.18,Orlando FL,32816,5714.06,0
2012-05-24,01:36:00,Smoothie King,-38.25,Winter Park FL,32789,5675.81,0
2012-05-24,08:38:00,Trader Joe's,-96.96,Orlando FL,32816,5578.85,0
2012-05-25,11:56:00,Disney World,-41.26,Orlando FL,32816,5537.59,0
2012-05-25,18:22:00,Amazon,-118.76,Orlando FL,32816,5418.83,0
2012-05-25,09:20:00,Panera,-30.32,Orlando FL,32816,5388.51,0
2012-05-25,01:51:00,Movie Rental,-24.71,Oviedo FL,32765,5363.8,0
2012-05-25,05:47:00,Lowes Foods,-42.64,Winter Park FL,32789,5321.16,0
2012-05-26,16:19:00,Starbucks,-35.46,Orlando FL,32816,5285.7,0
2012-05-26,02:03:00,Kroger,-87.97,Orlando FL,32816,5197.73,0
2012-05-26,03:23:00,Whole Foods,-91.95,Winter Park FL,32789,5105.78,0
2012-05-27,02:33:00,Free Bitcoin,-968.24,Groton CT,75741,4137.54,1
2012-05-28,13:56:00,Concert Tickets,-19.5,Oviedo FL,32765,5086.28,0
2012-05-28,04:01:00,Amazon,-66.72,Orlando FL,32816,5019.56,0
2012-05-28,06:19:00,Kroger,-64.99,Orlando FL,32816,4954.57,0
2012-05-28,06:26:00,McDonald's,-31.31,Orlando FL,32816,4923.26,0
2012-05-28,17:09:00,Best Buy,-45.59,Winter Park FL,32789,4877.67,0
2012-05-29,02:36:00,McDonald's,-17.39,Oviedo FL,32765,4860.28,0
2012-05-29,10:15:00,Shell,-27.02,Oviedo FL,32765,4833.26,0
2012-05-29,01:02:00,Shell,-32.89,Winter Park FL,32789,4800.37,0
2012-05-29,05:41:00,Panera,-37.15,Winter Park FL,32789,4763.22,0
2012-05-29,04:09:00,Paypal,-1401.5,Tokyo JP,83880,3361.72,1
2012-05-30,14:01:00,Racetrac,-17.25,Orlando FL,32816,4745.97,0
2012-05-30,10:49:00,Walgreens,-52.85,Oviedo FL,32765,4693.12,0
2012-05-30,12:09:00,BP,-21.87,Oviedo FL,32765,4671.25,0
2012-05-30,01:08:00,Panera,-34.29,Winter Park FL,32789,4636.96,0
2012-05-31,00:33:00,Trader Joe's,-86.6,Orlando FL,32816,4550.36,0
2012-05-31,05:54:00,Best Buy,-63.31,Orlando FL,32816,4487.05,0
2012-05-31,03:23:00,AutoZone,-161.13,Orlando FL,32816,4325.92,0
2012-06-01,09:00:00,Rent,-1428.57,Oviedo FL,32765,2897.35,0
2012-06-01,09:00:00,Insurance,-200.0,Oviedo FL,32765,2697.35,0
2012-06-01,09:00:00,Car,-281.69,Oviedo FL,32765,2415.66,0
2012-06-01,09:00:00,Utilities,-142.86,Oviedo FL,32765,2272.8,0
2012-06-01,17:43:00,Starbucks,-37.87,Oviedo FL,32765,2234.93,0
2012-06-01,06:56:00,Concert Tickets,-47.14,Winter Park FL,32789,2187.79,0
2012-06-01,16:28:00,Smoothie King,-41.55,Winter Park FL,32789,2146.24,0
2012-06-02,15:59:00,Smoothie King,-38.3,Winter Park FL,32789,2107.94,0
2012-06-03,08:00:00,Paycheck,3000.0,Oviedo FL,32765,5107.94,0
2012-06-05,17:13:00,Movie Rental,-65.75,Orlando FL,32816,5042.19,0
2012-06-05,03:10:00,ComputerPart,-1379.12,Charleston SC,24601,3663.07,1
2012-06-06,18:44:00,Subway,-41.45,Winter Park FL,32789,5000.74,0
2012-06-07,09:00:00,Spotify,-12.0,Oviedo FL,32765,4988.74,0
2012-06-07,09:00:00,Internet,-70.0,Oviedo FL,32765,4918.74,0
2012-06-07,09:00:00,Streaming,-23.81,Oviedo FL,32765,4894.93,0
2012-06-08,07:42:00,Panera,-17.26,Orlando FL,32816,4877.67,0
2012-06-08,15:58:00,CVS,-37.63,Oviedo FL,32765,4840.04,0
2012-06-08,06:30:00,Wawa,-26.08,Oviedo FL,32765,4813.96,0
2012-06-08,14:41:00,Panera,-24.7,Orlando FL,32816,4789.26,0
2012-06-08,08:57:00,Midas,-221.49,Orlando FL,32816,4567.77,0
2012-06-08,00:15:00,Free Bitcoin,-1009.34,Los Angeles CA,97966,3558.43,1
2012-06-09,03:48:00,Chevron,-12.6,Oviedo FL,32765,4555.17,0
2012-06-09,12:05:00,Concert Tickets,-52.39,Orlando FL,32816,4502.78,0
2012-06-09,00:58:00,Online,-1416.84,London EN,16717,3085.94,1
2012-06-10,18:46:00,Shell,-18.21,Winter Park FL,32789,4484.57,0
2012-06-10,13:31:00,Trader Joe's,-44.77,Orlando FL,32816,4439.8,0
2012-06-10,04:08:00,Movie Rental,-51.23,Winter Park FL,32789,4388.57,0
2012-06-11,09:07:00,Panera,-32.2,Orlando FL,32816,4356.37,0
2012-06-11,02:18:00,Walmart,-145.71,Orlando FL,32816,4210.66,0
2012-06-11,14:39:00,Valvoline,-149.84,Oviedo FL,32765,4060.82,0
2012-06-11,01:54:00,Petco,-142.07,Winter Park FL,32789,3918.75,0
2012-06-12,18:46:00,Take5,-86.88,Oviedo FL,32765,3831.87,0
2012-06-12,09:24:00,Disney World,-54.76,Winter Park FL,32789,3777.11,0
2012-06-12,15:03:00,Whole Foods,-61.65,Winter Park FL,32789,3715.46,0
2012-06-12,02:57:00,Dollar Tree,-9.1,Oviedo FL,32765,3706.36,0
2012-06-12,05:48:00,AutoZone,-175.91,Winter Park FL,32789,3530.45,0
2012-06-13,05:02:00,McDonald's,-8.26,Winter Park FL,32789,3522.19,0
2012-06-13,03:35:00,Five Below,-21.49,Oviedo FL,32765,3500.7,0
2012-06-14,02:08:00,Subway,-40.5,Oviedo FL,32765,3460.2,0
2012-06-14,14:46:00,Gamestop,-12.51,Oviedo FL,32765,3447.69,0
2012-06-14,13:52:00,Disney World,-21.51,Orlando FL,32816,3426.18,0
2012-06-14,03:59:00,Online,-1727.95,Anchorage AL,56472,1698.23,1
2012-06-15,04:00:00,Starbucks,-39.49,Winter Park FL,32789,3386.69,0
2012-06-15,10:58:00,Take5,-211.95,Winter Park FL,32789,3174.74,0
2012-06-15,04:21:00,Take5,-71.86,Orlando FL,32816,3102.88,0
2012-06-16,16:39:00,Target,-77.43,Oviedo FL,32765,3025.45,0
2012-06-16,14:19:00,Home Depot,-167.47,Winter Park FL,32789,2857.98,0
2012-06-16,17:48:00,McDonald's,-28.63,Oviedo FL,32765,2829.35,0
2012-06-16,03:07:00,Exxon,-20.53,Oviedo FL,32765,2808.82,0
2012-06-16,12:54:00,Shell,-25.23,Winter Park FL,32789,2783.59,0
2012-06-17,08:00:00,Paycheck,3000.0,Oviedo FL,32765,5783.59,0
2012-06-17,08:02:00,Qdoba,-33.01,Winter Park FL,32789,5750.58,0
2012-06-17,14:16:00,7-Eleven,-20.87,Orlando FL,32816,5729.71,0
2012-06-17,01:08:00,Movie Theater,-37.01,Oviedo FL,32765,5692.7,0
2012-06-17,06:52:00,Concert Tickets,-66.14,Winter Park FL,32789,5626.56,0
2012-06-17,00:52:00,Exxon,-26.39,Orlando FL,32816,5600.17,0
2012-06-18,06:20:00,Starbucks,-35.41,Winter Park FL,32789,5564.76,0
2012-06-18,14:30:00,Concert Tickets,-15.88,Orlando FL,32816,5548.88,0
2012-06-18,08:42:00,Starbucks,-8.54,Orlando FL,32816,5540.34,0
2012-06-19,17:04:00,Best Buy,-107.08,Orlando FL,32816,5433.26,0
2012-06-19,16:11:00,Smoothie King,-44.62,Orlando FL,32816,5388.64,0
2012-06-19,10:04:00,Movie Rental,-58.56,Winter Park FL,32789,5330.08,0
2012-06-20,13:21:00,Exxon,-26.42,Oviedo FL,32765,5303.66,0
2012-06-20,13:45:00,Racetrac,-27.57,Winter Park FL,32789,5276.09,0
2012-06-20,04:29:00,Home Depot,-145.36,Oviedo FL,32765,5130.73,0
2012-06-20,12:19:00,Trader Joe's,-35.85,Orlando FL,32816,5094.88,0
2012-06-20,11:42:00,Midas,-153.61,Winter Park FL,32789,4941.27,0
2012-06-20,03:12:00,ComputerPart,-158.56,Anchorage AL,43322,4782.71,1
2012-06-21,09:04:00,Shell,-19.65,Oviedo FL,32765,4921.62,0
2012-06-21,16:23:00,Panera,-36.66,Oviedo FL,32765,4884.96,0
2012-06-21,01:24:00,Walgreens,-37.68,Oviedo FL,32765,4847.28,0
2012-06-21,02:02:00,Qdoba,-24.53,Winter Park FL,32789,4822.75,0
2012-06-22,13:51:00,Qdoba,-26.14,Winter Park FL,32789,4796.61,0
2012-06-22,02:56:00,Qdoba,-27.77,Orlando FL,32816,4768.84,0
2012-06-23,16:06:00,Petco,-105.33,Winter Park FL,32789,4663.51,0
2012-06-23,01:10:00,Dollar Tree,-17.46,Oviedo FL,32765,4646.05,0
2012-06-23,13:49:00,Kroger,-63.84,Winter Park FL,32789,4582.21,0
2012-06-23,04:32:00,Starbucks,-27.15,Winter Park FL,32789,4555.06,0
2012-06-24,16:12:00,Take5,-112.74,Oviedo FL,32765,4442.32,0
2012-06-24,12:14:00,Publix,-51.0,Orlando FL,32816,4391.32,0
2012-06-24,07:18:00,Panera,-10.31,Winter Park FL,32789,4381.01,0
2012-06-25,06:11:00,Chevron,-24.19,Winter Park FL,32789,4356.82,0
2012-06-25,15:00:00,Pep Boys,-169.67,Orlando FL,32816,4187.15,0
2012-06-25,14:27:00,Whole Foods,-70.58,Oviedo FL,32765,4116.57,0
2012-06-26,08:52:00,Racetrac,-31.52,Winter Park FL,32789,4085.05,0
2012-06-28,08:14:00,Smoothie King,-10.31,Orlando FL,32816,4074.74,0
2012-06-28,13:58:00,Target,-166.41,Orlando FL,32816,3908.33,0
2012-06-29,09:15:00,Amazon,-48.3,Orlando FL,32816,3860.03,0
2012-06-29,01:28:00,Subway,-8.56,Oviedo FL,32765,3851.47,0
2012-07-01,08:00:00,Paycheck,3000.0,Oviedo FL,32765,6851.47,0
2012-07-01,09:00:00,Rent,-1428.57,Oviedo FL,32765,5422.9,0
2012-07-01,09:00:00,Insurance,-200.0,Oviedo FL,32765,5222.9,0
2012-07-01,09:00:00,Car,-281.69,Oviedo FL,32765,4941.21,0
2012-07-01,09:00:00,Utilities,-142.86,Oviedo FL,32765,4798.35,0
2012-07-01,05:40:00,Walmart,-166.66,Orlando FL,32816,4631.69,0
2012-07-01,15:32:00,Subway,-16.36,Winter Park FL,32789,4615.33,0
2012-07-01,04:50:00,Disney World,-67.12,Orlando FL,32816,4548.21,0
2012-07-02,02:02:00,Panera,-7.57,Winter Park FL,32789,4540.64,0
2012-07-02,07:08:00,Subway,-31.23,Winter Park FL,32789,4509.41,0
2012-07-02,09:53:00,Movie Rental,-30.54,Orlando FL,32816,4478.87,0
2012-07-02,00:13:00,Qdoba,-38.28,Oviedo FL,32765,4440.59,0
2012-07-03,13:03:00,Concert Tickets,-45.97,Orlando FL,32816,4394.62,0
2012-07-03,12:53:00,Qdoba,-22.64,Oviedo FL,32765,4371.98,0
2012-07-05,15:06:00,Shell,-22.2,Winter Park FL,32789,4349.78,0
2012-07-05,14:03:00,McDonald's,-40.87,Oviedo FL,32765,4308.91,0
2012-07-05,16:20:00,Home Depot,-24.75,Oviedo FL,32765,4284.16,0
2012-07-06,16:48:00,Exxon,-24.05,Oviedo FL,32765,4260.11,0
2012-07-06,16:19:00,Petco,-116.28,Oviedo FL,32765,4143.83,0
2012-07-06,18:12:00,Qdoba,-15.61,Orlando FL,32816,4128.22,0
2012-07-06,01:59:00,Valvoline,-75.58,Orlando FL,32816,4052.64,0
2012-07-06,09:16:00,Walgreens,-41.4,Oviedo FL,32765,4011.24,0
2012-07-07,09:00:00,Spotify,-12.0,Oviedo FL,32765,3999.24,0
2012-07-07,09:00:00,Internet,-70.0,Oviedo FL,32765,3929.24,0
2012-07-07,09:00:00,Streaming,-23.81,Oviedo FL,32765,3905.43,0
2012-07-07,10:19:00,Panera,-32.39,Oviedo FL,32765,3873.04,0
2012-07-07,13:09:00,Petco,-80.19,Winter Park FL,32789,3792.85,0
2012-07-07,01:21:00,Lowes Foods,-50.51,Winter Park FL,32789,3742.34,0
2012-07-07,02:17:00,Amazon,-15.57,Orlando FL,32816,3726.77,0
2012-07-07,11:19:00,7-Eleven,-26.5,Oviedo FL,32765,3700.27,0
2012-07-08,15:52:00,Subway,-41.33,Orlando FL,32816,3658.94,0
2012-07-09,12:30:00,Shell,-19.13,Oviedo FL,32765,3639.81,0
2012-07-11,04:20:00,Paypal,-1546.04,Tokyo JP,66451,2093.77,1
2012-07-12,01:43:00,Home Depot,-47.83,Orlando FL,32816,3591.98,0
2012-07-12,18:18:00,7-Eleven,-28.0,Oviedo FL,32765,3563.98,0
2012-07-12,11:09:00,Valvoline,-210.64,Orlando FL,32816,3353.34,0
2012-07-12,14:50:00,Chevron,-11.58,Orlando FL,32816,3341.76,0
2012-07-13,15:00:00,CVS,-15.64,Oviedo FL,32765,3326.12,0
2012-07-13,05:06:00,Petco,-80.94,Winter Park FL,32789,3245.18,0
2012-07-13,05:32:00,Five Below,-43.43,Oviedo FL,32765,3201.75,0
2012-07-13,09:21:00,Concert Tickets,-36.21,Oviedo FL,32765,3165.54,0
2012-07-14,15:03:00,Smoothie King,-12.33,Oviedo FL,32765,3153.21,0
2012-07-15,08:00:00,Paycheck,3000.0,Oviedo FL,32765,6153.21,0
2012-07-15,00:07:00,Target,-222.64,Oviedo FL,32765,5930.57,0
2012-07-15,12:02:00,Kroger,-107.48,Winter Park FL,32789,5823.09,0
2012-07-15,09:54:00,Subway,-30.39,Orlando FL,32816,5792.7,0
2012-07-15,17:51:00,CVS,-52.66,Orlando FL,32816,5740.04,0
2012-07-16,17:57:00,Petco,-16.55,Oviedo FL,32765,5723.49,0
2012-07-16,04:18:00,Starbucks,-24.51,Orlando FL,32816,5698.98,0
2012-07-16,15:20:00,Smoothie King,-36.08,Orlando FL,32816,5662.9,0
2012-07-16,09:29:00,Concert Tickets,-41.81,Oviedo FL,32765,5621.09,0
2012-07-17,04:15:00,Take5,-75.56,Winter Park FL,32789,5545.53,0
2012-07-17,11:24:00,Home Depot,-15.89,Oviedo FL,32765,5529.64,0
2012-07-17,10:45:00,Whole Foods,-45.37,Oviedo FL,32765,5484.27,0
2012-07-17,01:00:00,Exxon,-22.75,Winter Park FL,32789,5461.52,0
2012-07-17,16:02:00,Starbucks,-7.58,Winter Park FL,32789,5453.94,0
2012-07-18,02:31:00,Shell,-27.95,Oviedo FL,32765,5425.99,0
2012-07-18,07:29:00,Smoothie King,-12.19,Oviedo FL,32765,5413.8,0
2012-07-18,08:31:00,Lowes Foods,-111.83,Winter Park FL,32789,5301.97,0
2012-07-18,04:40:00,Smoothie King,-42.57,Oviedo FL,32765,5259.4,0
2012-07-19,18:44:00,Best Buy,-47.58,Orlando FL,32816,5211.82,0
2012-07-19,05:57:00,Walmart,-59.48,Winter Park FL,32789,5152.34,0
2012-07-19,15:28:00,Walmart,-20.92,Oviedo FL,32765,5131.42,0
2012-07-19,03:56:00,Trader Joe's,-73.6,Orlando FL,32816,5057.82,0
2012-07-19,06:29:00,Disney World,-12.1,Orlando FL,32816,5045.72,0
2012-07-20,13:58:00,Qdoba,-8.17,Orlando FL,32816,5037.55,0
2012-07-20,04:03:00,Best Buy,-19.17,Winter Park FL,32789,5018.38,0
2012-07-20,07:49:00,Walgreens,-44.82,Winter Park FL,32789,4973.56,0
2012-07-20,10:35:00,Subway,-42.11,Winter Park FL,32789,4931.45,0
2012-07-20,04:57:00,Panera,-44.18,Orlando FL,32816,4887.27,0
2012-07-21,01:42:00,Unknown,-1639.17,Tokyo JP,99371,3248.1,1
2012-07-22,05:30:00,Shell,-26.46,Oviedo FL,32765,4860.81,0
2012-07-22,16:15:00,Qdoba,-18.16,Oviedo FL,32765,4842.65,0
2012-07-23,10:19:00,McDonald's,-37.26,Orlando FL,32816,4805.39,0
2012-07-23,14:10:00,Trader Joe's,-78.75,Orlando FL,32816,4726.64,0
2012-07-23,10:33:00,Starbucks,-12.19,Oviedo FL,32765,4714.45,0
2012-07-23,00:28:00,Exxon,-25.51,Oviedo FL,32765,4688.94,0
2012-07-23,11:28:00,Starbucks,-25.27,Oviedo FL,32765,4663.67,0
2012-07-25,05:18:00,Free Bitcoin,-1691.96,Los Angeles CA,37435,2971.71,1
2012-07-26,02:40:00,Trader Joe's,-53.31,Winter Park FL,32789,4610.36,0
2012-07-26,14:56:00,Walmart,-13.8,Winter Park FL,32789,4596.56,0
2012-07-26,15:39:00,Walgreens,-27.19,Oviedo FL,32765,4569.37,0
2012-07-27,15:10:00,McDonald's,-42.52,Orlando FL,32816,4526.85,0
2012-07-27,07:50:00,Exxon,-24.16,Orlando FL,32816,4502.69,0
2012-07-27,07:20:00,McDonald's,-16.51,Oviedo FL,32765,4486.18,0
2012-07-28,00:31:00,Concert Tickets,-12.52,Winter Park FL,32789,4473.66,0
2012-07-28,06:39:00,Smoothie King,-39.1,Winter Park FL,32789,4434.56,0
2012-07-28,07:07:00,Panera,-20.83,Winter Park FL,32789,4413.73,0
2012-07-28,03:08:00,Whole Foods,-50.31,Winter Park FL,32789,4363.42,0
2012-07-29,08:00:00,Paycheck,3000.0,Oviedo FL,32765,7363.42,0
2012-07-30,05:32:00,Shell,-37.79,Orlando FL,32816,7325.63,0
2012-07-31,00:14:00,User,-576.25,Mexico City MC,80492,6749.38,1
2012-08-01,09:00:00,Rent,-1428.57,Oviedo FL,32765,5897.06,0
2012-08-01,09:00:00,Insurance,-200.0,Oviedo FL,32765,5697.06,0
2012-08-01,09:00:00,Car,-281.69,Oviedo FL,32765,5415.37,0
2012-08-01,09:00:00,Utilities,-142.86,Oviedo FL,32765,5272.51,0
2012-08-01,13:23:00,Subway,-42.81,Orlando FL,32816,5229.7,0
2012-08-01,01:36:00,Publix,-34.2,Winter Park FL,32789,5195.5,0
2012-08-02,18:23:00,Movie Theater,-52.3,Orlando FL,32816,5143.2,0
2012-08-03,12:16:00,Concert Tickets,-62.41,Winter Park FL,32789,5080.79,0
2012-08-03,10:53:00,Disney World,-13.75,Orlando FL,32816,5067.04,0
2012-08-03,04:02:00,Panera,-13.22,Orlando FL,32816,5053.82,0
2012-08-03,16:13:00,Racetrac,-11.92,Oviedo FL,32765,5041.9,0
2012-08-03,12:04:00,Subway,-7.38,Oviedo FL,32765,5034.52,0
2012-08-04,09:43:00,Best Buy,-31.89,Oviedo FL,32765,5002.63,0
2012-08-04,04:57:00,Petco,-48.55,Orlando FL,32816,4954.08,0
2012-08-04,13:17:00,Amazon,-81.41,Orlando FL,32816,4872.67,0
2012-08-04,15:29:00,Panera,-37.53,Oviedo FL,32765,4835.14,0
2012-08-05,08:16:00,Movie Theater,-18.87,Orlando FL,32816,4816.27,0
2012-08-05,11:55:00,McDonald's,-16.43,Orlando FL,32816,4799.84,0
2012-08-05,14:06:00,Target,-101.92,Orlando FL,32816,4697.92,0
2012-08-05,17:44:00,Smoothie King,-44.69,Orlando FL,32816,4653.23,0
2012-08-06,07:22:00,Starbucks,-41.21,Winter Park FL,32789,4612.02,0
2012-08-06,15:42:00,Movie Theater,-38.82,Orlando FL,32816,4573.2,0
2012-08-06,18:41:00,Starbucks,-44.9,Oviedo FL,32765,4528.3,0
2012-08-06,03:58:00,Disney World,-44.97,Orlando FL,32816,4483.33,0
2012-08-06,02:49:00,CVS,-19.59,Winter Park FL,32789,4463.74,0
2012-08-07,09:00:00,Spotify,-12.0,Oviedo FL,32765,4451.74,0
2012-08-07,09:00:00,Internet,-70.0,Oviedo FL,32765,4381.74,0
2012-08-07,09:00:00,Streaming,-23.81,Oviedo FL,32765,4357.93,0
2012-08-07,10:48:00,Walgreens,-24.89,Oviedo FL,32765,4333.04,0
2012-08-07,13:20:00,Take5,-186.87,Oviedo FL,32765,4146.17,0
2012-08-07,07:49:00,Starbucks,-40.26,Winter Park FL,32789,4105.91,0
2012-08-07,14:20:00,Panera,-17.24,Winter Park FL,32789,4088.67,0
2012-08-08,00:48:00,Lowes Foods,-69.07,Winter Park FL,32789,4019.6,0
2012-08-08,02:00:00,Panera,-27.03,Orlando FL,32816,3992.57,0
2012-08-09,04:18:00,Disney World,-23.1,Oviedo FL,32765,3969.47,0
2012-08-09,10:20:00,CVS,-40.15,Winter Park FL,32789,3929.32,0
2012-08-09,05:39:00,Amazon,-125.18,Winter Park FL,32789,3804.14,0
2012-08-09,03:52:00,Trader Joe's,-49.04,Oviedo FL,32765,3755.1,0
2012-08-09,04:56:00,McDonald's,-38.08,Orlando FL,32816,3717.02,0
2012-08-10,08:44:00,Kroger,-50.03,Oviedo FL,32765,3666.99,0
2012-08-10,00:40:00,Publix,-49.62,Oviedo FL,32765,3617.37,0
2012-08-12,08:00:00,Paycheck,3000.0,Oviedo FL,32765,6617.37,0
2012-08-12,08:52:00,Petco,-27.23,Orlando FL,32816,6590.14,0
2012-08-12,00:50:00,Dollar Tree,-15.52,Orlando FL,32816,6574.62,0
2012-08-12,06:51:00,Walmart,-23.59,Oviedo FL,32765,6551.03,0
2012-08-12,08:00:00,Kroger,-125.93,Winter Park FL,32789,6425.1,0
2012-08-12,06:56:00,Starbucks,-31.89,Orlando FL,32816,6393.21,0
2012-08-13,15:41:00,Petco,-20.86,Orlando FL,32816,6372.35,0
2012-08-13,11:18:00,Smoothie King,-31.45,Winter Park FL,32789,6340.9,0
2012-08-13,17:11:00,Subway,-28.51,Orlando FL,32816,6312.39,0
2012-08-14,09:18:00,Qdoba,-44.84,Oviedo FL,32765,6267.55,0
2012-08-14,18:28:00,Walmart,-203.19,Oviedo FL,32765,6064.36,0
2012-08-14,01:25:00,CVS,-51.23,Orlando FL,32816,6013.13,0
2012-08-14,14:07:00,McDonald's,-45.68,Orlando FL,32816,5967.45,0
2012-08-14,14:54:00,McDonald's,-36.3,Orlando FL,32816,5931.15,0
2012-08-14,04:08:00,Free Bitcoin,-1002.65,New York NY,99373,4928.5,1
2012-08-15,01:41:00,Panera,-40.34,Orlando FL,32816,5890.81,0
2012-08-15,13:50:00,Home Depot,-67.74,Orlando FL,32816,5823.07,0
2012-08-15,11:27:00,BP,-14.56,Winter Park FL,32789,5808.51,0
2012-08-16,07:44:00,Racetrac,-18.46,Winter Park FL,32789,5790.05,0
2012-08-17,18:40:00,Qdoba,-25.15,Winter Park FL,32789,5764.9,0
2012-08-17,03:31:00,Walgreens,-29.22,Oviedo FL,32765,5735.68,0
2012-08-17,10:30:00,Panera,-21.68,Orlando FL,32816,5714.0,0
2012-08-17,18:35:00,Smoothie King,-41.93,Oviedo FL,32765,5672.07,0
2012-08-18,06:29:00,Subway,-9.46,Oviedo FL,32765,5662.61,0
2012-08-18,11:10:00,Midas,-45.58,Oviedo FL,32765,5617.03,0
2012-08-18,03:08:00,Shell,-28.55,Orlando FL,32816,5588.48,0
2012-08-19,08:28:00,Subway,-13.3,Oviedo FL,32765,5575.18,0
2012-08-19,07:59:00,Starbucks,-34.63,Orlando FL,32816,5540.55,0
2012-08-19,00:44:00,Starbucks,-16.78,Winter Park FL,32789,5523.77,0
2012-08-20,02:47:00,Gamestop,-19.22,Orlando FL,32816,5504.55,0
2012-08-21,18:50:00,Whole Foods,-97.25,Oviedo FL,32765,5407.3,0
2012-08-21,12:36:00,McDonald's,-37.1,Winter Park FL,32789,5370.2,0
2012-08-21,12:24:00,Panera,-25.34,Winter Park FL,32789,5344.86,0
2012-08-21,08:41:00,Qdoba,-6.05,Orlando FL,32816,5338.81,0
2012-08-22,17:33:00,Trader Joe's,-92.45,Winter Park FL,32789,5246.36,0
2012-08-22,02:12:00,Shell,-15.56,Winter Park FL,32789,5230.8,0
2012-08-22,12:54:00,Starbucks,-21.21,Oviedo FL,32765,5209.59,0
2012-08-22,00:22:00,Panera,-17.08,Orlando FL,32816,5192.51,0
2012-08-23,10:16:00,Target,-27.75,Oviedo FL,32765,5164.76,0
2012-08-23,07:39:00,Home Depot,-74.34,Winter Park FL,32789,5090.42,0
2012-08-24,03:38:00,Starbucks,-38.1,Orlando FL,32816,5052.32,0
2012-08-24,09:53:00,Disney World,-47.46,Winter Park FL,32789,5004.86,0
2012-08-24,05:20:00,Panera,-29.39,Oviedo FL,32765,4975.47,0
2012-08-24,12:58:00,Best Buy,-137.03,Oviedo FL,32765,4838.44,0
2012-08-25,02:51:00,Subway,-26.81,Oviedo FL,32765,4811.63,0
2012-08-25,17:33:00,Panera,-34.84,Orlando FL,32816,4776.79,0
2012-08-25,03:06:00,Starbucks,-6.4,Winter Park FL,32789,4770.39,0
2012-08-25,07:30:00,Panera,-26.57,Oviedo FL,32765,4743.82,0
2012-08-25,14:06:00,Disney World,-44.37,Oviedo FL,32765,4699.45,0
2012-08-26,08:00:00,Paycheck,3000.0,Oviedo FL,32765,7699.45,0
2012-08-27,05:32:00,Paypal,-101.28,Honolulu HI,30599,7598.17,1
2012-08-28,17:41:00,Walgreens,-63.52,Oviedo FL,32765,7635.93,0
2012-08-28,04:54:00,Petco,-75.57,Winter Park FL,32789,7560.36,0
2012-08-29,04:35:00,ComputerPart,-839.21,Honolulu HI,23356,6721.15,1
2012-08-31,10:15:00,Five Below,-43.79,Winter Park FL,32789,7516.57,0
2012-08-31,01:38:00,Qdoba,-35.14,Orlando FL,32816,7481.43,0
2012-08-31,08:52:00,Qdoba,-19.1,Winter Park FL,32789,7462.33,0
2012-09-01,09:00:00,Rent,-1428.57,Oviedo FL,32765,6033.76,0
2012-09-01,09:00:00,Insurance,-200.0,Oviedo FL,32765,5833.76,0
2012-09-01,09:00:00,Car,-281.69,Oviedo FL,32765,5552.07,0
2012-09-01,09:00:00,Utilities,-142.86,Oviedo FL,32765,5409.21,0
2012-09-01,14:35:00,Starbucks,-10.22,Winter Park FL,32789,5398.99,0
2012-09-01,17:16:00,Smoothie King,-44.59,Oviedo FL,32765,5354.4,0
2012-09-03,08:21:00,Whole Foods,-75.22,Oviedo FL,32765,5279.18,0
2012-09-03,08:18:00,Concert Tickets,-43.45,Orlando FL,32816,5235.73,0
2012-09-03,03:47:00,McDonald's,-19.26,Orlando FL,32816,5216.47,0
2012-09-03,00:44:00,AutoZone,-67.85,Orlando FL,32816,5148.62,0
2012-09-04,03:05:00,Dollar Tree,-15.36,Winter Park FL,32789,5133.26,0
2012-09-04,01:00:00,Qdoba,-13.34,Oviedo FL,32765,5119.92,0
2012-09-04,05:03:00,Starbucks,-15.15,Oviedo FL,32765,5104.77,0
2012-09-04,00:16:00,Qdoba,-41.06,Oviedo FL,32765,5063.71,0
2012-09-04,16:00:00,Racetrac,-30.7,Winter Park FL,32789,5033.01,0
2012-09-05,06:12:00,Home Depot,-66.99,Orlando FL,32816,4966.02,0
2012-09-07,09:00:00,Spotify,-12.0,Oviedo FL,32765,4954.02,0
2012-09-07,09:00:00,Internet,-70.0,Oviedo FL,32765,4884.02,0
2012-09-07,09:00:00,Streaming,-23.81,Oviedo FL,32765,4860.21,0
2012-09-07,18:35:00,Movie Theater,-52.41,Orlando FL,32816,4807.8,0
2012-09-07,11:44:00,Panera,-12.39,Oviedo FL,32765,4795.41,0
2012-09-07,16:01:00,Petco,-159.63,Oviedo FL,32765,4635.78,0
2012-09-08,18:41:00,Qdoba,-36.74,Winter Park FL,32789,4599.04,0
2012-09-09,08:00:00,Paycheck,3000.0,Oviedo FL,32765,7599.04,0
2012-09-09,00:49:00,Petco,-192.2,Orlando FL,32816,7406.84,0
2012-09-09,03:00:00,Petco,-236.59,Orlando FL,32816,7170.25,0
2012-09-09,15:26:00,Smoothie King,-21.57,Winter Park FL,32789,7148.68,0
2012-09-09,00:14:00,Smoothie King,-61.64,Orlando FL,32816,7087.04,0
2012-09-10,16:31:00,Petco,-25.08,Winter Park FL,32789,7061.96,0
2012-09-10,05:00:00,Paypal,-1450.27,Mexico City MC,48753,5611.69,1
2012-09-11,10:21:00,Movie Rental,-101.39,Oviedo FL,32765,6960.57,0
2012-09-11,14:40:00,Shell,-34.31,Orlando FL,32816,6926.26,0
2012-09-11,05:30:00,Lowes Foods,-118.46,Oviedo FL,32765,6807.8,0
2012-09-11,17:16:00,Qdoba,-21.74,Winter Park FL,32789,6786.06,0
2012-09-12,10:15:00,Walmart,-123.52,Oviedo FL,32765,6662.54,0
2012-09-12,01:06:00,Concert Tickets,-32.18,Winter Park FL,32789,6630.36,0
2012-09-12,14:33:00,Valvoline,-240.68,Winter Park FL,32789,6389.68,0
2012-09-12,10:49:00,CVS,-54.95,Winter Park FL,32789,6334.73,0
2012-09-12,16:25:00,Valvoline,-227.56,Winter Park FL,32789,6107.17,0
2012-09-13,07:09:00,Best Buy,-138.0,Winter Park FL,32789,5969.17,0
2012-09-13,11:22:00,Walgreens,-39.06,Orlando FL,32816,5930.11,0
2012-09-13,14:27:00,Smoothie King,-12.61,Oviedo FL,32765,5917.5,0
2012-09-13,01:26:00,Lowes Foods,-52.14,Oviedo FL,32765,5865.36,0
2012-09-14,03:55:00,Whole Foods,-106.42,Orlando FL,32816,5758.94,0
2012-09-14,07:28:00,Gamestop,-40.01,Orlando FL,32816,5718.93,0
2012-09-14,11:03:00,Shell,-30.99,Winter Park FL,32789,5687.94,0
2012-09-14,04:13:00,Starbucks,-39.93,Orlando FL,32816,5648.01,0
2012-09-14,05:52:00,Lowes Foods,-40.44,Orlando FL,32816,5607.57,0
2012-09-15,15:28:00,Kroger,-61.85,Orlando FL,32816,5545.72,0
2012-09-15,03:55:00,CVS,-51.36,Oviedo FL,32765,5494.36,0
2012-09-15,04:17:00,Dollar Tree,-20.14,Winter Park FL,32789,5474.22,0
2012-09-15,09:57:00,Panera,-13.41,Orlando FL,32816,5460.81,0
2012-09-15,18:33:00,McDonald's,-22.52,Orlando FL,32816,5438.29,0
2012-09-15,04:25:00,User,-1495.13,Mexico City MC,52921,3943.16,1
2012-09-16,09:45:00,Walgreens,-38.57,Winter Park FL,32789,5399.72,0
2012-09-16,14:35:00,Movie Theater,-25.95,Oviedo FL,32765,5373.77,0
2012-09-17,03:07:00,Smoothie King,-20.6,Orlando FL,32816,5353.17,0
2012-09-17,03:22:00,Smoothie King,-23.19,Orlando FL,32816,5329.98,0
2012-09-18,08:57:00,Exxon,-21.71,Winter Park FL,32789,5308.27,0
2012-09-18,08:16:00,Trader Joe's,-104.61,Winter Park FL,32789,5203.66,0
2012-09-18,10:46:00,Whole Foods,-42.17,Orlando FL,32816,5161.49,0
2012-09-18,10:02:00,Gamestop,-16.11,Oviedo FL,32765,5145.38,0
2012-09-19,14:02:00,Kroger,-51.08,Winter Park FL,32789,5094.3,0
2012-09-20,07:08:00,Kroger,-109.54,Oviedo FL,32765,4984.76,0
2012-09-20,11:11:00,BP,-32.64,Orlando FL,32816,4952.12,0
2012-09-20,11:16:00,Publix,-95.4,Oviedo FL,32765,4856.72,0
2012-09-20,06:40:00,Starbucks,-17.09,Orlando FL,32816,4839.63,0
2012-09-21,10:18:00,Disney World,-54.56,Orlando FL,32816,4785.07,0
2012-09-22,05:09:00,Whole Foods,-73.3,Winter Park FL,32789,4711.77,0
2012-09-23,08:00:00,Paycheck,3000.0,Oviedo FL,32765,7711.77,0
2012-09-23,02:16:00,Movie Rental,-26.65,Orlando FL,32816,7685.12,0
2012-09-23,13:47:00,Trader Joe's,-59.27,Oviedo FL,32765,7625.85,0
2012-09-23,05:42:00,Valley,-458.73,Los Angeles CA,12316,7167.12,1
2012-09-24,11:43:00,Movie Theater,-91.64,Oviedo FL,32765,7534.21,0
2012-09-24,15:38:00,Starbucks,-40.07,Oviedo FL,32765,7494.14,0
2012-09-25,12:07:00,Five Below,-41.44,Winter Park FL,32789,7452.7,0
2012-09-26,07:52:00,Lowes Foods,-50.99,Oviedo FL,32765,7401.71,0
2012-09-27,18:35:00,Movie Theater,-37.66,Winter Park FL,32789,7364.05,0
2012-09-27,13:45:00,Movie Rental,-51.6,Orlando FL,32816,7312.45,0
2012-09-27,18:43:00,Panera,-43.96,Orlando FL,32816,7268.49,0
2012-09-27,00:12:00,Starbucks,-26.16,Orlando FL,32816,7242.33,0
2012-09-29,00:20:00,Home Depot,-203.12,Winter Park FL,32789,7039.21,0
2012-09-29,13:37:00,Petco,-157.05,Oviedo FL,32765,6882.16,0
2012-09-29,00:11:00,McDonald's,-54.27,Oviedo FL,32765,6827.89,0
2012-09-29,07:44:00,McDonald's,-41.75,Oviedo FL,32765,6786.14,0
2012-09-29,16:33:00,Gamestop,-12.2,Orlando FL,32816,6773.94,0
2012-09-30,15:16:00,BP,-45.25,Orlando FL,32816,6728.69,0
2012-10-01,09:00:00,Rent,-1428.57,Oviedo FL,32765,5300.12,0
2012-10-01,09:00:00,Insurance,-200.0,Oviedo FL,32765,5100.12,0
2012-10-01,09:00:00,Car,-281.69,Oviedo FL,32765,4818.43,0
2012-10-01,09:00:00,Utilities,-142.86,Oviedo FL,32765,4675.57,0
2012-10-02,07:25:00,Movie Rental,-60.79,Orlando FL,32816,4614.78,0
2012-10-02,10:02:00,AutoZone,-170.32,Oviedo FL,32765,4444.46,0
2012-10-02,16:49:00,Walgreens,-49.35,Orlando FL,32816,4395.11,0
2012-10-03,17:18:00,Panera,-15.3,Winter Park FL,32789,4379.81,0
2012-10-03,01:40:00,Best Buy,-146.47,Orlando FL,32816,4233.34,0
2012-10-04,08:35:00,Chevron,-15.91,Oviedo FL,32765,4217.43,0
2012-10-04,10:38:00,Whole Foods,-102.68,Winter Park FL,32789,4114.75,0
2012-10-04,18:59:00,Publix,-104.8,Winter Park FL,32789,4009.95,0
2012-10-04,16:30:00,Chevron,-16.77,Oviedo FL,32765,3993.18,0
2012-10-05,12:50:00,Racetrac,-31.7,Winter Park FL,32789,3961.48,0
2012-10-05,01:51:00,Smoothie King,-32.0,Winter Park FL,32789,3929.48,0
2012-10-06,16:42:00,Take5,-219.18,Winter Park FL,32789,3710.3,0
2012-10-07,08:00:00,Paycheck,3000.0,Oviedo FL,32765,6710.3,0
2012-10-07,09:00:00,Spotify,-12.0,Oviedo FL,32765,6698.3,0
2012-10-07,09:00:00,Internet,-70.0,Oviedo FL,32765,6628.3,0
2012-10-07,09:00:00,Streaming,-23.81,Oviedo FL,32765,6604.49,0
2012-10-07,08:09:00,Qdoba,-12.22,Orlando FL,32816,6592.27,0
2012-10-08,02:16:00,Smoothie King,-62.77,Oviedo FL,32765,6529.5,0
2012-10-09,11:42:00,Walgreens,-65.26,Orlando FL,32816,6464.24,0
2012-10-09,06:43:00,Take5,-113.83,Orlando FL,32816,6350.41,0
2012-10-09,12:21:00,Walgreens,-24.52,Winter Park FL,32789,6325.89,0
2012-10-11,18:04:00,Home Depot,-217.55,Orlando FL,32816,6108.34,0
2012-10-11,16:48:00,Home Depot,-142.21,Winter Park FL,32789,5966.13,0
2012-10-11,11:16:00,Walmart,-103.63,Orlando FL,32816,5862.5,0
2012-10-11,12:41:00,Concert Tickets,-51.11,Oviedo FL,32765,5811.39,0
2012-10-11,06:33:00,Petco,-145.55,Orlando FL,32816,5665.84,0
2012-10-12,00:08:00,Online,-1503.67,Los Angeles CA,91565,4162.17,1
2012-10-13,07:09:00,McDonald's,-22.58,Winter Park FL,32789,5643.26,0
2012-10-13,02:58:00,Walmart,-159.13,Oviedo FL,32765,5484.13,0
2012-10-13,15:16:00,Walgreens,-43.21,Orlando FL,32816,5440.92,0
2012-10-14,11:23:00,7-Eleven,-29.25,Orlando FL,32816,5411.67,0
2012-10-14,12:22:00,Smoothie King,-39.36,Oviedo FL,32765,5372.31,0
2012-10-15,17:16:00,Smoothie King,-35.36,Orlando FL,32816,5336.95,0
2012-10-15,13:32:00,Kroger,-35.93,Oviedo FL,32765,5301.02,0
2012-10-16,05:04:00,Qdoba,-38.9,Winter Park FL,32789,5262.12,0
2012-10-16,00:39:00,CVS,-46.41,Oviedo FL,32765,5215.71,0
2012-10-16,15:07:00,Whole Foods,-107.63,Orlando FL,32816,5108.08,0
2012-10-16,00:43:00,Smoothie King,-14.41,Orlando FL,32816,5093.67,0
2012-10-17,16:59:00,Smoothie King,-16.97,Orlando FL,32816,5076.7,0
2012-10-19,16:46:00,Trader Joe's,-68.45,Oviedo FL,32765,5008.25,0
2012-10-20,11:07:00,Walgreens,-22.21,Orlando FL,32816,4986.04,0
2012-10-20,05:29:00,Smoothie King,-30.05,Orlando FL,32816,4955.99,0
2012-10-21,08:00:00,Paycheck,3000.0,Oviedo FL,32765,7955.99,0
2012-10-21,01:59:00,BP,-29.44,Orlando FL,32816,7926.55,0
2012-10-21,04:19:00,Target,-231.8,Oviedo FL,32765,7694.75,0
2012-10-21,10:15:00,Walmart,-77.71,Winter Park FL,32789,7617.04,0
2012-10-21,05:38:00,Disney World,-83.54,Winter Park FL,32789,7533.5,0
2012-10-22,13:59:00,McDonald's,-67.57,Winter Park FL,32789,7465.93,0
2012-10-22,16:36:00,McDonald's,-35.07,Oviedo FL,32765,7430.86,0
2012-10-22,02:56:00,Walgreens,-21.18,Winter Park FL,32789,7409.68,0
2012-10-22,06:36:00,Movie Rental,-43.28,Winter Park FL,32789,7366.4,0
2012-10-22,18:00:00,Starbucks,-16.92,Oviedo FL,32765,7349.48,0
2012-10-23,15:43:00,Movie Theater,-20.94,Orlando FL,32816,7328.54,0
2012-10-23,02:12:00,Dollar Tree,-20.82,Oviedo FL,32765,7307.72,0
2012-10-23,11:49:00,Movie Theater,-23.7,Winter Park FL,32789,7284.02,0
2012-10-23,12:40:00,Take5,-320.84,Winter Park FL,32789,6963.18,0
2012-10-24,10:02:00,Whole Foods,-123.62,Oviedo FL,32765,6839.56,0
2012-10-24,15:07:00,Best Buy,-144.78,Orlando FL,32816,6694.78,0
2012-10-25,12:34:00,Movie Rental,-26.35,Oviedo FL,32765,6668.43,0
2012-10-25,12:06:00,Qdoba,-65.8,Winter Park FL,32789,6602.63,0
2012-10-25,02:59:00,Wawa,-44.13,Orlando FL,32816,6558.5,0
2012-10-25,10:50:00,Dollar Tree,-54.81,Oviedo FL,32765,6503.69,0
2012-10-26,13:35:00,Dollar Tree,-36.29,Winter Park FL,32789,6467.4,0
2012-10-26,13:57:00,Chevron,-29.75,Oviedo FL,32765,6437.65,0
2012-10-27,04:14:00,Shell,-50.37,Orlando FL,32816,6387.28,0
2012-10-27,09:51:00,Best Buy,-122.52,Oviedo FL,32765,6264.76,0
2012-10-27,05:37:00,Walgreens,-40.6,Oviedo FL,32765,6224.16,0
2012-10-27,00:46:00,Five Below,-44.26,Winter Park FL,32789,6179.9,0
2012-10-27,10:17:00,Trader Joe's,-104.89,Orlando FL,32816,6075.01,0
2012-10-29,11:49:00,Subway,-35.54,Oviedo FL,32765,6039.47,0
2012-10-29,06:19:00,Exxon,-38.47,Winter Park FL,32789,6001.0,0
2012-10-30,01:40:00,Best Buy,-118.26,Oviedo FL,32765,5882.74,0
2012-10-30,07:04:00,Exxon,-31.2,Oviedo FL,32765,5851.54,0
2012-10-30,08:44:00,Subway,-37.07,Winter Park FL,32789,5814.47,0
2012-10-30,02:20:00,Unknown,-576.7,Tokyo JP,39626,5237.77,1
2012-10-31,03:51:00,McDonald's,-38.95,Oviedo FL,32765,5775.52,0
2012-10-31,15:35:00,AutoZone,-105.31,Winter Park FL,32789,5670.21,0
2012-10-31,03:25:00,Walmart,-136.19,Oviedo FL,32765,5534.02,0
2012-10-31,09:36:00,Gamestop,-14.67,Oviedo FL,32765,5519.35,0
2012-10-31,01:52:00,Unknown,-828.88,Anchorage AL,84322,4690.47,1
2012-11-01,09:00:00,Rent,-1428.57,Oviedo FL,32765,4090.78,0
2012-11-01,09:00:00,Insurance,-200.0,Oviedo FL,32765,3890.78,0
2012-11-01,09:00:00,Car,-281.69,Oviedo FL,32765,3609.09,0
2012-11-01,09:00:00,Utilities,-142.86,Oviedo FL,32765,3466.23,0
2012-11-01,08:45:00,Subway,-8.96,Winter Park FL,32789,3457.27,0
2012-11-01,06:17:00,Starbucks,-25.92,Oviedo FL,32765,3431.35,0
2012-11-01,12:48:00,Movie Theater,-41.54,Winter Park FL,32789,3389.81,0
2012-11-01,10:00:00,Shell,-32.78,Oviedo FL,32765,3357.03,0
2012-11-01,18:45:00,Subway,-41.99,Orlando FL,32816,3315.04,0
2012-11-01,02:15:00,Valley,-112.42,Tokyo JP,61603,3202.62,1
2012-11-02,16:46:00,Walgreens,-48.3,Winter Park FL,32789,3266.74,0
2012-11-02,16:17:00,Concert Tickets,-28.51,Oviedo FL,32765,3238.23,0
2012-11-02,00:03:00,Starbucks,-13.69,Oviedo FL,32765,3224.54,0
2012-11-02,09:53:00,Target,-29.95,Orlando FL,32816,3194.59,0
2012-11-03,06:27:00,7-Eleven,-16.57,Winter Park FL,32789,3178.02,0
2012-11-03,04:58:00,McDonald's,-35.85,Orlando FL,32816,3142.17,0
2012-11-03,10:25:00,Starbucks,-23.81,Orlando FL,32816,3118.36,0
2012-11-03,09:30:00,7-Eleven,-12.51,Winter Park FL,32789,3105.85,0
2012-11-04,08:00:00,Paycheck,3000.0,Oviedo FL,32765,6105.85,0
2012-11-04,12:42:00,Qdoba,-28.17,Orlando FL,32816,6077.68,0
2012-11-04,03:32:00,Kroger,-128.75,Winter Park FL,32789,5948.93,0
2012-11-04,15:24:00,Subway,-27.48,Oviedo FL,32765,5921.45,0
2012-11-04,13:34:00,Petco,-33.49,Orlando FL,32816,5887.96,0
2012-11-04,07:52:00,Gamestop,-30.23,Oviedo FL,32765,5857.73,0
2012-11-05,01:13:00,Walmart,-128.43,Winter Park FL,32789,5729.3,0
2012-11-05,18:09:00,Valvoline,-159.7,Orlando FL,32816,5569.6,0
2012-11-05,14:18:00,Movie Theater,-17.03,Orlando FL,32816,5552.57,0
2012-11-05,16:57:00,Gamestop,-41.68,Orlando FL,32816,5510.89,0
2012-11-07,09:00:00,Spotify,-12.0,Oviedo FL,32765,5498.89,0
2012-11-07,09:00:00,Internet,-70.0,Oviedo FL,32765,5428.89,0
2012-11-07,09:00:00,Streaming,-23.81,Oviedo FL,32765,5405.08,0
2012-11-07,09:32:00,Dollar Tree,-5.67,Orlando FL,32816,5399.41,0
2012-11-07,11:54:00,Lowes Foods,-43.39,Oviedo FL,32765,5356.02,0
2012-11-07,17:19:00,Amazon,-153.75,Orlando FL,32816,5202.27,0
2012-11-08,06:57:00,Publix,-41.61,Oviedo FL,32765,5160.66,0
2012-11-08,01:20:00,Panera,-18.5,Winter Park FL,32789,5142.16,0
2012-11-08,11:19:00,Wawa,-25.36,Orlando FL,32816,5116.8,0
2012-11-08,16:09:00,7-Eleven,-26.01,Orlando FL,32816,5090.79,0
2012-11-10,16:31:00,CVS,-40.88,Winter Park FL,32789,5049.91,0
2012-11-10,11:19:00,Kroger,-39.08,Orlando FL,32816,5010.83,0
2012-11-10,00:22:00,Kroger,-78.38,Winter Park FL,32789,4932.45,0
2012-11-10,02:09:00,Qdoba,-34.55,Oviedo FL,32765,4897.9,0
2012-11-11,17:15:00,Publix,-88.78,Winter Park FL,32789,4809.12,0
2012-11-12,01:53:00,Walgreens,-34.45,Orlando FL,32816,4774.67,0
2012-11-12,02:16:00,Smoothie King,-39.32,Orlando FL,32816,4735.35,0
2012-11-12,15:08:00,Target,-60.38,Oviedo FL,32765,4674.97,0
2012-11-12,07:50:00,Shell,-33.59,Winter Park FL,32789,4641.38,0
2012-11-12,05:45:00,Unknown,-1427.06,Honolulu HI,81416,3214.32,1
2012-11-14,05:02:00,Chevron,-12.91,Oviedo FL,32765,4628.47,0
2012-11-14,15:29:00,Concert Tickets,-24.95,Orlando FL,32816,4603.52,0
2012-11-14,11:10:00,Lowes Foods,-71.65,Oviedo FL,32765,4531.87,0
2012-11-14,16:52:00,Walgreens,-29.37,Orlando FL,32816,4502.5,0
2012-11-15,01:44:00,Publix,-52.47,Winter Park FL,32789,4450.03,0
2012-11-15,18:23:00,Chevron,-26.92,Winter Park FL,32789,4423.11,0
2012-11-16,10:15:00,McDonald's,-24.34,Orlando FL,32816,4398.77,0
2012-11-16,08:10:00,AutoZone,-72.05,Winter Park FL,32789,4326.72,0
2012-11-17,05:57:00,Qdoba,-9.44,Oviedo FL,32765,4317.28,0
2012-11-17,13:24:00,Publix,-58.61,Orlando FL,32816,4258.67,0
2012-11-18,08:00:00,Paycheck,3000.0,Oviedo FL,32765,7258.67,0
2012-11-18,08:30:00,McDonald's,-26.75,Orlando FL,32816,7231.92,0
2012-11-18,00:23:00,Kroger,-79.32,Winter Park FL,32789,7152.6,0
2012-11-18,00:34:00,Five Below,-52.56,Orlando FL,32816,7100.04,0
2012-11-19,01:35:00,Valley,-157.25,Tokyo JP,55542,6942.79,1
2012-11-22,00:13:00,McDonald's,-53.46,Orlando FL,32816,7046.58,0
2012-11-22,16:50:00,Racetrac,-34.48,Winter Park FL,32789,7012.1,0
2012-11-23,15:58:00,7-Eleven,-20.42,Orlando FL,32816,6991.68,0
2012-11-23,10:31:00,Movie Rental,-100.46,Winter Park FL,32789,6891.22,0
2012-11-23,05:10:00,Starbucks,-61.18,Winter Park FL,32789,6830.04,0
2012-11-24,11:42:00,Racetrac,-46.61,Winter Park FL,32789,6783.43,0
2012-11-24,02:53:00,McDonald's,-46.48,Winter Park FL,32789,6736.95,0
2012-11-24,14:59:00,Panera,-23.02,Winter Park FL,32789,6713.93,0
2012-11-25,08:48:00,Subway,-31.15,Winter Park FL,32789,6682.78,0
2012-11-25,02:16:00,McDonald's,-66.57,Winter Park FL,32789,6616.21,0
2012-11-25,09:04:00,Qdoba,-66.19,Oviedo FL,32765,6550.02,0
2012-11-25,16:16:00,Publix,-121.64,Orlando FL,32816,6428.38,0
2012-11-25,02:31:00,Best Buy,-216.85,Orlando FL,32816,6211.53,0
2012-11-26,14:33:00,Smoothie King,-8.64,Oviedo FL,32765,6202.89,0
2012-11-27,11:49:00,Qdoba,-42.08,Oviedo FL,32765,6160.81,0
2012-11-28,14:57:00,Target,-127.45,Oviedo FL,32765,6033.36,0
2012-11-29,04:04:00,Walmart,-88.21,Oviedo FL,32765,5945.15,0
2012-11-30,16:45:00,Panera,-12.92,Winter Park FL,32789,5932.23,0
2012-11-30,17:16:00,McDonald's,-17.69,Oviedo FL,32765,5914.54,0
2012-11-30,18:05:00,McDonald's,-31.05,Winter Park FL,32789,5883.49,0
2012-11-30,01:08:00,Online,-954.13,Charleston SC,51003,4929.36,1
2012-12-01,09:00:00,Rent,-1428.57,Oviedo FL,32765,4454.92,0
2012-12-01,09:00:00,Insurance,-200.0,Oviedo FL,32765,4254.92,0
2012-12-01,09:00:00,Car,-281.69,Oviedo FL,32765,3973.23,0
2012-12-01,09:00:00,Utilities,-142.86,Oviedo FL,32765,3830.37,0
2012-12-01,18:04:00,Movie Rental,-12.96,Orlando FL,32816,3817.41,0
2012-12-01,12:23:00,Movie Rental,-14.24,Orlando FL,32816,3803.17,0
2012-12-01,05:22:00,Unknown,-1526.61,Mexico City MC,65248,2276.56,1
2012-12-02,08:00:00,Paycheck,3000.0,Oviedo FL,32765,6803.17,0
2012-12-02,02:14:00,McDonald's,-51.94,Oviedo FL,32765,6751.23,0
2012-12-02,07:30:00,Disney World,-58.28,Winter Park FL,32789,6692.95,0
