Date,Time,Name,Amount,Location,Zip,Balance,Fraud
2024-01-01,08:00:00,Paycheck,2000.0,Oviedo FL,32765,4000.0,0
2024-01-01,09:00:00,Rent,-960.0,Oviedo FL,32765,3040.0,0
2024-01-01,09:00:00,Insurance,-197.46,Oviedo FL,32765,2842.54,0
2024-01-01,09:00:00,Car,-300.0,Oviedo FL,32765,2542.54,0
2024-01-01,10:55:00,Subway,-14.43,Winter Park FL,32789,2528.11,0
2024-01-02,19:59:00,Paypal,-414.88,Groton CT,51858,2113.23,1
2024-01-02,14:09:00,Five Below,-13.42,Orlando FL,32816,2514.69,0
2024-01-02,12:55:00,Shell,-16.68,Winter Park FL,32789,2498.01,0
2024-01-02,13:45:00,Exxon,-12.83,Orlando FL,32816,2485.18,0
2024-01-03,20:28:00,Starbucks,-20.16,Orlando FL,32816,2465.02,0
2024-01-04,09:01:00,CVS,-38.34,Oviedo FL,32765,2426.68,0
2024-01-04,21:13:00,Magic the Gathering,-856.62,Pittsburgh PA,79001,1570.06,1
2024-01-05,16:59:00,McDonald's,-39.32,Oviedo FL,32765,2387.36,0
2024-01-06,08:26:00,Impractical Jokers,-2522.51,Los Angeles CA,48029,-135.15,1
2024-01-06,08:45:00,Subway,-7.52,Winter Park FL,32789,2379.84,0
2024-01-06,18:50:00,Netflix,-44.66,Oviedo FL,32765,2335.18,0
2024-01-06,16:56:00,Walmart,-145.29,Orlando FL,32816,2189.89,0
2024-01-07,09:00:00,Spotify,-11.99,Oviedo FL,32765,2177.9,0
2024-01-07,09:00:00,Internet,-70.89,Oviedo FL,32765,2107.01,0
2024-01-07,09:00:00,ChatGPT Plus,-20.0,Oviedo FL,32765,2087.01,0
2024-01-07,16:13:00,CVS,-10.88,Winter Park FL,32789,2076.13,0
2024-01-07,10:16:00,Burger King,-17.28,Winter Park FL,32789,2058.85,0
2024-01-08,11:14:00,Burger King,-5.79,Oviedo FL,32765,2053.06,0
2024-01-08,10:36:00,BP,-21.17,Orlando FL,32816,2031.89,0
2024-01-08,17:01:00,Burger King,-31.3,Orlando FL,32816,2000.59,0
2024-01-09,18:25:00,Accelerators,-2567.12,Anchorage AL,28507,-566.53,1
2024-01-10,13:46:00,Burger King,-20.03,Winter Park FL,32789,1980.56,0
2024-01-10,17:34:00,Subway,-32.13,Oviedo FL,32765,1948.43,0
2024-01-10,12:34:00,Five Below,-8.37,Winter Park FL,32789,1940.06,0
2024-01-11,11:32:00,Servicenow,-2767.41,London EN,91506,-827.35,1
2024-01-12,18:29:00,Pep Boys,-57.61,Oviedo FL,32765,1882.45,0
2024-01-12,10:08:00,Subway,-31.11,Winter Park FL,32789,1851.34,0
2024-01-13,03:51:00,IBM,-1955.22,Groton CT,17957,-103.88,1
2024-01-13,14:58:00,Netflix,-11.75,Orlando FL,32816,1839.59,0
2024-01-13,10:53:00,McDonald's,-12.8,Oviedo FL,32765,1826.79,0
2024-01-13,12:45:00,McDonald's,-13.81,Orlando FL,32816,1812.98,0
2024-01-15,08:00:00,Paycheck,2000.0,Oviedo FL,32765,3812.98,0
2024-01-15,14:19:00,Walgreens,-20.17,Winter Park FL,32789,3792.81,0
2024-01-16,16:03:00,Subway,-12.39,Winter Park FL,32789,3780.42,0
2024-01-16,09:17:00,Amusement Park,-33.65,Winter Park FL,32789,3746.77,0
2024-01-16,11:23:00,Kroger,-82.2,Winter Park FL,32789,3664.57,0
2024-01-17,19:30:00,Burger King,-22.51,Orlando FL,32816,3642.06,0
2024-01-19,17:14:00,Subway,-28.29,Winter Park FL,32789,3613.77,0
2024-01-19,09:03:00,Concert Tickets,-57.42,Orlando FL,32816,3556.35,0
2024-01-19,16:53:00,Concert Tickets,-44.87,Orlando FL,32816,3511.48,0
2024-01-20,14:32:00,Subway,-11.75,Orlando FL,32816,3499.73,0
2024-01-20,13:31:00,Netflix,-45.86,Orlando FL,32816,3453.87,0
2024-01-22,12:21:00,Starbucks,-20.94,Orlando FL,32816,3432.93,0
2024-01-22,16:20:00,Subway,-31.75,Winter Park FL,32789,3401.18,0
2024-01-22,12:36:00,CVS,-44.54,Orlando FL,32816,3356.64,0
2024-01-23,12:01:00,Subway,-9.74,Winter Park FL,32789,3346.9,0
2024-01-25,18:33:00,Lockheed Martin,-1759.66,Los Angeles CA,17842,1587.24,1
2024-01-26,10:28:00,CVS,-26.93,Winter Park FL,32789,3319.97,0
2024-01-27,13:52:00,Burger King,-7.73,Oviedo FL,32765,3312.24,0
2024-01-28,06:05:00,Fat Joe,-821.28,Groton CT,21579,2490.96,1
2024-01-28,13:58:00,Subway,-38.44,Orlando FL,32816,3273.8,0
2024-01-29,08:00:00,Paycheck,2000.0,Oviedo FL,32765,5273.8,0
2024-01-30,20:06:00,Burger King,-7.5,Winter Park FL,32789,5266.3,0
2024-01-30,15:24:00,Netflix,-33.04,Oviedo FL,32765,5233.26,0
2024-01-31,08:08:00,Dollar Tree,-34.24,Orlando FL,32816,5199.02,0
2024-01-31,19:43:00,Kroger,-99.84,Orlando FL,32816,5099.18,0
2024-01-31,04:05:00,Pawn Stars,-658.98,Anchorage AL,89580,4440.2,1
2024-02-01,09:00:00,Rent,-960.0,Oviedo FL,32765,4139.18,0
2024-02-01,09:00:00,Insurance,-197.46,Oviedo FL,32765,3941.72,0
2024-02-01,09:00:00,Car,-300.0,Oviedo FL,32765,3641.72,0
2024-02-01,16:15:00,Amusement Park,-12.11,Orlando FL,32816,3629.61,0
2024-02-01,10:31:00,Walmart,-148.06,Orlando FL,32816,3481.55,0
2024-02-01,09:02:00,Magic the Gathering,-2393.15,Charleston SC,73565,1088.4,1
2024-02-01,11:44:00,Burger King,-18.09,Winter Park FL,32789,3463.46,0
2024-02-02,19:30:00,Burger King,-28.08,Oviedo FL,32765,3435.38,0
2024-02-02,13:01:00,Movie Theater,-20.99,Orlando FL,32816,3414.39,0
2024-02-02,14:34:00,Starbucks,-13.62,Orlando FL,32816,3400.77,0
2024-02-04,10:21:00,Kroger,-94.62,Winter Park FL,32789,3306.15,0
2024-02-05,18:32:00,Jiffy Lube,-126.28,Oviedo FL,32765,3179.87,0
2024-02-05,12:28:00,Walgreens,-35.31,Winter Park FL,32789,3144.56,0
2024-02-05,19:41:00,Burger King,-27.65,Winter Park FL,32789,3116.91,0
2024-02-06,15:41:00,Exxon,-19.58,Oviedo FL,32765,3097.33,0
2024-02-07,09:00:00,Spotify,-11.99,Oviedo FL,32765,3085.34,0
2024-02-07,09:00:00,Internet,-70.89,Oviedo FL,32765,3014.45,0
2024-02-07,09:00:00,ChatGPT Plus,-20.0,Oviedo FL,32765,2994.45,0
2024-02-09,18:38:00,Target,-20.68,Winter Park FL,32789,2973.77,0
2024-02-09,19:05:00,McDonald's,-35.92,Winter Park FL,32789,2937.85,0
2024-02-09,12:00:00,McDonald's,-19.15,Winter Park FL,32789,2918.7,0
2024-02-11,11:37:00,McDonald's,-24.85,Winter Park FL,32789,2893.85,0
2024-02-12,08:00:00,Paycheck,2000.0,Oviedo FL,32765,4893.85,0
2024-02-12,12:25:00,Burger King,-27.0,Winter Park FL,32789,4866.85,0
2024-02-12,12:18:00,Walgreens,-9.22,Orlando FL,32816,4857.63,0
2024-02-13,16:44:00,Walmart,-15.02,Winter Park FL,32789,4842.61,0
2024-02-14,12:29:00,BP,-18.62,Winter Park FL,32789,4823.99,0
2024-02-15,08:07:00,Subway,-29.5,Winter Park FL,32789,4794.49,0
2024-02-15,10:43:00,Accelerators,-1567.28,New York NY,74170,3227.21,1
2024-02-16,16:43:00,BP,-10.33,Winter Park FL,32789,4784.16,0
2024-02-16,18:38:00,Servicenow,-1009.04,Honolulu HI,62073,3775.12,1
2024-02-18,16:03:00,Burger King,-31.22,Orlando FL,32816,4752.94,0
2024-02-18,13:38:00,Exxon,-12.53,Orlando FL,32816,4740.41,0
2024-02-19,17:29:00,Starbucks,-35.61,Winter Park FL,32789,4704.8,0
2024-02-19,13:03:00,Subway,-16.4,Oviedo FL,32765,4688.4,0
2024-02-20,19:33:00,Chevron,-21.84,Orlando FL,32816,4666.56,0
2024-02-22,11:50:00,Walmart,-74.8,Oviedo FL,32765,4591.76,0
2024-02-22,21:02:00,Burger King,-12.54,Winter Park FL,32789,4579.22,0
2024-02-23,10:01:00,Five Below,-35.15,Winter Park FL,32789,4544.07,0
2024-02-23,21:17:00,Exxon,-11.43,Winter Park FL,32789,4532.64,0
2024-02-23,21:43:00,BP,-23.29,Oviedo FL,32765,4509.35,0
2024-02-24,08:09:00,Onlyfans,-649.49,Tokyo JP,85184,3859.86,1
2024-02-24,11:03:00,BP,-11.18,Oviedo FL,32765,4498.17,0
2024-02-24,15:19:00,Publix,-62.11,Orlando FL,32816,4436.06,0
2024-02-24,15:44:00,Onlyfans,-809.91,Pyongyang NK,67766,3626.15,1
2024-02-24,08:14:00,Dollar Tree,-18.06,Winter Park FL,32789,4418.0,0
2024-02-25,12:49:00,Best Buy,-45.85,Orlando FL,32816,4372.15,0
2024-02-25,16:48:00,Burger King,-15.3,Orlando FL,32816,4356.85,0
2024-02-25,16:43:00,Burger King,-7.19,Oviedo FL,32765,4349.66,0
2024-02-26,08:00:00,Paycheck,2000.0,Oviedo FL,32765,6349.66,0
2024-02-26,12:09:00,Whole Foods,-125.84,Winter Park FL,32789,6223.82,0
2024-02-26,09:32:00,Burger King,-27.6,Oviedo FL,32765,6196.22,0
2024-02-26,20:15:00,Shell,-51.05,Oviedo FL,32765,6145.17,0
2024-02-27,20:14:00,BP,-40.5,Oviedo FL,32765,6104.67,0
2024-02-27,17:22:00,Best Buy,-192.39,Orlando FL,32816,5912.28,0
2024-02-28,21:16:00,Best Buy,-65.68,Oviedo FL,32765,5846.6,0
2024-02-28,07:07:00,Lockheed Martin,-2136.14,Pyongyang NK,74849,3710.46,1
2024-02-28,20:59:00,Amazon,-57.13,Oviedo FL,32765,5789.47,0
2024-02-28,13:44:00,Trader Joe's,-47.0,Orlando FL,32816,5742.47,0
2024-02-28,22:06:00,Fat Joe,-1452.68,New York NY,15220,4289.79,1
2024-02-29,17:44:00,Burger King,-36.72,Winter Park FL,32789,5705.75,0
2024-03-01,09:00:00,Rent,-960.0,Oviedo FL,32765,4745.75,0
2024-03-01,09:00:00,Insurance,-197.46,Oviedo FL,32765,4548.29,0
2024-03-01,09:00:00,Car,-300.0,Oviedo FL,32765,4248.29,0
2024-03-01,13:04:00,Netflix,-51.91,Oviedo FL,32765,4196.38,0
2024-03-01,13:18:00,Target,-13.96,Winter Park FL,32789,4182.42,0
2024-03-01,14:55:00,McDonald's,-9.24,Orlando FL,32816,4173.18,0
2024-03-02,17:55:00,Best Buy,-81.95,Orlando FL,32816,4091.23,0
2024-03-02,00:58:00,IBM,-395.06,Groton CT,93306,3696.17,1
2024-03-02,17:31:00,McDonald's,-12.66,Orlando FL,32816,4078.57,0
2024-03-02,18:12:00,Trader Joe's,-78.74,Orlando FL,32816,3999.83,0
2024-03-02,13:55:00,Paypal,-2611.66,Charleston SC,22928,1388.17,1
2024-03-03,20:45:00,Kroger,-93.11,Winter Park FL,32789,3906.72,0
2024-03-05,10:08:00,BP,-18.37,Oviedo FL,32765,3888.35,0
2024-03-05,14:49:00,Shell,-23.34,Winter Park FL,32789,3865.01,0
2024-03-05,21:58:00,Concert Tickets,-49.59,Orlando FL,32816,3815.42,0
2024-03-06,21:15:00,Burger King,-26.71,Winter Park FL,32789,3788.71,0
2024-03-06,09:16:00,Target,-81.62,Orlando FL,32816,3707.09,0
2024-03-07,09:00:00,Spotify,-11.99,Oviedo FL,32765,3695.1,0
2024-03-07,09:00:00,Internet,-70.89,Oviedo FL,32765,3624.21,0
2024-03-07,09:00:00,ChatGPT Plus,-20.0,Oviedo FL,32765,3604.21,0
2024-03-08,12:00:00,Onlyfans,-2246.61,Pyongyang NK,98148,1357.6,1
2024-03-08,18:18:00,Walmart,-29.67,Winter Park FL,32789,3574.54,0
2024-03-09,19:11:00,McDonald's,-27.22,Orlando FL,32816,3547.32,0
2024-03-10,19:45:00,Subway,-11.81,Orlando FL,32816,3535.51,0
2024-03-10,10:14:00,Publix,-31.77,Orlando FL,32816,3503.74,0
2024-03-10,11:43:00,Netflix,-46.33,Winter Park FL,32789,3457.41,0
2024-03-11,08:00:00,Paycheck,2000.0,Oviedo FL,32765,5457.41,0
2024-03-12,09:53:00,Burger King,-18.41,Oviedo FL,32765,5439.0,0
2024-03-12,20:34:00,Best Buy,-54.04,Oviedo FL,32765,5384.96,0
2024-03-12,17:49:00,Subway,-25.87,Winter Park FL,32789,5359.09,0
2024-03-12,15:06:00,Fraud,-2199.71,London EN,40845,3159.38,1
2024-03-13,04:56:00,Onlyfans,-1794.42,Groton CT,84259,3564.67,1
2024-03-13,10:37:00,Starbucks,-36.59,Winter Park FL,32789,5322.5,0
2024-03-14,17:49:00,Trader Joe's,-58.33,Winter Park FL,32789,5264.17,0
2024-03-14,10:26:00,Starbucks,-23.43,Winter Park FL,32789,5240.74,0
2024-03-14,13:19:00,Burger King,-23.33,Orlando FL,32816,5217.41,0
2024-03-15,01:44:00,Accelerators,-2354.31,Charleston SC,71490,2863.1,1
2024-03-15,20:20:00,Netflix,-23.91,Winter Park FL,32789,5193.5,0
2024-03-17,11:07:00,Starbucks,-34.9,Oviedo FL,32765,5158.6,0
2024-03-18,16:35:00,McDonald's,-17.65,Winter Park FL,32789,5140.95,0
2024-03-18,14:28:00,Starbucks,-38.07,Winter Park FL,32789,5102.88,0
2024-03-19,08:35:00,Amazon,-13.41,Orlando FL,32816,5089.47,0
2024-03-19,09:36:00,Burger King,-14.26,Oviedo FL,32765,5075.21,0
2024-03-21,14:43:00,Subway,-13.5,Orlando FL,32816,5061.71,0
2024-03-21,13:17:00,Starbucks,-11.54,Orlando FL,32816,5050.17,0
2024-03-22,19:46:00,Amusement Park,-51.28,Orlando FL,32816,4998.89,0
2024-03-22,10:18:00,BP,-22.58,Winter Park FL,32789,4976.31,0
2024-03-23,16:01:00,Walmart,-129.49,Winter Park FL,32789,4846.82,0
2024-03-23,09:22:00,Publix,-82.67,Oviedo FL,32765,4764.15,0
2024-03-23,15:04:00,Five Below,-20.59,Oviedo FL,32765,4743.56,0
2024-03-24,20:53:00,Paypal,-941.58,Charleston SC,67192,3801.98,1
2024-03-24,15:54:00,Whole Foods,-49.66,Orlando FL,32816,4693.9,0
2024-03-24,19:19:00,Midas,-122.88,Orlando FL,32816,4571.02,0
2024-03-25,08:00:00,Paycheck,2000.0,Oviedo FL,32765,6571.02,0
2024-03-25,14:42:00,Walmart,-207.7,Orlando FL,32816,6363.32,0
2024-03-25,16:46:00,Five Below,-68.91,Oviedo FL,32765,6294.41,0
2024-03-26,11:47:00,Concert Tickets,-73.32,Winter Park FL,32789,6221.09,0
2024-03-27,09:35:00,Publix,-106.72,Winter Park FL,32789,6114.37,0
2024-03-29,12:50:00,Magic the Gathering,-644.73,Charleston SC,61010,5469.64,1
2024-03-29,12:36:00,Netflix,-57.66,Winter Park FL,32789,6056.71,0
2024-03-29,11:25:00,Walmart,-118.29,Winter Park FL,32789,5938.42,0
2024-03-30,16:46:00,Best Buy,-126.91,Winter Park FL,32789,5811.51,0
2024-03-31,11:54:00,McDonald's,-16.58,Oviedo FL,32765,5794.93,0
2024-03-31,14:27:00,Subway,-28.6,Oviedo FL,32765,5766.33,0
2024-03-31,20:29:00,Target,-87.28,Oviedo FL,32765,5679.05,0
2024-04-01,09:00:00,Rent,-960.0,Oviedo FL,32765,4719.05,0
2024-04-01,09:00:00,Insurance,-197.46,Oviedo FL,32765,4521.59,0
2024-04-01,09:00:00,Car,-300.0,Oviedo FL,32765,4221.59,0
2024-04-02,09:30:00,Burger King,-30.31,Winter Park FL,32789,4191.28,0
2024-04-02,11:45:00,Exxon,-20.24,Orlando FL,32816,4171.04,0
2024-04-03,20:53:00,Burger King,-9.95,Orlando FL,32816,4161.09,0
2024-04-04,12:33:00,BP,-25.36,Orlando FL,32816,4135.73,0
2024-04-04,18:54:00,Amusement Park,-48.87,Oviedo FL,32765,4086.86,0
2024-04-05,11:37:00,Concert Tickets,-49.34,Orlando FL,32816,4037.52,0
2024-04-05,19:48:00,Best Buy,-63.69,Orlando FL,32816,3973.83,0
2024-04-05,07:26:00,IBM,-2162.37,Los Angeles CA,52579,1811.46,1
2024-04-05,20:40:00,McDonald's,-11.79,Winter Park FL,32789,3962.04,0
2024-04-06,15:04:00,Netflix,-33.9,Orlando FL,32816,3928.14,0
2024-04-06,08:20:00,Burger King,-20.82,Oviedo FL,32765,3907.32,0
2024-04-07,09:00:00,Spotify,-11.99,Oviedo FL,32765,3895.33,0
2024-04-07,09:00:00,Internet,-70.89,Oviedo FL,32765,3824.44,0
2024-04-07,09:00:00,ChatGPT Plus,-20.0,Oviedo FL,32765,3804.44,0
2024-04-07,10:48:00,Kroger,-99.79,Winter Park FL,32789,3704.65,0
2024-04-07,16:12:00,Burger King,-8.75,Orlando FL,32816,3695.9,0
2024-04-07,08:34:00,Amazon,-95.15,Orlando FL,32816,3600.75,0
2024-04-08,08:00:00,Paycheck,2000.0,Oviedo FL,32765,5600.75,0
2024-04-08,19:57:00,Onlyfans,-2307.4,New York NY,91786,3293.35,1
2024-04-08,13:12:00,Target,-64.81,Winter Park FL,32789,5535.94,0
2024-04-09,09:25:00,Target,-127.27,Winter Park FL,32789,5408.67,0
2024-04-09,09:31:00,Trader Joe's,-69.34,Orlando FL,32816,5339.33,0
2024-04-09,10:30:00,Target,-39.02,Orlando FL,32816,5300.31,0
2024-04-10,10:56:00,Chevron,-12.46,Oviedo FL,32765,5287.85,0
2024-04-11,18:35:00,Movie Theater,-11.27,Orlando FL,32816,5276.58,0
2024-04-11,14:06:00,Subway,-33.62,Orlando FL,32816,5242.96,0
2024-04-11,18:36:00,Subway,-20.29,Oviedo FL,32765,5222.67,0
2024-04-12,08:28:00,Subway,-32.68,Oviedo FL,32765,5189.99,0
2024-04-13,03:50:00,Fraud,-1853.05,Tokyo JP,49042,3336.94,1
2024-04-13,17:37:00,Movie Theater,-22.24,Orlando FL,32816,5167.75,0
2024-04-13,21:43:00,Target,-64.2,Winter Park FL,32789,5103.55,0
2024-04-13,12:22:00,Netflix,-33.53,Orlando FL,32816,5070.02,0
2024-04-14,11:33:00,Walmart,-125.77,Orlando FL,32816,4944.25,0
2024-04-14,21:58:00,McDonald's,-22.24,Oviedo FL,32765,4922.01,0
2024-04-15,10:14:00,Walgreens,-8.28,Oviedo FL,32765,4913.73,0
2024-04-15,13:00:00,McDonald's,-22.64,Winter Park FL,32789,4891.09,0
2024-04-15,17:41:00,Burger King,-18.71,Orlando FL,32816,4872.38,0
2024-04-16,09:03:00,Amusement Park,-28.52,Winter Park FL,32789,4843.86,0
2024-04-16,17:39:00,McDonald's,-10.2,Oviedo FL,32765,4833.66,0
2024-04-16,16:03:00,McDonald's,-37.61,Oviedo FL,32765,4796.05,0
2024-04-17,13:03:00,CVS,-44.24,Oviedo FL,32765,4751.81,0
2024-04-20,08:31:00,Dollar Tree,-11.07,Orlando FL,32816,4740.74,0
2024-04-20,21:17:00,CVS,-6.38,Orlando FL,32816,4734.36,0
2024-04-20,14:41:00,BP,-26.59,Oviedo FL,32765,4707.77,0
2024-04-21,16:02:00,McDonald's,-30.29,Oviedo FL,32765,4677.48,0
2024-04-21,08:07:00,Subway,-32.68,Orlando FL,32816,4644.8,0
2024-04-21,12:06:00,Target,-78.17,Orlando FL,32816,4566.63,0
2024-04-22,08:00:00,Paycheck,2000.0,Oviedo FL,32765,6566.63,0
2024-04-23,10:17:00,BP,-20.24,Orlando FL,32816,6546.39,0
2024-04-23,15:21:00,Chevron,-32.32,Orlando FL,32816,6514.07,0
2024-04-23,08:24:00,Pep Boys,-270.73,Winter Park FL,32789,6243.34,0
2024-04-24,11:38:00,Midas,-324.1,Orlando FL,32816,5919.24,0
2024-04-24,08:05:00,Trader Joe's,-65.63,Winter Park FL,32789,5853.61,0
2024-04-26,09:13:00,Walmart,-30.97,Winter Park FL,32789,5822.64,0
2024-04-27,16:56:00,Dollar Tree,-47.85,Orlando FL,32816,5774.79,0
2024-04-27,19:24:00,BP,-17.44,Winter Park FL,32789,5757.35,0
2024-04-28,14:34:00,Target,-43.79,Winter Park FL,32789,5713.56,0
2024-04-28,15:40:00,Trader Joe's,-45.83,Winter Park FL,32789,5667.73,0
2024-04-28,04:05:00,Lockheed Martin,-1598.16,Honolulu HI,67645,4069.57,1
2024-04-29,15:18:00,BP,-13.23,Winter Park FL,32789,5654.5,0
2024-04-30,17:39:00,McDonald's,-14.7,Oviedo FL,32765,5639.8,0
2024-04-30,17:29:00,Pep Boys,-100.31,Orlando FL,32816,5539.49,0
2024-05-01,09:00:00,Rent,-960.0,Oviedo FL,32765,4579.49,0
2024-05-01,09:00:00,Insurance,-197.46,Oviedo FL,32765,4382.03,0
2024-05-01,09:00:00,Car,-300.0,Oviedo FL,32765,4082.03,0
2024-05-01,11:13:00,Publix,-82.47,Oviedo FL,32765,3999.56,0
2024-05-01,09:34:00,Servicenow,-2382.32,London EN,46322,1617.24,1
2024-05-01,08:52:00,Starbucks,-39.62,Orlando FL,32816,3959.94,0
2024-05-04,17:40:00,Burger King,-31.58,Oviedo FL,32765,3928.36,0
2024-05-04,19:40:00,Jiffy Lube,-164.64,Oviedo FL,32765,3763.72,0
2024-05-05,12:23:00,Trader Joe's,-51.97,Oviedo FL,32765,3711.75,0
2024-05-06,08:00:00,Paycheck,2000.0,Oviedo FL,32765,5711.75,0
2024-05-06,10:44:00,Shell,-18.3,Oviedo FL,32765,5693.45,0
2024-05-06,18:13:00,Amusement Park,-41.56,Orlando FL,32816,5651.89,0
2024-05-06,04:52:00,Impractical Jokers,-1942.34,Tokyo JP,79413,3709.55,1
2024-05-06,20:29:00,Shell,-28.65,Oviedo FL,32765,5623.24,0
2024-05-07,09:00:00,Spotify,-11.99,Oviedo FL,32765,5611.25,0
2024-05-07,09:00:00,Internet,-70.89,Oviedo FL,32765,5540.36,0
2024-05-07,09:00:00,ChatGPT Plus,-20.0,Oviedo FL,32765,5520.36,0
2024-05-07,14:14:00,Best Buy,-87.22,Orlando FL,32816,5433.14,0
2024-05-07,15:16:00,Subway,-11.12,Orlando FL,32816,5422.02,0
2024-05-08,18:07:00,Fat Joe,-1589.55,Anchorage AL,32363,3832.47,1
2024-05-08,18:02:00,Kroger,-72.76,Oviedo FL,32765,5349.26,0
2024-05-11,18:24:00,Target,-36.31,Oviedo FL,32765,5312.95,0
2024-05-12,12:21:00,Starbucks,-31.69,Oviedo FL,32765,5281.26,0
2024-05-13,08:49:00,Dollar Tree,-8.99,Winter Park FL,32789,5272.27,0
2024-05-13,18:47:00,Dollar Tree,-21.95,Orlando FL,32816,5250.32,0
2024-05-13,21:15:00,Whole Foods,-95.68,Orlando FL,32816,5154.64,0
2024-05-15,11:00:00,Starbucks,-25.36,Orlando FL,32816,5129.28,0
2024-05-15,08:46:00,Kroger,-81.87,Orlando FL,32816,5047.41,0
2024-05-16,14:59:00,Burger King,-18.72,Winter Park FL,32789,5028.69,0
2024-05-17,16:37:00,Burger King,-21.99,Winter Park FL,32789,5006.7,0
2024-05-17,15:55:00,Starbucks,-8.51,Orlando FL,32816,4998.19,0
2024-05-17,13:05:00,Onlyfans,-329.33,Honolulu HI,55295,4668.86,1
2024-05-19,12:08:00,Five Below,-16.93,Orlando FL,32816,4981.26,0
2024-05-19,17:10:00,McDonald's,-24.19,Winter Park FL,32789,4957.07,0
2024-05-20,08:00:00,Paycheck,2000.0,Oviedo FL,32765,6957.07,0
2024-05-20,08:30:00,Fraud,-2470.22,Anchorage AL,62934,4486.85,1
2024-05-21,18:06:00,McDonald's,-13.53,Winter Park FL,32789,6943.54,0
2024-05-21,13:28:00,Trader Joe's,-155.88,Oviedo FL,32765,6787.66,0
2024-05-22,11:59:00,Starbucks,-26.4,Oviedo FL,32765,6761.26,0
2024-05-22,23:41:00,Monster Energy,-1277.52,Charleston SC,62444,5483.74,1
2024-05-24,11:54:00,Target,-171.93,Orlando FL,32816,6589.33,0
2024-05-24,08:15:00,Subway,-57.13,Orlando FL,32816,6532.2,0
2024-05-25,13:01:00,Chevron,-42.92,Winter Park FL,32789,6489.28,0
2024-05-26,17:53:00,Movie Theater,-116.44,Winter Park FL,32789,6372.84,0
2024-05-26,13:13:00,Movie Theater,-32.85,Winter Park FL,32789,6339.99,0
2024-05-29,14:48:00,Amazon,-74.32,Orlando FL,32816,6265.67,0
2024-05-29,02:49:00,Pawn Stars,-2861.23,Anchorage AL,74762,3404.44,1
2024-05-29,12:32:00,Starbucks,-38.5,Orlando FL,32816,6227.17,0
2024-05-30,11:59:00,Subway,-13.79,Oviedo FL,32765,6213.38,0
2024-06-01,09:00:00,Rent,-960.0,Oviedo FL,32765,5253.38,0
2024-06-01,09:00:00,Insurance,-197.46,Oviedo FL,32765,5055.92,0
2024-06-01,09:00:00,Car,-300.0,Oviedo FL,32765,4755.92,0
2024-06-01,11:59:00,Target,-69.99,Winter Park FL,32789,4685.93,0
2024-06-02,19:38:00,Fraud,-1066.34,Pyongyang NK,20508,3619.59,1
2024-06-02,17:59:00,Burger King,-30.41,Winter Park FL,32789,4655.52,0
2024-06-03,08:00:00,Paycheck,2000.0,Oviedo FL,32765,6655.52,0
2024-06-03,15:01:00,Burger King,-52.56,Winter Park FL,32789,6602.96,0
2024-06-03,08:50:00,AutoZone,-112.09,Oviedo FL,32765,6490.87,0
2024-06-03,21:01:00,Walmart,-139.53,Orlando FL,32816,6351.34,0
2024-06-03,23:08:00,IBM,-1976.22,Honolulu HI,96000,4375.12,1
2024-06-04,10:43:00,Burger King,-34.03,Orlando FL,32816,6317.31,0
2024-06-05,20:59:00,Burger King,-26.58,Winter Park FL,32789,6290.73,0
2024-06-05,02:32:00,Magic the Gathering,-1380.8,Charleston SC,80417,4909.93,1
2024-06-05,12:40:00,McDonald's,-26.18,Orlando FL,32816,6264.55,0
2024-06-06,16:33:00,Exxon,-27.19,Winter Park FL,32789,6237.36,0
2024-06-07,09:00:00,Spotify,-11.99,Oviedo FL,32765,6225.37,0
2024-06-07,09:00:00,Internet,-70.89,Oviedo FL,32765,6154.48,0
2024-06-07,09:00:00,ChatGPT Plus,-20.0,Oviedo FL,32765,6134.48,0
2024-06-07,17:50:00,Starbucks,-29.49,Oviedo FL,32765,6104.99,0
2024-06-07,17:45:00,Exxon,-25.12,Orlando FL,32816,6079.87,0
2024-06-07,16:45:00,Best Buy,-147.8,Oviedo FL,32765,5932.07,0
2024-06-08,12:57:00,Subway,-6.3,Orlando FL,32816,5925.77,0
2024-06-08,10:46:00,McDonald's,-30.0,Orlando FL,32816,5895.77,0
2024-06-09,14:38:00,Midas,-182.91,Oviedo FL,32765,5712.86,0
2024-06-09,11:22:00,McDonald's,-39.49,Orlando FL,32816,5673.37,0
2024-06-09,06:02:00,Onlyfans,-2888.44,Charleston SC,43462,2784.93,1
2024-06-09,12:15:00,Movie Theater,-45.33,Winter Park FL,32789,5628.04,0
2024-06-09,20:05:00,Pawn Stars,-1938.57,Mexico City MC,51251,3689.47,1
2024-06-11,11:21:00,Amazon,-69.72,Orlando FL,32816,5558.32,0
2024-06-12,15:21:00,Starbucks,-30.55,Oviedo FL,32765,5527.77,0
2024-06-12,14:23:00,Burger King,-10.41,Orlando FL,32816,5517.36,0
2024-06-12,21:06:00,BP,-14.55,Orlando FL,32816,5502.81,0
2024-06-12,17:09:00,Paypal,-1347.07,Pyongyang NK,90132,4155.74,1
2024-06-13,10:05:00,Starbucks,-23.39,Oviedo FL,32765,5479.42,0
2024-06-13,14:35:00,Kroger,-83.2,Oviedo FL,32765,5396.22,0
2024-06-13,08:09:00,Concert Tickets,-58.86,Oviedo FL,32765,5337.36,0
2024-06-14,12:11:00,Burger King,-34.7,Winter Park FL,32789,5302.66,0
2024-06-15,07:44:00,IBM,-1205.29,Mexico City MC,54152,4097.37,1
2024-06-15,19:09:00,McDonald's,-26.5,Orlando FL,32816,5276.16,0
2024-06-15,13:42:00,Starbucks,-11.94,Orlando FL,32816,5264.22,0
2024-06-15,03:47:00,Fat Joe,-1371.7,Anchorage AL,32413,3892.52,1
2024-06-16,19:03:00,Burger King,-29.61,Oviedo FL,32765,5234.61,0
2024-06-17,08:00:00,Paycheck,2000.0,Oviedo FL,32765,7234.61,0
2024-06-17,13:21:00,McDonald's,-41.69,Winter Park FL,32789,7192.92,0
2024-06-17,04:17:00,Accelerators,-2038.09,Los Angeles CA,40533,5154.83,1
2024-06-18,05:39:00,Fraud,-1783.13,Charleston SC,13752,5409.79,1
2024-06-18,19:00:00,Starbucks,-67.4,Orlando FL,32816,7125.52,0
2024-06-18,11:41:00,Walmart,-118.31,Oviedo FL,32765,7007.21,0
2024-06-18,19:56:00,Monster Energy,-2286.67,Groton CT,58352,4720.54,1
2024-06-19,08:26:00,Burger King,-35.43,Orlando FL,32816,6971.78,0
2024-06-19,10:18:00,Netflix,-30.14,Orlando FL,32816,6941.64,0
2024-06-19,13:07:00,Midas,-310.74,Winter Park FL,32789,6630.9,0
2024-06-20,20:25:00,AutoZone,-245.25,Oviedo FL,32765,6385.65,0
2024-06-20,07:31:00,Onlyfans,-2130.67,Charleston SC,13079,4254.98,1
2024-06-21,08:08:00,Starbucks,-12.39,Oviedo FL,32765,6373.26,0
2024-06-21,20:31:00,Five Below,-62.58,Oviedo FL,32765,6310.68,0
2024-06-21,11:14:00,Publix,-149.72,Orlando FL,32816,6160.96,0
2024-06-21,21:07:00,Fraud,-976.52,Pyongyang NK,36397,5184.44,1
2024-06-22,11:34:00,Shell,-34.84,Oviedo FL,32765,6126.12,0
2024-06-22,18:35:00,Shell,-45.62,Orlando FL,32816,6080.5,0
2024-06-22,08:26:00,Burger King,-18.22,Oviedo FL,32765,6062.28,0
2024-06-23,18:50:00,Starbucks,-25.99,Winter Park FL,32789,6036.29,0
2024-06-23,18:15:00,Target,-53.37,Oviedo FL,32765,5982.92,0
2024-06-23,16:29:00,Whole Foods,-82.09,Winter Park FL,32789,5900.83,0
2024-06-24,14:14:00,Trader Joe's,-80.35,Orlando FL,32816,5820.48,0
2024-06-25,21:40:00,Fat Joe,-1552.1,Honolulu HI,86820,4268.38,1
2024-06-25,20:14:00,Movie Theater,-22.0,Winter Park FL,32789,5798.48,0
2024-06-25,14:40:00,Kroger,-52.95,Orlando FL,32816,5745.53,0
2024-06-28,15:09:00,Burger King,-5.56,Orlando FL,32816,5739.97,0
2024-06-29,20:55:00,Walgreens,-9.15,Orlando FL,32816,5730.82,0
2024-06-29,17:54:00,Burger King,-9.08,Winter Park FL,32789,5721.74,0
2024-07-01,08:00:00,Paycheck,2000.0,Oviedo FL,32765,7721.74,0
2024-07-01,09:00:00,Rent,-960.0,Oviedo FL,32765,6761.74,0
2024-07-01,09:00:00,Insurance,-197.46,Oviedo FL,32765,6564.28,0
2024-07-01,09:00:00,Car,-300.0,Oviedo FL,32765,6264.28,0
2024-07-03,09:03:00,Exxon,-44.91,Oviedo FL,32765,6219.37,0
2024-07-03,08:42:00,CVS,-34.17,Winter Park FL,32789,6185.2,0
2024-07-03,17:50:00,Midas,-123.52,Orlando FL,32816,6061.68,0
2024-07-06,10:57:00,Kroger,-85.32,Orlando FL,32816,5976.36,0
2024-07-06,10:53:00,Kroger,-30.98,Winter Park FL,32789,5945.38,0
2024-07-07,09:00:00,Spotify,-11.99,Oviedo FL,32765,5933.39,0
2024-07-07,09:00:00,Internet,-70.89,Oviedo FL,32765,5862.5,0
2024-07-07,09:00:00,ChatGPT Plus,-20.0,Oviedo FL,32765,5842.5,0
2024-07-07,19:06:00,McDonald's,-27.9,Orlando FL,32816,5814.6,0
2024-07-07,08:54:00,Trader Joe's,-65.23,Orlando FL,32816,5749.37,0
2024-07-07,11:41:00,Trader Joe's,-55.31,Oviedo FL,32765,5694.06,0
2024-07-08,14:02:00,Starbucks,-9.33,Winter Park FL,32789,5684.73,0
2024-07-08,20:54:00,Amazon,-127.44,Oviedo FL,32765,5557.29,0
2024-07-09,14:34:00,Subway,-14.39,Oviedo FL,32765,5542.9,0
2024-07-09,14:35:00,Subway,-15.97,Oviedo FL,32765,5526.93,0
2024-07-09,18:31:00,Movie Theater,-16.25,Oviedo FL,32765,5510.68,0
2024-07-09,13:40:00,Accelerators,-1247.34,Mexico City MC,44874,4263.34,1
2024-07-10,09:42:00,Amazon,-141.41,Orlando FL,32816,5369.27,0
2024-07-10,08:43:00,Walmart,-96.85,Orlando FL,32816,5272.42,0
2024-07-12,20:10:00,Amazon,-36.47,Winter Park FL,32789,5235.95,0
2024-07-12,01:38:00,Fraud,-768.5,London EN,60165,4467.45,1
2024-07-12,09:29:00,Burger King,-17.77,Oviedo FL,32765,5218.18,0
2024-07-15,08:00:00,Paycheck,2000.0,Oviedo FL,32765,7218.18,0
2024-07-15,09:21:00,CVS,-19.02,Orlando FL,32816,7199.16,0
2024-07-16,14:31:00,Amazon,-169.67,Winter Park FL,32789,7029.49,0
2024-07-16,11:29:00,Starbucks,-47.7,Winter Park FL,32789,6981.79,0
2024-07-16,18:56:00,Kroger,-149.39,Oviedo FL,32765,6832.4,0
2024-07-17,07:24:00,IBM,-989.61,Tokyo JP,19852,5842.79,1
2024-07-17,16:54:00,Walmart,-111.17,Winter Park FL,32789,6721.23,0
2024-07-18,21:55:00,Kroger,-133.14,Orlando FL,32816,6588.09,0
2024-07-20,09:18:00,Five Below,-65.35,Winter Park FL,32789,6522.74,0
2024-07-24,20:46:00,McDonald's,-25.5,Oviedo FL,32765,6497.24,0
2024-07-24,10:25:00,Kroger,-187.06,Winter Park FL,32789,6310.18,0
2024-07-24,14:11:00,Movie Theater,-74.5,Orlando FL,32816,6235.68,0
2024-07-26,19:46:00,Subway,-78.67,Winter Park FL,32789,6157.01,0
2024-07-26,15:23:00,Publix,-148.21,Winter Park FL,32789,6008.8,0
2024-07-26,13:21:00,Trader Joe's,-91.69,Oviedo FL,32765,5917.11,0
2024-07-27,21:47:00,Pep Boys,-124.83,Winter Park FL,32789,5792.28,0
2024-07-28,21:20:00,Subway,-25.69,Winter Park FL,32789,5766.59,0
2024-07-28,22:42:00,Accelerators,-1192.97,Anchorage AL,62584,4573.62,1
2024-07-28,17:57:00,Jiffy Lube,-164.49,Orlando FL,32816,5602.1,0
2024-07-28,19:53:00,Walmart,-38.9,Oviedo FL,32765,5563.2,0
2024-07-29,08:00:00,Paycheck,2000.0,Oviedo FL,32765,7563.2,0
2024-07-29,21:32:00,Walmart,-32.97,Winter Park FL,32789,7530.23,0
2024-07-30,09:34:00,Exxon,-34.11,Oviedo FL,32765,7496.12,0
2024-07-30,12:35:00,McDonald's,-21.23,Orlando FL,32816,7474.89,0
2024-07-31,13:01:00,McDonald's,-32.14,Oviedo FL,32765,7442.75,0
2024-07-31,13:24:00,IBM,-1093.42,Anchorage AL,91767,6349.33,1
2024-07-31,21:07:00,CVS,-31.38,Winter Park FL,32789,7411.37,0
2024-07-31,18:06:00,Fraud,-1866.73,Honolulu HI,16989,5544.64,1
2024-07-31,20:53:00,McDonald's,-10.35,Oviedo FL,32765,7401.02,0
2024-08-01,09:00:00,Rent,-960.0,Oviedo FL,32765,6441.02,0
2024-08-01,09:00:00,Insurance,-197.46,Oviedo FL,32765,6243.56,0
2024-08-01,09:00:00,Car,-300.0,Oviedo FL,32765,5943.56,0
2024-08-01,12:16:00,Concert Tickets,-24.91,Orlando FL,32816,5918.65,0
2024-08-01,10:35:00,Best Buy,-17.58,Winter Park FL,32789,5901.07,0
2024-08-01,12:04:00,Burger King,-12.68,Oviedo FL,32765,5888.39,0
2024-08-02,12:54:00,Servicenow,-2363.59,Pittsburgh PA,21028,3524.8,1
2024-08-02,15:14:00,Starbucks,-15.41,Orlando FL,32816,5872.98,0
2024-08-02,12:29:00,Accelerators,-1238.89,Groton CT,29950,4634.09,1
2024-08-02,15:42:00,Starbucks,-25.86,Oviedo FL,32765,5847.12,0
2024-08-02,11:05:00,McDonald's,-16.88,Winter Park FL,32789,5830.24,0
2024-08-05,21:33:00,McDonald's,-37.71,Orlando FL,32816,5792.53,0
2024-08-07,09:00:00,Spotify,-11.99,Oviedo FL,32765,5780.54,0
2024-08-07,09:00:00,Internet,-70.89,Oviedo FL,32765,5709.65,0
2024-08-07,09:00:00,ChatGPT Plus,-20.0,Oviedo FL,32765,5689.65,0
2024-08-07,15:06:00,BP,-10.92,Winter Park FL,32789,5678.73,0
2024-08-07,17:44:00,Walgreens,-22.18,Orlando FL,32816,5656.55,0
2024-08-07,12:45:00,BP,-28.56,Oviedo FL,32765,5627.99,0
2024-08-08,10:21:00,Fat Joe,-2690.41,Los Angeles CA,44903,2937.58,1
2024-08-08,15:29:00,BP,-14.5,Winter Park FL,32789,5613.49,0
2024-08-08,08:15:00,McDonald's,-15.37,Oviedo FL,32765,5598.12,0
2024-08-08,15:32:00,McDonald's,-21.83,Oviedo FL,32765,5576.29,0
2024-08-09,16:12:00,Best Buy,-136.92,Oviedo FL,32765,5439.37,0
2024-08-09,22:25:00,Magic the Gathering,-1244.88,Pittsburgh PA,42611,4194.49,1
2024-08-09,20:32:00,Burger King,-11.1,Winter Park FL,32789,5428.27,0
2024-08-09,17:21:00,Shell,-27.38,Winter Park FL,32789,5400.89,0
2024-08-10,11:58:00,Netflix,-44.32,Winter Park FL,32789,5356.57,0
2024-08-10,21:03:00,Trader Joe's,-59.41,Orlando FL,32816,5297.16,0
2024-08-10,08:47:00,Subway,-13.19,Winter Park FL,32789,5283.97,0
2024-08-11,14:59:00,Burger King,-38.44,Winter Park FL,32789,5245.53,0
2024-08-11,09:51:00,BP,-22.75,Winter Park FL,32789,5222.78,0
2024-08-11,16:33:00,Exxon,-14.8,Winter Park FL,32789,5207.98,0
2024-08-12,08:00:00,Paycheck,2000.0,Oviedo FL,32765,7207.98,0
2024-08-13,12:31:00,Pep Boys,-287.63,Orlando FL,32816,6920.35,0
2024-08-13,14:43:00,Amazon,-264.33,Winter Park FL,32789,6656.02,0
2024-08-13,19:13:00,Pep Boys,-189.19,Oviedo FL,32765,6466.83,0
2024-08-15,08:18:00,Impractical Jokers,-2482.42,Los Angeles CA,35818,3984.41,1
2024-08-16,12:10:00,Chevron,-42.92,Orlando FL,32816,6423.91,0
2024-08-16,16:54:00,McDonald's,-17.45,Winter Park FL,32789,6406.46,0
2024-08-17,19:10:00,Netflix,-86.68,Oviedo FL,32765,6319.78,0
2024-08-17,16:27:00,Concert Tickets,-114.02,Winter Park FL,32789,6205.76,0
2024-08-17,16:49:00,Walmart,-83.65,Orlando FL,32816,6122.11,0
2024-08-18,14:35:00,Dollar Tree,-96.92,Orlando FL,32816,6025.19,0
2024-08-18,20:34:00,Subway,-44.3,Oviedo FL,32765,5980.89,0
2024-08-19,08:13:00,Movie Theater,-50.99,Oviedo FL,32765,5929.9,0
2024-08-19,10:52:00,Starbucks,-26.76,Winter Park FL,32789,5903.14,0
2024-08-20,14:42:00,Best Buy,-49.55,Winter Park FL,32789,5853.59,0
2024-08-22,09:15:00,McDonald's,-35.81,Oviedo FL,32765,5817.78,0
2024-08-23,17:40:00,McDonald's,-18.05,Oviedo FL,32765,5799.73,0
2024-08-24,18:48:00,Burger King,-29.48,Orlando FL,32816,5770.25,0
2024-08-25,18:34:00,Subway,-7.48,Oviedo FL,32765,5762.77,0
2024-08-25,13:20:00,Concert Tickets,-15.29,Oviedo FL,32765,5747.48,0
2024-08-25,16:37:00,Pep Boys,-168.82,Oviedo FL,32765,5578.66,0
2024-08-26,08:00:00,Paycheck,2000.0,Oviedo FL,32765,7578.66,0
2024-08-26,16:04:00,Amazon,-101.08,Oviedo FL,32765,7477.58,0
2024-08-26,18:20:00,Netflix,-56.56,Winter Park FL,32789,7421.02,0
2024-08-27,08:53:00,Starbucks,-40.41,Winter Park FL,32789,7380.61,0
2024-08-27,13:33:00,Fat Joe,-1631.05,London EN,51459,5749.56,1
2024-08-27,16:56:00,Burger King,-20.75,Oviedo FL,32765,7359.86,0
2024-08-27,18:23:00,Subway,-60.51,Winter Park FL,32789,7299.35,0
2024-08-28,16:41:00,Chevron,-28.09,Oviedo FL,32765,7271.26,0
2024-08-29,19:51:00,BP,-42.57,Winter Park FL,32789,7228.69,0
2024-09-01,09:00:00,Rent,-960.0,Oviedo FL,32765,6268.69,0
2024-09-01,09:00:00,Insurance,-197.46,Oviedo FL,32765,6071.23,0
2024-09-01,09:00:00,Car,-300.0,Oviedo FL,32765,5771.23,0
2024-09-01,19:06:00,Paypal,-2456.12,Anchorage AL,35556,3315.11,1
2024-09-01,17:01:00,Subway,-10.73,Orlando FL,32816,5760.5,0
2024-09-01,17:56:00,Exxon,-14.95,Winter Park FL,32789,5745.55,0
2024-09-02,20:09:00,Concert Tickets,-58.59,Oviedo FL,32765,5686.96,0
2024-09-02,17:48:00,Walgreens,-17.82,Winter Park FL,32789,5669.14,0
2024-09-02,08:34:00,Walmart,-82.85,Orlando FL,32816,5586.29,0
2024-09-03,13:43:00,Burger King,-11.08,Orlando FL,32816,5575.21,0
2024-09-03,11:40:00,Starbucks,-18.67,Oviedo FL,32765,5556.54,0
2024-09-04,16:20:00,McDonald's,-22.66,Orlando FL,32816,5533.88,0
2024-09-05,17:53:00,Starbucks,-23.14,Orlando FL,32816,5510.74,0
2024-09-06,08:43:00,Walmart,-48.68,Winter Park FL,32789,5462.06,0
2024-09-06,02:27:00,Servicenow,-2796.22,Pyongyang NK,72643,2665.84,1
2024-09-06,12:15:00,Subway,-23.49,Oviedo FL,32765,5438.57,0
2024-09-06,08:28:00,Trader Joe's,-72.17,Winter Park FL,32789,5366.4,0
2024-09-07,09:00:00,Spotify,-11.99,Oviedo FL,32765,5354.41,0
2024-09-07,09:00:00,Internet,-70.89,Oviedo FL,32765,5283.52,0
2024-09-07,09:00:00,ChatGPT Plus,-20.0,Oviedo FL,32765,5263.52,0
2024-09-08,21:40:00,Walmart,-117.51,Oviedo FL,32765,5146.01,0
2024-09-09,08:00:00,Paycheck,2000.0,Oviedo FL,32765,7146.01,0
2024-09-09,12:13:00,Amusement Park,-52.98,Winter Park FL,32789,7093.03,0
2024-09-09,18:42:00,Fat Joe,-2486.64,Honolulu HI,70403,4606.39,1
2024-09-10,08:26:00,Movie Theater,-114.37,Oviedo FL,32765,6978.66,0
2024-09-12,14:05:00,AutoZone,-159.78,Winter Park FL,32789,6818.88,0
2024-09-12,20:51:00,CVS,-77.39,Oviedo FL,32765,6741.49,0
2024-09-12,18:48:00,Jiffy Lube,-267.72,Orlando FL,32816,6473.77,0
2024-09-13,12:07:00,BP,-19.85,Oviedo FL,32765,6453.92,0
2024-09-14,17:12:00,Pawn Stars,-586.54,Pittsburgh PA,52798,5867.38,1
2024-09-15,21:21:00,Exxon,-33.42,Winter Park FL,32789,6420.5,0
2024-09-16,10:53:00,Starbucks,-52.21,Oviedo FL,32765,6368.29,0
2024-09-16,10:46:00,Dollar Tree,-19.1,Winter Park FL,32789,6349.19,0
2024-09-16,11:52:00,Subway,-22.76,Winter Park FL,32789,6326.43,0
2024-09-17,13:32:00,McDonald's,-24.53,Oviedo FL,32765,6301.9,0
2024-09-17,15:38:00,Subway,-61.65,Winter Park FL,32789,6240.25,0
2024-09-17,10:47:00,McDonald's,-11.82,Oviedo FL,32765,6228.43,0
2024-09-18,17:46:00,Burger King,-22.64,Orlando FL,32816,6205.79,0
2024-09-18,15:24:00,Shell,-46.35,Winter Park FL,32789,6159.44,0
2024-09-18,18:26:00,Five Below,-79.87,Oviedo FL,32765,6079.57,0
2024-09-18,03:48:00,Lockheed Martin,-2212.91,Honolulu HI,82601,3866.66,1
2024-09-20,12:03:00,Walgreens,-94.78,Oviedo FL,32765,5984.79,0
2024-09-20,21:48:00,Five Below,-31.23,Oviedo FL,32765,5953.56,0
2024-09-20,14:16:00,McDonald's,-12.8,Orlando FL,32816,5940.76,0
2024-09-22,10:13:00,BP,-29.35,Orlando FL,32816,5911.41,0
2024-09-23,08:00:00,Paycheck,2000.0,Oviedo FL,32765,7911.41,0
2024-09-23,19:03:00,Walmart,-89.92,Orlando FL,32816,7821.49,0
2024-09-23,11:03:00,Chevron,-54.94,Oviedo FL,32765,7766.55,0
2024-09-24,12:57:00,Servicenow,-2021.52,Mexico City MC,62998,5745.03,1
2024-09-25,08:05:00,Publix,-159.5,Orlando FL,32816,7607.05,0
2024-09-25,18:36:00,Burger King,-25.12,Winter Park FL,32789,7581.93,0
2024-09-26,19:08:00,Burger King,-14.77,Oviedo FL,32765,7567.16,0
2024-09-26,09:09:00,Fraud,-216.94,Pyongyang NK,26023,7350.22,1
2024-09-26,08:41:00,Movie Theater,-50.01,Oviedo FL,32765,7517.15,0
2024-09-29,13:25:00,Exxon,-38.79,Winter Park FL,32789,7478.36,0
2024-09-29,18:59:00,Whole Foods,-179.39,Winter Park FL,32789,7298.97,0
2024-09-29,20:03:00,Subway,-67.18,Oviedo FL,32765,7231.79,0
2024-10-01,09:00:00,Rent,-960.0,Oviedo FL,32765,6271.79,0
2024-10-01,09:00:00,Insurance,-197.46,Oviedo FL,32765,6074.33,0
2024-10-01,09:00:00,Car,-300.0,Oviedo FL,32765,5774.33,0
2024-10-01,04:45:00,IBM,-312.1,Pyongyang NK,41077,5462.23,1
2024-10-01,15:16:00,Walmart,-79.78,Orlando FL,32816,5694.55,0
2024-10-01,17:44:00,Paypal,-2896.1,Pittsburgh PA,84617,2798.45,1
2024-10-01,19:54:00,Whole Foods,-37.46,Oviedo FL,32765,5657.09,0
2024-10-01,20:08:00,Whole Foods,-71.36,Oviedo FL,32765,5585.73,0
2024-10-02,21:00:00,Trader Joe's,-79.56,Oviedo FL,32765,5506.17,0
2024-10-02,17:48:00,Burger King,-24.37,Oviedo FL,32765,5481.8,0
2024-10-02,14:04:00,Walgreens,-40.02,Winter Park FL,32789,5441.78,0
2024-10-05,13:36:00,Walgreens,-27.12,Winter Park FL,32789,5414.66,0
2024-10-05,19:23:00,Lockheed Martin,-2735.81,Mexico City MC,26959,2678.85,1
2024-10-05,14:53:00,McDonald's,-16.61,Winter Park FL,32789,5398.05,0
2024-10-05,09:29:00,Whole Foods,-85.09,Winter Park FL,32789,5312.96,0
2024-10-06,13:44:00,Subway,-37.71,Oviedo FL,32765,5275.25,0
2024-10-06,17:05:00,Amusement Park,-23.46,Orlando FL,32816,5251.79,0
2024-10-06,21:16:00,Concert Tickets,-15.54,Oviedo FL,32765,5236.25,0
2024-10-07,08:00:00,Paycheck,2000.0,Oviedo FL,32765,7236.25,0
2024-10-07,09:00:00,Spotify,-11.99,Oviedo FL,32765,7224.26,0
2024-10-07,09:00:00,Internet,-70.89,Oviedo FL,32765,7153.37,0
2024-10-07,09:00:00,ChatGPT Plus,-20.0,Oviedo FL,32765,7133.37,0
2024-10-08,18:06:00,Movie Theater,-86.5,Orlando FL,32816,7046.87,0
2024-10-09,10:39:00,Dollar Tree,-90.59,Oviedo FL,32765,6956.28,0
2024-10-09,17:43:00,Target,-254.34,Orlando FL,32816,6701.94,0
2024-10-11,16:27:00,Burger King,-30.49,Orlando FL,32816,6671.45,0
2024-10-11,08:01:00,CVS,-55.38,Winter Park FL,32789,6616.07,0
2024-10-12,21:58:00,Midas,-309.29,Orlando FL,32816,6306.78,0
2024-10-12,18:18:00,Burger King,-18.1,Winter Park FL,32789,6288.68,0
2024-10-12,11:48:00,Starbucks,-71.45,Oviedo FL,32765,6217.23,0
2024-10-14,06:45:00,Pawn Stars,-1765.64,Pyongyang NK,51269,4451.59,1
2024-10-14,17:52:00,Kroger,-188.42,Oviedo FL,32765,6028.81,0
2024-10-15,15:28:00,McDonald's,-24.0,Orlando FL,32816,6004.81,0
2024-10-16,19:35:00,Magic the Gathering,-1797.76,Pyongyang NK,69420,4207.05,1
2024-10-16,11:53:00,Target,-234.67,Oviedo FL,32765,5770.14,0
2024-10-19,08:05:00,Burger King,-28.22,Oviedo FL,32765,5741.92,0
2024-10-19,14:32:00,Subway,-38.01,Winter Park FL,32789,5703.91,0
2024-10-20,09:00:00,Burger King,-15.75,Orlando FL,32816,5688.16,0
2024-10-21,08:00:00,Paycheck,2000.0,Oviedo FL,32765,7688.16,0
2024-10-21,13:45:00,Pep Boys,-229.5,Orlando FL,32816,7458.66,0
2024-10-21,15:05:00,Walgreens,-97.3,Orlando FL,32816,7361.36,0
2024-10-21,14:31:00,McDonald's,-76.07,Orlando FL,32816,7285.29,0
2024-10-21,19:31:00,Fraud,-1995.17,Mexico City MC,85643,5290.12,1
2024-10-23,10:58:00,Walmart,-219.3,Winter Park FL,32789,7065.99,0
2024-10-23,21:29:00,Burger King,-76.58,Oviedo FL,32765,6989.41,0
2024-10-23,12:47:00,Subway,-21.6,Oviedo FL,32765,6967.81,0
2024-10-24,18:56:00,Publix,-69.07,Orlando FL,32816,6898.74,0
2024-10-24,12:05:00,Subway,-58.62,Orlando FL,32816,6840.12,0
2024-10-25,11:27:00,Publix,-166.25,Oviedo FL,32765,6673.87,0
2024-10-25,18:15:00,Amusement Park,-21.66,Orlando FL,32816,6652.21,0
2024-10-25,10:14:00,Best Buy,-137.59,Orlando FL,32816,6514.62,0
2024-10-26,19:51:00,BP,-54.24,Oviedo FL,32765,6460.38,0
2024-10-27,17:40:00,Starbucks,-52.21,Orlando FL,32816,6408.17,0
2024-10-27,17:28:00,Impractical Jokers,-921.19,Anchorage AL,98736,5486.98,1
2024-10-28,16:57:00,Walgreens,-51.11,Winter Park FL,32789,6357.06,0
2024-10-28,19:15:00,BP,-23.72,Orlando FL,32816,6333.34,0
2024-10-28,18:14:00,Chevron,-20.89,Winter Park FL,32789,6312.45,0
2024-10-29,10:01:00,Shell,-42.3,Orlando FL,32816,6270.15,0
2024-10-29,20:40:00,CVS,-55.26,Orlando FL,32816,6214.89,0
2024-10-31,16:28:00,Exxon,-21.56,Oviedo FL,32765,6193.33,0
2024-10-31,18:45:00,Fat Joe,-1863.39,Mexico City MC,22979,4329.94,1
2024-10-31,10:26:00,Dollar Tree,-54.79,Winter Park FL,32789,6138.54,0
2024-11-01,09:00:00,Rent,-960.0,Oviedo FL,32765,5178.54,0
2024-11-01,09:00:00,Insurance,-197.46,Oviedo FL,32765,4981.08,0
2024-11-01,09:00:00,Car,-300.0,Oviedo FL,32765,4681.08,0
2024-11-01,14:03:00,Starbucks,-38.74,Oviedo FL,32765,4642.34,0
2024-11-01,08:07:00,BP,-11.87,Winter Park FL,32789,4630.47,0
2024-11-02,13:47:00,Concert Tickets,-55.23,Winter Park FL,32789,4575.24,0
2024-11-02,16:32:00,Walgreens,-19.37,Winter Park FL,32789,4555.87,0
2024-11-02,09:09:00,Starbucks,-22.77,Winter Park FL,32789,4533.1,0
2024-11-04,08:00:00,Paycheck,2000.0,Oviedo FL,32765,6533.1,0
2024-11-04,23:56:00,Servicenow,-339.36,Pittsburgh PA,53361,6193.74,1
2024-11-05,19:52:00,AutoZone,-290.79,Oviedo FL,32765,6242.31,0
2024-11-05,18:10:00,Kroger,-196.21,Orlando FL,32816,6046.1,0
2024-11-07,09:00:00,Spotify,-11.99,Oviedo FL,32765,6034.11,0
2024-11-07,09:00:00,Internet,-70.89,Oviedo FL,32765,5963.22,0
2024-11-07,09:00:00,ChatGPT Plus,-20.0,Oviedo FL,32765,5943.22,0
2024-11-08,11:57:00,Best Buy,-97.05,Oviedo FL,32765,5846.17,0
2024-11-08,13:49:00,AutoZone,-194.01,Winter Park FL,32789,5652.16,0
2024-11-10,10:20:00,Subway,-39.99,Orlando FL,32816,5612.17,0
2024-11-10,18:20:00,Subway,-29.12,Oviedo FL,32765,5583.05,0
2024-11-10,11:30:00,Amazon,-14.87,Winter Park FL,32789,5568.18,0
2024-11-10,10:51:00,Accelerators,-793.09,Pyongyang NK,97057,4775.09,1
2024-11-11,21:55:00,Starbucks,-22.57,Winter Park FL,32789,5545.61,0
2024-11-11,10:12:00,Pep Boys,-72.16,Winter Park FL,32789,5473.45,0
2024-11-11,16:11:00,Best Buy,-96.84,Winter Park FL,32789,5376.61,0
2024-11-12,08:15:00,Netflix,-17.6,Oviedo FL,32765,5359.01,0
2024-11-12,21:40:00,Starbucks,-28.03,Winter Park FL,32789,5330.98,0
2024-11-14,18:49:00,Shell,-20.64,Oviedo FL,32765,5310.34,0
2024-11-14,15:03:00,Walgreens,-33.37,Winter Park FL,32789,5276.97,0
2024-11-14,12:40:00,Chevron,-28.32,Winter Park FL,32789,5248.65,0
2024-11-16,17:11:00,Walmart,-33.03,Oviedo FL,32765,5215.62,0
2024-11-16,21:50:00,Starbucks,-21.2,Winter Park FL,32789,5194.42,0
2024-11-17,11:56:00,McDonald's,-29.43,Oviedo FL,32765,5164.99,0
2024-11-17,15:53:00,Best Buy,-111.66,Oviedo FL,32765,5053.33,0
2024-11-18,08:00:00,Paycheck,2000.0,Oviedo FL,32765,7053.33,0
2024-11-18,14:23:00,CVS,-50.6,Oviedo FL,32765,7002.73,0
2024-11-18,09:47:00,Fat Joe,-2566.07,Charleston SC,13394,4436.66,1
2024-11-19,10:24:00,Monster Energy,-2661.46,Groton CT,65968,4341.27,1
2024-11-19,21:35:00,Exxon,-53.8,Winter Park FL,32789,6948.93,0
2024-11-19,20:20:00,Dollar Tree,-46.15,Orlando FL,32816,6902.78,0
2024-11-20,08:05:00,Burger King,-63.52,Oviedo FL,32765,6839.26,0
2024-11-20,13:42:00,Concert Tickets,-82.72,Oviedo FL,32765,6756.54,0
2024-11-20,21:58:00,McDonald's,-72.43,Oviedo FL,32765,6684.11,0
2024-11-21,09:13:00,Best Buy,-192.94,Winter Park FL,32789,6491.17,0
2024-11-21,16:09:00,Exxon,-48.24,Winter Park FL,32789,6442.93,0
2024-11-21,15:37:00,Concert Tickets,-99.4,Oviedo FL,32765,6343.53,0
2024-11-22,08:32:00,Amazon,-153.36,Orlando FL,32816,6190.17,0
2024-11-22,21:42:00,Starbucks,-58.43,Orlando FL,32816,6131.74,0
2024-11-23,20:16:00,Subway,-55.55,Oviedo FL,32765,6076.19,0
2024-11-24,16:16:00,Best Buy,-243.6,Orlando FL,32816,5832.59,0
2024-11-24,15:18:00,CVS,-10.4,Winter Park FL,32789,5822.19,0
2024-11-25,10:27:00,Chevron,-27.64,Orlando FL,32816,5794.55,0
2024-11-25,11:50:00,Concert Tickets,-49.59,Oviedo FL,32765,5744.96,0
2024-11-26,18:02:00,Burger King,-23.16,Oviedo FL,32765,5721.8,0
2024-11-27,19:07:00,Servicenow,-318.63,Tokyo JP,39519,5403.17,1
2024-11-27,18:05:00,Starbucks,-16.62,Oviedo FL,32765,5705.18,0
2024-11-27,20:56:00,BP,-14.49,Oviedo FL,32765,5690.69,0
2024-11-28,11:02:00,Kroger,-65.93,Oviedo FL,32765,5624.76,0
2024-11-28,14:36:00,Burger King,-24.67,Orlando FL,32816,5600.09,0
2024-11-29,12:51:00,Starbucks,-9.62,Oviedo FL,32765,5590.47,0
2024-11-29,16:13:00,Movie Theater,-16.91,Orlando FL,32816,5573.56,0
2024-11-29,19:50:00,Starbucks,-31.31,Oviedo FL,32765,5542.25,0
2024-11-30,23:53:00,IBM,-2554.95,London EN,42671,2987.3,1
2024-11-30,10:57:00,Shell,-25.79,Winter Park FL,32789,5516.46,0
2024-12-01,09:00:00,Rent,-960.0,Oviedo FL,32765,4556.46,0
2024-12-01,09:00:00,Insurance,-197.46,Oviedo FL,32765,4359.0,0
2024-12-01,09:00:00,Car,-300.0,Oviedo FL,32765,4059.0,0
2024-12-01,15:17:00,Pep Boys,-192.64,Orlando FL,32816,3866.36,0
2024-12-01,13:03:00,IBM,-2162.76,Pittsburgh PA,89429,1703.6,1
2024-12-01,12:56:00,Subway,-22.07,Oviedo FL,32765,3844.29,0
2024-12-01,10:02:00,Subway,-28.68,Winter Park FL,32789,3815.61,0
2024-12-02,08:00:00,Paycheck,2000.0,Oviedo FL,32765,5815.61,0
2024-12-03,17:17:00,McDonald's,-17.15,Oviedo FL,32765,5798.46,0
2024-12-03,16:17:00,Dollar Tree,-9.66,Orlando FL,32816,5788.8,0
2024-12-03,11:30:00,Midas,-172.37,Orlando FL,32816,5616.43,0
2024-12-03,10:28:00,Lockheed Martin,-2745.18,London EN,95962,2871.25,1
2024-12-04,12:31:00,McDonald's,-15.72,Orlando FL,32816,5600.71,0
2024-12-04,17:23:00,Starbucks,-37.8,Orlando FL,32816,5562.91,0
2024-12-04,20:00:00,Best Buy,-69.15,Winter Park FL,32789,5493.76,0
2024-12-05,21:35:00,McDonald's,-29.99,Oviedo FL,32765,5463.77,0
2024-12-05,15:26:00,BP,-19.09,Oviedo FL,32765,5444.68,0
2024-12-05,17:24:00,Subway,-32.49,Oviedo FL,32765,5412.19,0
2024-12-06,17:44:00,Chevron,-12.24,Orlando FL,32816,5399.95,0
2024-12-06,18:43:00,Publix,-47.68,Orlando FL,32816,5352.27,0
2024-12-07,09:00:00,Spotify,-11.99,Oviedo FL,32765,5340.28,0
2024-12-07,09:00:00,Internet,-70.89,Oviedo FL,32765,5269.39,0
2024-12-07,09:00:00,ChatGPT Plus,-20.0,Oviedo FL,32765,5249.39,0
2024-12-07,18:49:00,Best Buy,-145.72,Orlando FL,32816,5103.67,0
2024-12-08,10:40:00,Walmart,-62.47,Winter Park FL,32789,5041.2,0
2024-12-09,11:38:00,Burger King,-6.78,Winter Park FL,32789,5034.42,0
2024-12-10,20:27:00,Walmart,-95.84,Oviedo FL,32765,4938.58,0
2024-12-10,10:46:00,Five Below,-27.96,Winter Park FL,32789,4910.62,0
2024-12-11,14:25:00,Best Buy,-66.12,Oviedo FL,32765,4844.5,0
2024-12-11,21:03:00,Best Buy,-26.72,Orlando FL,32816,4817.78,0
2024-12-12,14:24:00,Burger King,-26.14,Orlando FL,32816,4791.64,0
2024-12-12,20:11:00,Subway,-37.94,Oviedo FL,32765,4753.7,0
2024-12-12,17:41:00,McDonald's,-9.94,Oviedo FL,32765,4743.76,0
2024-12-13,05:10:00,Servicenow,-1155.74,Anchorage AL,68149,3588.02,1
2024-12-13,12:14:00,Amazon,-120.31,Oviedo FL,32765,4623.45,0
2024-12-13,10:47:00,Whole Foods,-95.89,Oviedo FL,32765,4527.56,0
2024-12-15,17:58:00,Onlyfans,-1097.35,Tokyo JP,74388,3430.21,1
2024-12-15,17:55:00,CVS,-27.34,Oviedo FL,32765,4500.22,0
2024-12-16,08:00:00,Paycheck,2000.0,Oviedo FL,32765,6500.22,0
2024-12-16,15:06:00,Trader Joe's,-162.1,Orlando FL,32816,6338.12,0
2024-12-16,13:28:00,Concert Tickets,-96.08,Orlando FL,32816,6242.04,0
2024-12-16,08:16:00,Movie Theater,-27.19,Orlando FL,32816,6214.85,0
2024-12-17,08:14:00,Chevron,-50.89,Winter Park FL,32789,6163.96,0
2024-12-18,01:29:00,Monster Energy,-2334.93,Honolulu HI,97687,3829.03,1
2024-12-18,08:38:00,AutoZone,-106.9,Winter Park FL,32789,6057.06,0
2024-12-18,13:51:00,Pep Boys,-334.43,Oviedo FL,32765,5722.63,0
2024-12-18,21:01:00,Starbucks,-20.5,Oviedo FL,32765,5702.13,0
2024-12-18,06:23:00,Fraud,-2168.6,Anchorage AL,23698,3533.53,1
2024-12-19,08:53:00,Subway,-15.88,Orlando FL,32816,5686.25,0
2024-12-19,16:42:00,Target,-112.78,Oviedo FL,32765,5573.47,0
2024-12-19,10:36:00,Subway,-37.91,Winter Park FL,32789,5535.56,0
2024-12-22,14:38:00,Whole Foods,-37.8,Winter Park FL,32789,5497.76,0
2024-12-23,16:25:00,Midas,-165.69,Winter Park FL,32789,5332.07,0
2024-12-23,13:07:00,Chevron,-10.0,Winter Park FL,32789,5322.07,0
2024-12-24,17:21:00,Starbucks,-38.28,Oviedo FL,32765,5283.79,0
2024-12-24,16:41:00,Movie Theater,-36.51,Orlando FL,32816,5247.28,0
2024-12-25,15:05:00,Subway,-32.31,Oviedo FL,32765,5214.97,0
2024-12-25,19:04:00,McDonald's,-12.79,Orlando FL,32816,5202.18,0
2024-12-26,16:59:00,Burger King,-9.99,Winter Park FL,32789,5192.19,0
2024-12-27,13:13:00,Amusement Park,-49.19,Oviedo FL,32765,5143.0,0
2024-12-27,09:16:00,Best Buy,-66.17,Orlando FL,32816,5076.83,0
2024-12-27,19:51:00,Netflix,-20.69,Orlando FL,32816,5056.14,0
2024-12-28,17:30:00,BP,-24.37,Oviedo FL,32765,5031.77,0
2024-12-28,15:24:00,McDonald's,-15.19,Orlando FL,32816,5016.58,0
2024-12-28,21:26:00,Amusement Park,-17.4,Oviedo FL,32765,4999.18,0
2024-12-29,15:14:00,McDonald's,-6.54,Winter Park FL,32789,4992.64,0
2024-12-29,14:35:00,Walmart,-44.97,Winter Park FL,32789,4947.67,0
2024-12-30,08:00:00,Paycheck,2000.0,Oviedo FL,32765,6947.67,0
2024-12-30,15:38:00,Walmart,-23.86,Oviedo FL,32765,6923.81,0
2024-12-30,08:54:00,Publix,-148.66,Oviedo FL,32765,6775.15,0
2024-12-30,13:12:00,Impractical Jokers,-2583.92,Groton CT,88462,4191.23,1
2024-12-31,19:46:00,Burger King,-70.64,Oviedo FL,32765,6704.51,0
2025-01-01,09:00:00,Rent,-960.0,Oviedo FL,32765,5744.51,0
2025-01-01,09:00:00,Insurance,-197.46,Oviedo FL,32765,5547.05,0
2025-01-01,09:00:00,Car,-300.0,Oviedo FL,32765,5247.05,0
2025-01-01,10:42:00,Starbucks,-29.78,Oviedo FL,32765,5217.27,0
2025-01-01,11:46:00,Whole Foods,-83.39,Winter Park FL,32789,5133.88,0
2025-01-01,21:21:00,CVS,-36.4,Winter Park FL,32789,5097.48,0
2025-01-05,21:28:00,Best Buy,-18.64,Winter Park FL,32789,5078.84,0
2025-01-05,22:58:00,Fraud,-1900.91,Honolulu HI,26397,3177.93,1
2025-01-05,19:32:00,McDonald's,-29.76,Oviedo FL,32765,5049.08,0
2025-01-05,15:30:00,Amazon,-113.06,Oviedo FL,32765,4936.02,0
2025-01-05,20:17:00,Fat Joe,-2282.46,Groton CT,31614,2653.56,1
2025-01-06,12:52:00,Best Buy,-136.15,Oviedo FL,32765,4799.87,0
2025-01-06,04:32:00,Lockheed Martin,-204.19,Anchorage AL,20705,4595.68,1
2025-01-06,21:37:00,BP,-22.55,Winter Park FL,32789,4777.32,0
2025-01-07,09:00:00,Spotify,-11.99,Oviedo FL,32765,4765.33,0
2025-01-07,09:00:00,Internet,-70.89,Oviedo FL,32765,4694.44,0
2025-01-07,09:00:00,ChatGPT Plus,-20.0,Oviedo FL,32765,4674.44,0
2025-01-09,08:59:00,Concert Tickets,-17.26,Winter Park FL,32789,4657.18,0
2025-01-09,08:39:00,Walmart,-137.41,Orlando FL,32816,4519.77,0
2025-01-09,21:17:00,Subway,-14.49,Oviedo FL,32765,4505.28,0
2025-01-10,17:05:00,Burger King,-12.9,Oviedo FL,32765,4492.38,0
2025-01-11,23:39:00,Pawn Stars,-251.18,Pittsburgh PA,52410,4241.2,1
2025-01-11,17:15:00,Burger King,-29.87,Oviedo FL,32765,4462.51,0
2025-01-11,14:21:00,Burger King,-29.43,Winter Park FL,32789,4433.08,0
2025-01-11,17:13:00,Exxon,-23.0,Orlando FL,32816,4410.08,0
2025-01-12,20:39:00,Movie Theater,-56.98,Winter Park FL,32789,4353.1,0
2025-01-12,10:17:00,Burger King,-35.97,Winter Park FL,32789,4317.13,0
2025-01-13,08:00:00,Paycheck,2000.0,Oviedo FL,32765,6317.13,0
2025-01-13,15:34:00,Pawn Stars,-2793.8,London EN,95065,3523.33,1
2025-01-13,19:40:00,McDonald's,-54.16,Orlando FL,32816,6262.97,0
2025-01-14,22:27:00,Servicenow,-476.92,Los Angeles CA,52813,5786.05,1
2025-01-14,11:51:00,Subway,-34.96,Oviedo FL,32765,6228.01,0
2025-01-14,20:30:00,Shell,-54.45,Winter Park FL,32789,6173.56,0
2025-01-15,17:14:00,Best Buy,-188.85,Orlando FL,32816,5984.71,0
2025-01-15,19:47:00,Lockheed Martin,-2099.42,Mexico City MC,39782,3885.29,1
2025-01-16,08:33:00,Starbucks,-8.95,Winter Park FL,32789,5975.76,0
2025-01-16,17:38:00,Publix,-70.93,Winter Park FL,32789,5904.83,0
2025-01-16,14:47:00,Target,-105.7,Oviedo FL,32765,5799.13,0
2025-01-17,18:51:00,Kroger,-43.42,Orlando FL,32816,5755.71,0
2025-01-17,10:41:00,McDonald's,-32.79,Oviedo FL,32765,5722.92,0
2025-01-19,12:32:00,CVS,-38.87,Winter Park FL,32789,5684.05,0
2025-01-19,17:09:00,Dollar Tree,-42.36,Oviedo FL,32765,5641.69,0
2025-01-20,10:45:00,McDonald's,-24.86,Orlando FL,32816,5616.83,0
2025-01-20,09:50:00,Accelerators,-2012.16,Los Angeles CA,71407,3604.67,1
2025-01-20,12:09:00,Best Buy,-111.26,Winter Park FL,32789,5505.57,0
2025-01-20,15:29:00,AutoZone,-161.6,Winter Park FL,32789,5343.97,0
2025-01-22,22:15:00,IBM,-2884.19,Charleston SC,99221,2459.78,1
2025-01-23,22:34:00,Servicenow,-2911.89,Anchorage AL,36955,2432.08,1
2025-01-23,19:09:00,Amazon,-65.55,Winter Park FL,32789,5278.42,0
2025-01-23,08:59:00,Publix,-96.76,Orlando FL,32816,5181.66,0
2025-01-23,13:29:00,Walmart,-116.12,Oviedo FL,32765,5065.54,0
2025-01-24,18:13:00,Amazon,-70.89,Orlando FL,32816,4994.65,0
2025-01-24,22:36:00,Servicenow,-1423.92,London EN,73874,3570.73,1
2025-01-25,09:40:00,Dollar Tree,-25.75,Winter Park FL,32789,4968.9,0
2025-01-25,18:46:00,Kroger,-62.49,Oviedo FL,32765,4906.41,0
2025-01-27,08:00:00,Paycheck,2000.0,Oviedo FL,32765,6906.41,0
2025-01-28,15:14:00,Kroger,-161.76,Winter Park FL,32789,6744.65,0
2025-01-28,23:58:00,Lockheed Martin,-1594.91,Honolulu HI,88306,5149.74,1
2025-01-29,15:41:00,Amusement Park,-23.37,Orlando FL,32816,6721.28,0
2025-01-29,15:44:00,McDonald's,-73.91,Winter Park FL,32789,6647.37,0
2025-01-31,15:04:00,Movie Theater,-117.76,Oviedo FL,32765,6529.61,0
2025-01-31,08:03:00,Dollar Tree,-64.13,Oviedo FL,32765,6465.48,0
2025-01-31,21:39:00,Whole Foods,-155.25,Orlando FL,32816,6310.23,0
2025-01-31,21:13:00,Accelerators,-342.75,Pittsburgh PA,97039,5967.48,1
2025-02-01,09:00:00,Rent,-960.0,Oviedo FL,32765,5350.23,0
2025-02-01,09:00:00,Insurance,-197.46,Oviedo FL,32765,5152.77,0
2025-02-01,09:00:00,Car,-300.0,Oviedo FL,32765,4852.77,0
2025-02-01,10:03:00,BP,-19.34,Oviedo FL,32765,4833.43,0
2025-02-03,10:55:00,Starbucks,-32.42,Oviedo FL,32765,4801.01,0
2025-02-03,13:31:00,Best Buy,-123.36,Winter Park FL,32789,4677.65,0
2025-02-04,17:43:00,Trader Joe's,-79.31,Winter Park FL,32789,4598.34,0
2025-02-04,11:56:00,Publix,-61.01,Orlando FL,32816,4537.33,0
2025-02-04,10:35:00,Best Buy,-148.78,Winter Park FL,32789,4388.55,0
2025-02-05,12:01:00,BP,-12.6,Orlando FL,32816,4375.95,0
2025-02-05,11:26:00,Burger King,-20.2,Orlando FL,32816,4355.75,0
2025-02-07,09:00:00,Spotify,-11.99,Oviedo FL,32765,4343.76,0
2025-02-07,09:00:00,Internet,-70.89,Oviedo FL,32765,4272.87,0
2025-02-07,09:00:00,ChatGPT Plus,-20.0,Oviedo FL,32765,4252.87,0
2025-02-07,18:58:00,Chevron,-18.04,Orlando FL,32816,4234.83,0
2025-02-07,13:19:00,Monster Energy,-208.28,Honolulu HI,56064,4026.55,1
2025-02-07,20:38:00,Netflix,-51.07,Winter Park FL,32789,4183.76,0
2025-02-07,08:59:00,Whole Foods,-52.06,Winter Park FL,32789,4131.7,0
2025-02-08,14:27:00,Burger King,-20.39,Oviedo FL,32765,4111.31,0
2025-02-08,13:37:00,Subway,-38.11,Winter Park FL,32789,4073.2,0
2025-02-09,05:12:00,Fat Joe,-2655.8,Anchorage AL,21386,1417.4,1
2025-02-09,16:34:00,Subway,-20.59,Orlando FL,32816,4052.61,0
2025-02-09,17:23:00,Burger King,-28.38,Oviedo FL,32765,4024.23,0
2025-02-09,16:00:00,Subway,-21.51,Oviedo FL,32765,4002.72,0
2025-02-10,08:00:00,Paycheck,2000.0,Oviedo FL,32765,6002.72,0
2025-02-10,10:50:00,Starbucks,-32.18,Oviedo FL,32765,5970.54,0
2025-02-10,10:15:00,Walmart,-46.85,Orlando FL,32816,5923.69,0
2025-02-10,17:21:00,Amazon,-58.49,Orlando FL,32816,5865.2,0
2025-02-11,18:11:00,BP,-14.31,Oviedo FL,32765,5850.89,0
2025-02-11,13:48:00,Starbucks,-36.17,Winter Park FL,32789,5814.72,0
2025-02-11,06:36:00,Accelerators,-1770.34,Pittsburgh PA,95853,4044.38,1
2025-02-11,14:45:00,Walgreens,-20.47,Oviedo FL,32765,5794.25,0
2025-02-12,08:25:00,Whole Foods,-50.93,Orlando FL,32816,5743.32,0
2025-02-13,12:37:00,Subway,-33.09,Winter Park FL,32789,5710.23,0
2025-02-13,10:51:00,Whole Foods,-85.52,Orlando FL,32816,5624.71,0
2025-02-13,20:58:00,McDonald's,-30.41,Oviedo FL,32765,5594.3,0
2025-02-14,16:25:00,Burger King,-30.34,Oviedo FL,32765,5563.96,0
2025-02-14,17:48:00,Publix,-76.45,Winter Park FL,32789,5487.51,0
2025-02-15,11:08:00,Starbucks,-7.09,Orlando FL,32816,5480.42,0
2025-02-15,17:38:00,Five Below,-18.74,Winter Park FL,32789,5461.68,0
2025-02-16,19:30:00,Subway,-13.08,Winter Park FL,32789,5448.6,0
2025-02-16,19:20:00,Pep Boys,-173.9,Oviedo FL,32765,5274.7,0
2025-02-16,13:32:00,Concert Tickets,-13.12,Orlando FL,32816,5261.58,0
2025-02-17,19:00:00,Concert Tickets,-35.35,Winter Park FL,32789,5226.23,0
2025-02-17,20:57:00,Starbucks,-17.38,Orlando FL,32816,5208.85,0
2025-02-17,10:43:00,Kroger,-36.36,Winter Park FL,32789,5172.49,0
2025-02-18,18:38:00,Servicenow,-2541.15,Pyongyang NK,92710,2631.34,1
2025-02-19,20:22:00,McDonald's,-6.63,Orlando FL,32816,5165.86,0
2025-02-19,09:01:00,Pep Boys,-94.01,Winter Park FL,32789,5071.85,0
2025-02-20,13:55:00,Best Buy,-78.99,Orlando FL,32816,4992.86,0
2025-02-20,10:30:00,Subway,-10.83,Orlando FL,32816,4982.03,0
2025-02-21,10:17:00,Publix,-41.72,Winter Park FL,32789,4940.31,0
2025-02-22,10:31:00,Netflix,-47.31,Orlando FL,32816,4893.0,0
2025-02-22,17:43:00,Whole Foods,-85.15,Winter Park FL,32789,4807.85,0
2025-02-22,09:12:00,Walgreens,-45.7,Oviedo FL,32765,4762.15,0
2025-02-23,15:09:00,IBM,-2105.97,Tokyo JP,78215,2656.18,1
2025-02-23,16:00:00,Starbucks,-28.55,Orlando FL,32816,4733.6,0
2025-02-23,17:12:00,Burger King,-13.05,Winter Park FL,32789,4720.55,0
2025-02-24,08:00:00,Paycheck,2000.0,Oviedo FL,32765,6720.55,0
2025-02-24,21:02:00,Burger King,-59.47,Oviedo FL,32765,6661.08,0
2025-02-24,16:36:00,Jiffy Lube,-114.04,Oviedo FL,32765,6547.04,0
2025-02-24,07:38:00,Paypal,-2747.1,London EN,19569,3799.94,1
2025-02-25,16:33:00,Subway,-57.23,Oviedo FL,32765,6489.81,0
2025-02-25,11:36:00,Amazon,-144.55,Orlando FL,32816,6345.26,0
2025-02-26,06:27:00,Fat Joe,-1319.85,Pyongyang NK,94933,5025.41,1
2025-02-26,21:34:00,Target,-170.83,Oviedo FL,32765,6174.43,0
2025-02-26,17:26:00,Exxon,-54.1,Orlando FL,32816,6120.33,0
2025-02-26,10:10:00,Five Below,-11.08,Orlando FL,32816,6109.25,0
2025-02-27,08:32:00,Shell,-43.69,Oviedo FL,32765,6065.56,0
2025-02-27,10:28:00,Whole Foods,-68.36,Orlando FL,32816,5997.2,0
2025-02-28,12:20:00,Whole Foods,-99.79,Winter Park FL,32789,5897.41,0
2025-02-28,21:11:00,Subway,-5.55,Oviedo FL,32765,5891.86,0
2025-02-28,19:33:00,Amusement Park,-29.37,Orlando FL,32816,5862.49,0
2025-03-01,09:00:00,Rent,-960.0,Oviedo FL,32765,4902.49,0
2025-03-01,09:00:00,Insurance,-197.46,Oviedo FL,32765,4705.03,0
2025-03-01,09:00:00,Car,-300.0,Oviedo FL,32765,4405.03,0
2025-03-01,18:54:00,Amazon,-12.05,Orlando FL,32816,4392.98,0
2025-03-03,20:15:00,Amazon,-47.08,Orlando FL,32816,4345.9,0
2025-03-03,16:33:00,Starbucks,-14.86,Winter Park FL,32789,4331.04,0
2025-03-04,21:38:00,Target,-128.14,Orlando FL,32816,4202.9,0
2025-03-05,12:22:00,Subway,-6.06,Orlando FL,32816,4196.84,0
2025-03-05,16:05:00,Starbucks,-29.83,Winter Park FL,32789,4167.01,0
2025-03-05,08:49:00,Movie Theater,-15.57,Oviedo FL,32765,4151.44,0
2025-03-05,13:31:00,Onlyfans,-1112.4,London EN,79006,3039.04,1
2025-03-06,08:56:00,Five Below,-48.07,Orlando FL,32816,4103.37,0
2025-03-06,19:37:00,Shell,-23.55,Winter Park FL,32789,4079.82,0
2025-03-06,13:27:00,Amazon,-97.3,Winter Park FL,32789,3982.52,0
2025-03-06,02:58:00,Magic the Gathering,-2375.29,Tokyo JP,14430,1607.23,1
2025-03-07,09:00:00,Spotify,-11.99,Oviedo FL,32765,3970.53,0
2025-03-07,09:00:00,Internet,-70.89,Oviedo FL,32765,3899.64,0
2025-03-07,09:00:00,ChatGPT Plus,-20.0,Oviedo FL,32765,3879.64,0
2025-03-07,13:33:00,McDonald's,-27.14,Orlando FL,32816,3852.5,0
2025-03-07,20:02:00,Starbucks,-29.96,Orlando FL,32816,3822.54,0
2025-03-09,19:01:00,Starbucks,-27.87,Winter Park FL,32789,3794.67,0
2025-03-10,08:00:00,Paycheck,2000.0,Oviedo FL,32765,5794.67,0
2025-03-10,15:31:00,Target,-109.21,Oviedo FL,32765,5685.46,0
2025-03-10,08:32:00,Amazon,-143.81,Winter Park FL,32789,5541.65,0
2025-03-10,11:48:00,Monster Energy,-2701.96,Honolulu HI,24971,2839.69,1
2025-03-11,17:27:00,Concert Tickets,-51.94,Orlando FL,32816,5489.71,0
2025-03-11,10:27:00,Exxon,-28.6,Oviedo FL,32765,5461.11,0
2025-03-12,20:54:00,Lockheed Martin,-693.32,Honolulu HI,78308,4767.79,1
2025-03-12,15:21:00,Five Below,-27.68,Winter Park FL,32789,5433.43,0
2025-03-12,08:48:00,Starbucks,-31.53,Winter Park FL,32789,5401.9,0
2025-03-14,11:58:00,Amazon,-117.3,Oviedo FL,32765,5284.6,0
2025-03-14,12:47:00,Burger King,-10.33,Winter Park FL,32789,5274.27,0
2025-03-15,10:57:00,Netflix,-30.93,Orlando FL,32816,5243.34,0
2025-03-15,09:35:00,Walgreens,-20.05,Oviedo FL,32765,5223.29,0
2025-03-15,18:37:00,Subway,-37.34,Oviedo FL,32765,5185.95,0
2025-03-17,08:51:00,Subway,-39.48,Oviedo FL,32765,5146.47,0
2025-03-18,20:55:00,Amazon,-19.99,Orlando FL,32816,5126.48,0
2025-03-18,10:25:00,Burger King,-9.95,Orlando FL,32816,5116.53,0
2025-03-19,12:32:00,Exxon,-27.07,Winter Park FL,32789,5089.46,0
2025-03-21,13:42:00,Whole Foods,-35.45,Orlando FL,32816,5054.01,0
2025-03-21,16:47:00,Best Buy,-16.08,Oviedo FL,32765,5037.93,0
2025-03-21,17:21:00,Midas,-100.64,Orlando FL,32816,4937.29,0
2025-03-22,11:05:00,Walgreens,-45.39,Orlando FL,32816,4891.9,0
2025-03-23,12:48:00,Walgreens,-45.33,Oviedo FL,32765,4846.57,0
2025-03-23,12:08:00,Servicenow,-2153.93,Tokyo JP,54948,2692.64,1
2025-03-23,17:43:00,AutoZone,-179.28,Winter Park FL,32789,4667.29,0
2025-03-24,08:00:00,Paycheck,2000.0,Oviedo FL,32765,6667.29,0
2025-03-24,08:11:00,Burger King,-27.01,Orlando FL,32816,6640.28,0
2025-03-25,20:59:00,Burger King,-22.98,Winter Park FL,32789,6617.3,0
2025-03-25,12:51:00,Walmart,-43.1,Winter Park FL,32789,6574.2,0
2025-03-28,16:21:00,Subway,-72.16,Winter Park FL,32789,6502.04,0
2025-03-28,13:57:00,Kroger,-98.95,Winter Park FL,32789,6403.09,0
2025-03-28,10:34:00,Jiffy Lube,-251.92,Winter Park FL,32789,6151.17,0
2025-03-29,18:14:00,BP,-28.15,Oviedo FL,32765,6123.02,0
2025-03-29,14:28:00,Best Buy,-223.34,Orlando FL,32816,5899.68,0
2025-03-30,08:39:00,Pep Boys,-153.92,Oviedo FL,32765,5745.76,0
2025-03-30,14:29:00,Walmart,-105.73,Oviedo FL,32765,5640.03,0
2025-04-01,09:00:00,Rent,-960.0,Oviedo FL,32765,4680.03,0
2025-04-01,09:00:00,Insurance,-197.46,Oviedo FL,32765,4482.57,0
2025-04-01,09:00:00,Car,-300.0,Oviedo FL,32765,4182.57,0
2025-04-01,18:00:00,Five Below,-43.54,Orlando FL,32816,4139.03,0
2025-04-01,15:07:00,Amazon,-92.36,Winter Park FL,32789,4046.67,0
2025-04-02,20:41:00,AutoZone,-82.52,Orlando FL,32816,3964.15,0
2025-04-03,12:58:00,Five Below,-5.18,Winter Park FL,32789,3958.97,0
2025-04-04,07:31:00,Magic the Gathering,-2010.21,Mexico City MC,97041,1948.76,1
2025-04-05,08:40:00,Exxon,-26.27,Orlando FL,32816,3932.7,0
2025-04-05,20:57:00,Starbucks,-16.7,Oviedo FL,32765,3916.0,0
2025-04-05,20:44:00,Magic the Gathering,-444.0,Pittsburgh PA,24308,3472.0,1
2025-04-05,18:12:00,Concert Tickets,-36.56,Oviedo FL,32765,3879.44,0
2025-04-05,15:54:00,Fraud,-1107.55,Honolulu HI,80569,2771.89,1
2025-04-06,14:41:00,Subway,-7.13,Oviedo FL,32765,3872.31,0
2025-04-06,20:15:00,Burger King,-8.56,Winter Park FL,32789,3863.75,0
2025-04-06,20:39:00,Accelerators,-2635.08,New York NY,81210,1228.67,1
2025-04-06,12:12:00,Jiffy Lube,-103.56,Oviedo FL,32765,3760.19,0
2025-04-07,08:00:00,Paycheck,2000.0,Oviedo FL,32765,5760.19,0
2025-04-07,09:00:00,Spotify,-11.99,Oviedo FL,32765,5748.2,0
2025-04-07,09:00:00,Internet,-70.89,Oviedo FL,32765,5677.31,0
2025-04-07,09:00:00,ChatGPT Plus,-20.0,Oviedo FL,32765,5657.31,0
2025-04-07,20:34:00,CVS,-11.32,Winter Park FL,32789,5645.99,0
2025-04-07,18:59:00,BP,-16.18,Winter Park FL,32789,5629.81,0
2025-04-07,18:25:00,Chevron,-20.15,Oviedo FL,32765,5609.66,0
2025-04-09,16:54:00,McDonald's,-33.32,Winter Park FL,32789,5576.34,0
2025-04-09,12:03:00,Kroger,-77.91,Orlando FL,32816,5498.43,0
2025-04-09,08:40:00,Starbucks,-21.36,Orlando FL,32816,5477.07,0
2025-04-11,20:06:00,Monster Energy,-1787.92,Anchorage AL,36835,3689.15,1
2025-04-11,08:49:00,CVS,-28.05,Orlando FL,32816,5449.02,0
2025-04-12,07:21:00,Fraud,-2600.4,Anchorage AL,52056,2848.62,1
2025-04-13,01:55:00,Onlyfans,-2116.78,Tokyo JP,93000,3332.24,1
2025-04-13,18:11:00,McDonald's,-22.56,Winter Park FL,32789,5426.46,0
2025-04-13,18:57:00,Best Buy,-131.9,Orlando FL,32816,5294.56,0
2025-04-13,21:38:00,Kroger,-99.77,Oviedo FL,32765,5194.79,0
2025-04-14,18:23:00,Jiffy Lube,-87.71,Oviedo FL,32765,5107.08,0
2025-04-15,08:35:00,Walmart,-130.91,Oviedo FL,32765,4976.17,0
2025-04-15,11:07:00,Dollar Tree,-24.42,Oviedo FL,32765,4951.75,0
2025-04-16,10:51:00,Burger King,-22.86,Winter Park FL,32789,4928.89,0
2025-04-16,15:28:00,Starbucks,-31.54,Winter Park FL,32789,4897.35,0
2025-04-16,16:56:00,Trader Joe's,-96.22,Winter Park FL,32789,4801.13,0
2025-04-17,08:03:00,Paypal,-2640.21,Anchorage AL,31718,2160.92,1
2025-04-18,18:40:00,Amazon,-42.54,Oviedo FL,32765,4758.59,0
2025-04-18,08:35:00,Best Buy,-136.79,Orlando FL,32816,4621.8,0
2025-04-18,16:00:00,McDonald's,-25.75,Oviedo FL,32765,4596.05,0
2025-04-19,13:59:00,Subway,-32.79,Oviedo FL,32765,4563.26,0
2025-04-21,08:00:00,Paycheck,2000.0,Oviedo FL,32765,6563.26,0
2025-04-21,09:25:00,Movie Theater,-50.24,Winter Park FL,32789,6513.02,0
2025-04-21,12:17:00,Subway,-59.88,Orlando FL,32816,6453.14,0
2025-04-21,12:04:00,Subway,-62.32,Winter Park FL,32789,6390.82,0
2025-04-22,12:52:00,Lockheed Martin,-1292.5,Honolulu HI,19660,5098.32,1
2025-04-23,09:27:00,Publix,-156.22,Winter Park FL,32789,6234.6,0
2025-04-24,21:38:00,Amazon,-92.18,Oviedo FL,32765,6142.42,0
2025-04-24,20:11:00,AutoZone,-189.74,Oviedo FL,32765,5952.68,0
2025-04-24,17:58:00,Best Buy,-74.7,Winter Park FL,32789,5877.98,0
2025-04-26,10:58:00,Burger King,-29.92,Winter Park FL,32789,5848.06,0
2025-04-26,20:53:00,Burger King,-36.52,Orlando FL,32816,5811.54,0
2025-04-26,20:24:00,Exxon,-28.59,Oviedo FL,32765,5782.95,0
2025-04-27,12:26:00,Shell,-10.95,Oviedo FL,32765,5772.0,0
2025-04-27,18:28:00,Subway,-36.49,Winter Park FL,32789,5735.51,0
2025-04-28,14:53:00,Publix,-45.27,Orlando FL,32816,5690.24,0
2025-04-29,14:51:00,Shell,-19.57,Orlando FL,32816,5670.67,0
2025-04-30,14:00:00,Exxon,-16.58,Oviedo FL,32765,5654.09,0
2025-04-30,17:11:00,Chevron,-23.17,Orlando FL,32816,5630.92,0
2025-05-01,09:00:00,Rent,-960.0,Oviedo FL,32765,4670.92,0
2025-05-01,09:00:00,Insurance,-197.46,Oviedo FL,32765,4473.46,0
2025-05-01,09:00:00,Car,-300.0,Oviedo FL,32765,4173.46,0
2025-05-01,09:42:00,Starbucks,-38.65,Winter Park FL,32789,4134.81,0
2025-05-01,08:49:00,Concert Tickets,-31.03,Orlando FL,32816,4103.78,0
2025-05-01,08:57:00,Netflix,-58.39,Orlando FL,32816,4045.39,0
2025-05-01,18:08:00,Servicenow,-521.09,Groton CT,11528,3524.3,1
2025-05-02,10:13:00,Exxon,-29.01,Oviedo FL,32765,4016.38,0
2025-05-02,10:47:00,Movie Theater,-22.41,Winter Park FL,32789,3993.97,0
2025-05-03,16:12:00,Paypal,-2705.34,Pyongyang NK,60572,1288.63,1
2025-05-03,08:31:00,Subway,-39.93,Oviedo FL,32765,3954.04,0
2025-05-04,20:57:00,Target,-88.63,Winter Park FL,32789,3865.41,0
2025-05-04,12:01:00,Subway,-39.76,Orlando FL,32816,3825.65,0
2025-05-05,08:00:00,Paycheck,2000.0,Oviedo FL,32765,5825.65,0
2025-05-05,12:52:00,Burger King,-7.14,Winter Park FL,32789,5818.51,0
2025-05-05,08:20:00,Kroger,-38.2,Winter Park FL,32789,5780.31,0
2025-05-05,21:38:00,McDonald's,-10.63,Winter Park FL,32789,5769.68,0
2025-05-06,19:34:00,Starbucks,-20.88,Orlando FL,32816,5748.8,0
2025-05-06,12:43:00,Publix,-73.71,Orlando FL,32816,5675.09,0
2025-05-06,11:32:00,Burger King,-9.54,Orlando FL,32816,5665.55,0
2025-05-06,22:35:00,Onlyfans,-1402.5,Los Angeles CA,58556,4263.05,1
2025-05-07,09:00:00,Spotify,-11.99,Oviedo FL,32765,5653.56,0
2025-05-07,09:00:00,Internet,-70.89,Oviedo FL,32765,5582.67,0
2025-05-07,09:00:00,ChatGPT Plus,-20.0,Oviedo FL,32765,5562.67,0
2025-05-07,17:54:00,Dollar Tree,-49.76,Orlando FL,32816,5512.91,0
2025-05-07,15:16:00,Pawn Stars,-2828.8,London EN,18458,2684.11,1
2025-05-07,21:45:00,McDonald's,-13.36,Orlando FL,32816,5499.55,0
2025-05-08,17:59:00,Starbucks,-34.65,Oviedo FL,32765,5464.9,0
2025-05-10,13:19:00,Amazon,-93.32,Winter Park FL,32789,5371.58,0
2025-05-11,16:36:00,Starbucks,-38.93,Orlando FL,32816,5332.65,0
2025-05-11,13:02:00,Concert Tickets,-48.0,Winter Park FL,32789,5284.65,0
2025-05-12,05:40:00,Impractical Jokers,-596.48,Charleston SC,85611,4688.17,1
2025-05-12,15:06:00,Shell,-23.58,Winter Park FL,32789,5261.07,0
2025-05-12,20:32:00,Fat Joe,-1238.23,Anchorage AL,46974,4022.84,1
2025-05-12,10:30:00,BP,-18.12,Winter Park FL,32789,5242.95,0
2025-05-12,13:17:00,Kroger,-68.41,Oviedo FL,32765,5174.54,0
2025-05-13,10:23:00,Walmart,-104.65,Winter Park FL,32789,5069.89,0
2025-05-13,13:39:00,Kroger,-53.1,Oviedo FL,32765,5016.79,0
2025-05-13,03:39:00,Magic the Gathering,-2479.13,Tokyo JP,17473,2537.66,1
2025-05-13,14:55:00,Walmart,-29.4,Oviedo FL,32765,4987.39,0
2025-05-14,14:35:00,Movie Theater,-32.31,Oviedo FL,32765,4955.08,0
2025-05-14,22:16:00,Paypal,-2083.3,New York NY,28209,2871.78,1
2025-05-14,19:09:00,Walgreens,-22.46,Winter Park FL,32789,4932.62,0
2025-05-15,15:14:00,Target,-118.94,Oviedo FL,32765,4813.68,0
2025-05-15,09:05:00,Publix,-89.37,Winter Park FL,32789,4724.31,0
2025-05-15,21:32:00,IBM,-966.11,Charleston SC,88436,3758.2,1
2025-05-16,18:10:00,Exxon,-18.91,Orlando FL,32816,4705.4,0
2025-05-16,13:05:00,Accelerators,-1534.34,Mexico City MC,63982,3171.06,1
2025-05-16,17:39:00,Subway,-35.88,Orlando FL,32816,4669.52,0
2025-05-17,11:41:00,Walmart,-138.77,Winter Park FL,32789,4530.75,0
2025-05-17,18:44:00,Pawn Stars,-1464.0,Pittsburgh PA,37217,3066.75,1
2025-05-17,19:15:00,McDonald's,-23.25,Orlando FL,32816,4507.5,0
2025-05-18,12:50:00,Kroger,-65.98,Orlando FL,32816,4441.52,0
2025-05-18,16:03:00,McDonald's,-23.86,Orlando FL,32816,4417.66,0
2025-05-18,23:40:00,Monster Energy,-1728.86,Anchorage AL,71079,2688.8,1
2025-05-18,11:01:00,Shell,-11.21,Oviedo FL,32765,4406.45,0
2025-05-19,08:00:00,Paycheck,2000.0,Oviedo FL,32765,6406.45,0
2025-05-22,12:27:00,Starbucks,-71.43,Orlando FL,32816,6335.02,0
2025-05-23,19:56:00,Trader Joe's,-63.78,Orlando FL,32816,6271.24,0
2025-05-23,21:01:00,Netflix,-87.23,Orlando FL,32816,6184.01,0
2025-05-24,18:30:00,Jiffy Lube,-232.39,Oviedo FL,32765,5951.62,0
2025-05-24,20:26:00,Burger King,-29.33,Orlando FL,32816,5922.29,0
2025-05-25,09:35:00,Midas,-126.99,Winter Park FL,32789,5795.3,0
2025-05-28,03:46:00,Paypal,-1914.12,New York NY,11922,3881.18,1
2025-05-29,10:04:00,Starbucks,-8.29,Orlando FL,32816,5787.01,0
2025-05-29,10:13:00,Amazon,-105.03,Orlando FL,32816,5681.98,0
2025-05-30,21:52:00,Magic the Gathering,-1447.38,Tokyo JP,48720,4234.6,1
2025-05-31,17:29:00,Walgreens,-12.82,Orlando FL,32816,5669.16,0
2025-06-01,09:00:00,Rent,-960.0,Oviedo FL,32765,4709.16,0
2025-06-01,09:00:00,Insurance,-197.46,Oviedo FL,32765,4511.7,0
2025-06-01,09:00:00,Car,-300.0,Oviedo FL,32765,4211.7,0
2025-06-01,16:53:00,Midas,-89.71,Winter Park FL,32789,4121.99,0
2025-06-02,08:00:00,Paycheck,2000.0,Oviedo FL,32765,6121.99,0
2025-06-04,17:18:00,Amusement Park,-70.96,Oviedo FL,32765,6051.03,0
2025-06-04,21:52:00,Shell,-21.07,Orlando FL,32816,6029.96,0
2025-06-04,17:49:00,Onlyfans,-2752.74,Honolulu HI,47294,3277.22,1
2025-06-04,16:40:00,Starbucks,-39.8,Oviedo FL,32765,5990.16,0
2025-06-05,21:55:00,BP,-12.46,Winter Park FL,32789,5977.7,0
2025-06-05,20:17:00,Walgreens,-44.94,Winter Park FL,32789,5932.76,0
2025-06-06,12:42:00,Walmart,-101.73,Orlando FL,32816,5831.03,0
2025-06-07,09:00:00,Spotify,-11.99,Oviedo FL,32765,5819.04,0
2025-06-07,09:00:00,Internet,-70.89,Oviedo FL,32765,5748.15,0
2025-06-07,09:00:00,ChatGPT Plus,-20.0,Oviedo FL,32765,5728.15,0
2025-06-09,09:04:00,Starbucks,-36.24,Orlando FL,32816,5691.91,0
2025-06-11,14:25:00,Dollar Tree,-42.57,Winter Park FL,32789,5649.34,0
2025-06-12,17:27:00,Dollar Tree,-34.98,Orlando FL,32816,5614.36,0
2025-06-12,18:21:00,Amazon,-98.01,Oviedo FL,32765,5516.35,0
2025-06-12,10:23:00,Subway,-29.14,Orlando FL,32816,5487.21,0
2025-06-13,13:31:00,Starbucks,-8.02,Orlando FL,32816,5479.19,0
2025-06-13,20:23:00,Dollar Tree,-22.85,Orlando FL,32816,5456.34,0
2025-06-14,19:11:00,Fraud,-190.25,London EN,50196,5266.09,1
2025-06-14,17:12:00,Target,-46.46,Orlando FL,32816,5409.88,0
2025-06-14,17:03:00,Midas,-43.42,Winter Park FL,32789,5366.46,0
2025-06-14,13:12:00,Publix,-79.2,Oviedo FL,32765,5287.26,0
2025-06-15,15:57:00,Target,-48.77,Orlando FL,32816,5238.49,0
2025-06-16,08:00:00,Paycheck,2000.0,Oviedo FL,32765,7238.49,0
2025-06-16,21:02:00,Five Below,-24.43,Oviedo FL,32765,7214.06,0
2025-06-17,11:10:00,Starbucks,-59.43,Winter Park FL,32789,7154.63,0
2025-06-17,10:39:00,Walgreens,-34.98,Orlando FL,32816,7119.65,0
2025-06-17,14:16:00,Movie Theater,-47.82,Orlando FL,32816,7071.83,0
2025-06-18,15:39:00,Starbucks,-31.93,Oviedo FL,32765,7039.9,0
2025-06-18,21:24:00,Dollar Tree,-35.63,Oviedo FL,32765,7004.27,0
2025-06-18,18:49:00,Five Below,-44.97,Orlando FL,32816,6959.3,0
2025-06-19,15:27:00,Starbucks,-23.59,Orlando FL,32816,6935.71,0
2025-06-19,00:47:00,Fraud,-780.75,New York NY,49520,6154.96,1
2025-06-20,13:18:00,Jiffy Lube,-345.84,Oviedo FL,32765,6589.87,0
2025-06-20,12:18:00,Subway,-60.18,Orlando FL,32816,6529.69,0
2025-06-20,13:20:00,Best Buy,-269.94,Oviedo FL,32765,6259.75,0
2025-06-21,19:15:00,Paypal,-951.54,Honolulu HI,53607,5308.21,1
2025-06-21,15:20:00,CVS,-66.59,Oviedo FL,32765,6193.16,0
2025-06-21,12:21:00,Amusement Park,-61.22,Oviedo FL,32765,6131.94,0
2025-06-21,17:14:00,Publix,-87.82,Winter Park FL,32789,6044.12,0
2025-06-22,14:10:00,Movie Theater,-114.18,Winter Park FL,32789,5929.94,0
2025-06-22,03:24:00,Fat Joe,-146.26,New York NY,28432,5783.68,1
2025-06-23,12:04:00,McDonald's,-16.85,Oviedo FL,32765,5913.09,0
2025-06-23,11:23:00,Subway,-27.69,Winter Park FL,32789,5885.4,0
2025-06-24,19:26:00,Burger King,-26.13,Orlando FL,32816,5859.27,0
2025-06-25,21:36:00,Whole Foods,-58.18,Oviedo FL,32765,5801.09,0
2025-06-25,11:35:00,Netflix,-38.82,Orlando FL,32816,5762.27,0
2025-06-26,11:35:00,AutoZone,-41.99,Oviedo FL,32765,5720.28,0
2025-06-26,15:19:00,Amusement Park,-29.63,Winter Park FL,32789,5690.65,0
2025-06-27,13:53:00,Pep Boys,-85.88,Orlando FL,32816,5604.77,0
2025-06-29,21:43:00,CVS,-25.68,Oviedo FL,32765,5579.09,0
2025-06-29,11:21:00,Amazon,-130.01,Oviedo FL,32765,5449.08,0
2025-06-29,21:16:00,Walgreens,-28.96,Orlando FL,32816,5420.12,0
2025-06-30,08:00:00,Paycheck,2000.0,Oviedo FL,32765,7420.12,0
2025-06-30,11:59:00,Target,-119.65,Oviedo FL,32765,7300.47,0
2025-06-30,09:11:00,Starbucks,-52.19,Oviedo FL,32765,7248.28,0
2025-06-30,13:39:00,Amazon,-65.43,Winter Park FL,32789,7182.85,0
2025-07-01,09:00:00,Rent,-960.0,Oviedo FL,32765,6222.85,0
2025-07-01,09:00:00,Insurance,-197.46,Oviedo FL,32765,6025.39,0
2025-07-01,09:00:00,Car,-300.0,Oviedo FL,32765,5725.39,0
2025-07-01,14:39:00,Kroger,-34.91,Orlando FL,32816,5690.48,0
2025-07-01,12:46:00,Exxon,-12.57,Winter Park FL,32789,5677.91,0
2025-07-02,21:49:00,Movie Theater,-36.94,Orlando FL,32816,5640.97,0
2025-07-02,13:16:00,McDonald's,-10.05,Winter Park FL,32789,5630.92,0
2025-07-02,10:45:00,Monster Energy,-2116.63,Mexico City MC,45456,3514.29,1
2025-07-03,18:42:00,Monster Energy,-932.09,Groton CT,46989,4698.83,1
2025-07-03,15:26:00,Whole Foods,-34.88,Winter Park FL,32789,5596.04,0
2025-07-04,16:13:00,McDonald's,-33.17,Winter Park FL,32789,5562.87,0
2025-07-05,10:31:00,Best Buy,-16.88,Winter Park FL,32789,5545.99,0
2025-07-05,16:37:00,Dollar Tree,-7.68,Orlando FL,32816,5538.31,0
2025-07-07,09:00:00,Spotify,-11.99,Oviedo FL,32765,5526.32,0
2025-07-07,09:00:00,Internet,-70.89,Oviedo FL,32765,5455.43,0
2025-07-07,09:00:00,ChatGPT Plus,-20.0,Oviedo FL,32765,5435.43,0
2025-07-07,18:57:00,Burger King,-25.07,Oviedo FL,32765,5410.36,0
2025-07-07,14:43:00,Servicenow,-838.86,Anchorage AL,98032,4571.5,1
2025-07-08,12:33:00,Fat Joe,-612.18,Pyongyang NK,14710,4798.18,1
2025-07-08,11:35:00,CVS,-40.87,Orlando FL,32816,5369.49,0
2025-07-08,18:01:00,Starbucks,-12.09,Oviedo FL,32765,5357.4,0
2025-07-08,17:46:00,Exxon,-12.3,Oviedo FL,32765,5345.1,0
2025-07-09,17:45:00,Subway,-21.87,Orlando FL,32816,5323.23,0
2025-07-11,12:06:00,Walmart,-86.98,Winter Park FL,32789,5236.25,0
2025-07-11,15:36:00,Burger King,-11.54,Winter Park FL,32789,5224.71,0
2025-07-11,19:38:00,Walgreens,-45.21,Winter Park FL,32789,5179.5,0
2025-07-12,21:47:00,Walgreens,-32.68,Winter Park FL,32789,5146.82,0
2025-07-12,14:31:00,Starbucks,-25.41,Oviedo FL,32765,5121.41,0
2025-07-12,08:18:00,Netflix,-58.39,Winter Park FL,32789,5063.02,0
2025-07-13,16:41:00,Best Buy,-67.82,Oviedo FL,32765,4995.2,0
2025-07-13,18:32:00,Netflix,-23.63,Winter Park FL,32789,4971.57,0
2025-07-14,08:00:00,Paycheck,2000.0,Oviedo FL,32765,6971.57,0
2025-07-14,11:45:00,Subway,-39.21,Oviedo FL,32765,6932.36,0
2025-07-14,21:56:00,Publix,-162.14,Orlando FL,32816,6770.22,0
2025-07-14,18:48:00,CVS,-98.01,Winter Park FL,32789,6672.21,0
2025-07-15,11:52:00,Chevron,-34.25,Oviedo FL,32765,6637.96,0
2025-07-15,09:14:00,McDonald's,-44.38,Orlando FL,32816,6593.58,0
2025-07-16,13:50:00,Target,-276.35,Orlando FL,32816,6317.23,0
2025-07-16,20:27:00,Dollar Tree,-81.62,Orlando FL,32816,6235.61,0
2025-07-17,18:41:00,McDonald's,-28.45,Winter Park FL,32789,6207.16,0
2025-07-19,16:05:00,Amazon,-40.01,Orlando FL,32816,6167.15,0
2025-07-20,21:35:00,Subway,-17.06,Oviedo FL,32765,6150.09,0
2025-07-20,19:53:00,Burger King,-33.15,Orlando FL,32816,6116.94,0
2025-07-21,18:54:00,Concert Tickets,-54.92,Orlando FL,32816,6062.02,0
2025-07-22,15:03:00,Subway,-41.8,Orlando FL,32816,6020.22,0
2025-07-22,20:47:00,Subway,-42.65,Oviedo FL,32765,5977.57,0
2025-07-23,18:00:00,Trader Joe's,-59.29,Winter Park FL,32789,5918.28,0
2025-07-23,15:13:00,AutoZone,-40.18,Orlando FL,32816,5878.1,0
2025-07-23,10:45:00,Jiffy Lube,-183.17,Orlando FL,32816,5694.93,0
2025-07-24,10:08:00,Burger King,-28.27,Winter Park FL,32789,5666.66,0
2025-07-25,16:00:00,McDonald's,-21.54,Winter Park FL,32789,5645.12,0
2025-07-25,20:11:00,Starbucks,-32.0,Oviedo FL,32765,5613.12,0
2025-07-26,17:40:00,Five Below,-25.97,Orlando FL,32816,5587.15,0
2025-07-26,16:00:00,McDonald's,-29.83,Orlando FL,32816,5557.32,0
2025-07-26,16:39:00,Trader Joe's,-89.15,Winter Park FL,32789,5468.17,0
2025-07-27,20:13:00,Whole Foods,-44.13,Orlando FL,32816,5424.04,0
2025-07-27,09:59:00,Amazon,-105.45,Oviedo FL,32765,5318.59,0
2025-07-27,19:24:00,IBM,-730.71,Charleston SC,87922,4587.88,1
2025-07-28,08:00:00,Paycheck,2000.0,Oviedo FL,32765,7318.59,0
2025-07-28,10:47:00,McDonald's,-25.67,Orlando FL,32816,7292.92,0
2025-07-28,12:21:00,Shell,-35.63,Orlando FL,32816,7257.29,0
2025-07-28,18:31:00,Concert Tickets,-92.48,Orlando FL,32816,7164.81,0
2025-07-30,18:37:00,Starbucks,-14.66,Winter Park FL,32789,7150.15,0
2025-07-30,21:56:00,Subway,-34.92,Winter Park FL,32789,7115.23,0
2025-07-30,18:34:00,Walmart,-135.91,Orlando FL,32816,6979.32,0
2025-07-31,16:10:00,Kroger,-138.0,Orlando FL,32816,6841.32,0
2025-07-31,01:14:00,Magic the Gathering,-2614.8,Groton CT,32723,4226.52,1
2025-08-01,09:00:00,Rent,-960.0,Oviedo FL,32765,5881.32,0
2025-08-01,09:00:00,Insurance,-197.46,Oviedo FL,32765,5683.86,0
2025-08-01,09:00:00,Car,-300.0,Oviedo FL,32765,5383.86,0
2025-08-01,10:00:00,Five Below,-32.97,Orlando FL,32816,5350.89,0
2025-08-01,18:32:00,Walgreens,-37.42,Oviedo FL,32765,5313.47,0
2025-08-02,21:15:00,Amusement Park,-45.02,Orlando FL,32816,5268.45,0
2025-08-02,17:55:00,McDonald's,-25.77,Winter Park FL,32789,5242.68,0
2025-08-03,19:39:00,Shell,-21.64,Orlando FL,32816,5221.04,0
2025-08-03,06:41:00,Impractical Jokers,-283.6,Los Angeles CA,89684,4937.44,1
2025-08-03,08:13:00,Walgreens,-44.79,Orlando FL,32816,5176.25,0
2025-08-03,15:27:00,Pep Boys,-109.37,Orlando FL,32816,5066.88,0
2025-08-04,11:59:00,Pawn Stars,-1816.17,Mexico City MC,46329,3250.71,1
2025-08-04,11:50:00,Amazon,-52.29,Winter Park FL,32789,5014.59,0
2025-08-05,19:31:00,Trader Joe's,-53.21,Winter Park FL,32789,4961.38,0
2025-08-05,16:03:00,CVS,-16.91,Orlando FL,32816,4944.47,0
2025-08-05,09:23:00,Best Buy,-91.19,Orlando FL,32816,4853.28,0
2025-08-06,18:45:00,Midas,-122.59,Winter Park FL,32789,4730.69,0
2025-08-06,20:32:00,Subway,-28.07,Oviedo FL,32765,4702.62,0
2025-08-07,09:00:00,Spotify,-11.99,Oviedo FL,32765,4690.63,0
2025-08-07,09:00:00,Internet,-70.89,Oviedo FL,32765,4619.74,0
2025-08-07,09:00:00,ChatGPT Plus,-20.0,Oviedo FL,32765,4599.74,0
2025-08-07,20:51:00,Concert Tickets,-20.78,Winter Park FL,32789,4578.96,0
2025-08-07,08:20:00,McDonald's,-8.91,Orlando FL,32816,4570.05,0
2025-08-09,00:35:00,Fraud,-284.01,Mexico City MC,53476,4286.04,1
2025-08-09,10:01:00,Subway,-5.46,Orlando FL,32816,4564.59,0
2025-08-10,21:36:00,Five Below,-33.48,Oviedo FL,32765,4531.11,0
2025-08-10,08:12:00,Kroger,-95.71,Winter Park FL,32789,4435.4,0
2025-08-10,13:22:00,Starbucks,-10.6,Winter Park FL,32789,4424.8,0
2025-08-11,08:00:00,Paycheck,2000.0,Oviedo FL,32765,6424.8,0
2025-08-11,17:54:00,Chevron,-43.71,Winter Park FL,32789,6381.09,0
2025-08-11,11:10:00,Whole Foods,-98.73,Winter Park FL,32789,6282.36,0
2025-08-11,12:24:00,Jiffy Lube,-373.1,Orlando FL,32816,5909.26,0
2025-08-13,19:30:00,McDonald's,-15.08,Oviedo FL,32765,5894.18,0
2025-08-13,19:39:00,BP,-16.22,Orlando FL,32816,5877.96,0
2025-08-14,14:40:00,Midas,-140.19,Oviedo FL,32765,5737.77,0
2025-08-15,19:42:00,Dollar Tree,-43.33,Orlando FL,32816,5694.44,0
2025-08-16,08:52:00,Walmart,-131.66,Winter Park FL,32789,5562.78,0
2025-08-16,17:17:00,Concert Tickets,-17.25,Oviedo FL,32765,5545.53,0
2025-08-17,17:34:00,Trader Joe's,-49.3,Winter Park FL,32789,5496.23,0
2025-08-17,12:08:00,Shell,-11.05,Winter Park FL,32789,5485.18,0
2025-08-17,20:16:00,Target,-25.77,Orlando FL,32816,5459.41,0
2025-08-17,10:43:00,IBM,-2032.15,New York NY,95260,3427.26,1
2025-08-18,14:56:00,Subway,-8.64,Oviedo FL,32765,5450.77,0
2025-08-18,11:24:00,Fat Joe,-1396.37,Honolulu HI,44375,4054.4,1
2025-08-19,19:29:00,Amazon,-116.68,Orlando FL,32816,5334.09,0
2025-08-19,20:47:00,Best Buy,-49.26,Orlando FL,32816,5284.83,0
2025-08-19,20:02:00,Starbucks,-17.8,Orlando FL,32816,5267.03,0
2025-08-21,15:55:00,Kroger,-96.01,Winter Park FL,32789,5171.02,0
2025-08-22,11:30:00,Shell,-12.16,Oviedo FL,32765,5158.86,0
2025-08-22,15:24:00,Subway,-39.31,Winter Park FL,32789,5119.55,0
2025-08-23,16:10:00,Shell,-15.63,Oviedo FL,32765,5103.92,0
2025-08-24,20:55:00,Subway,-22.13,Winter Park FL,32789,5081.79,0
2025-08-25,08:00:00,Paycheck,2000.0,Oviedo FL,32765,7081.79,0
2025-08-25,09:12:00,Burger King,-10.9,Winter Park FL,32789,7070.89,0
2025-08-25,08:10:00,Chevron,-45.25,Oviedo FL,32765,7025.64,0
2025-08-26,13:27:00,Shell,-24.08,Winter Park FL,32789,7001.56,0
2025-08-26,21:53:00,CVS,-14.79,Winter Park FL,32789,6986.77,0
2025-08-26,17:20:00,Amusement Park,-93.01,Oviedo FL,32765,6893.76,0
2025-08-28,12:48:00,Burger King,-43.61,Winter Park FL,32789,6850.15,0
2025-08-28,13:32:00,Trader Joe's,-143.84,Winter Park FL,32789,6706.31,0
2025-08-28,17:55:00,Starbucks,-64.84,Oviedo FL,32765,6641.47,0
2025-08-29,16:47:00,Amusement Park,-53.7,Oviedo FL,32765,6587.77,0
2025-08-30,20:31:00,Target,-81.86,Orlando FL,32816,6505.91,0
2025-08-30,21:25:00,Burger King,-46.29,Winter Park FL,32789,6459.62,0
2025-08-30,12:27:00,Fat Joe,-436.45,Honolulu HI,24037,6023.17,1
2025-08-30,20:50:00,Chevron,-58.84,Orlando FL,32816,6400.78,0
2025-08-31,18:23:00,Walgreens,-55.44,Orlando FL,32816,6345.34,0
2025-09-01,09:00:00,Rent,-960.0,Oviedo FL,32765,5385.34,0
2025-09-01,09:00:00,Insurance,-197.46,Oviedo FL,32765,5187.88,0
2025-09-01,09:00:00,Car,-300.0,Oviedo FL,32765,4887.88,0
2025-09-02,19:38:00,Trader Joe's,-48.98,Orlando FL,32816,4838.9,0
2025-09-02,12:27:00,Subway,-29.98,Orlando FL,32816,4808.92,0
2025-09-02,13:17:00,Target,-82.03,Winter Park FL,32789,4726.89,0
2025-09-04,18:33:00,Dollar Tree,-19.93,Oviedo FL,32765,4706.96,0
2025-09-04,19:05:00,Starbucks,-31.98,Oviedo FL,32765,4674.98,0
2025-09-04,12:18:00,Concert Tickets,-30.29,Orlando FL,32816,4644.69,0
2025-09-05,10:01:00,Amazon,-116.47,Oviedo FL,32765,4528.22,0
2025-09-05,21:15:00,Target,-26.08,Oviedo FL,32765,4502.14,0
2025-09-05,16:37:00,Chevron,-20.58,Winter Park FL,32789,4481.56,0
2025-09-06,10:05:00,Movie Theater,-10.99,Orlando FL,32816,4470.57,0
2025-09-07,09:00:00,Spotify,-11.99,Oviedo FL,32765,4458.58,0
2025-09-07,09:00:00,Internet,-70.89,Oviedo FL,32765,4387.69,0
2025-09-07,09:00:00,ChatGPT Plus,-20.0,Oviedo FL,32765,4367.69,0
2025-09-08,08:00:00,Paycheck,2000.0,Oviedo FL,32765,6367.69,0
2025-09-08,21:21:00,Amazon,-85.83,Orlando FL,32816,6281.86,0
2025-09-08,20:29:00,Kroger,-132.65,Winter Park FL,32789,6149.21,0
2025-09-09,16:18:00,Starbucks,-63.62,Orlando FL,32816,6085.59,0
2025-09-09,10:18:00,Subway,-44.75,Orlando FL,32816,6040.84,0
2025-09-10,02:32:00,Monster Energy,-440.74,Tokyo JP,96446,5600.1,1
2025-09-10,12:21:00,Subway,-65.23,Orlando FL,32816,5975.61,0
2025-09-10,21:53:00,Trader Joe's,-86.78,Winter Park FL,32789,5888.83,0
2025-09-10,11:30:00,Lockheed Martin,-1922.71,Groton CT,43297,3966.12,1
2025-09-11,19:03:00,Walmart,-142.92,Winter Park FL,32789,5745.91,0
2025-09-11,13:44:00,Starbucks,-11.6,Orlando FL,32816,5734.31,0
2025-09-12,12:13:00,Movie Theater,-25.36,Orlando FL,32816,5708.95,0
2025-09-12,18:35:00,Midas,-180.67,Oviedo FL,32765,5528.28,0
2025-09-12,17:59:00,Walgreens,-14.89,Winter Park FL,32789,5513.39,0
2025-09-15,14:01:00,Fat Joe,-2080.65,London EN,18373,3432.74,1
2025-09-17,18:33:00,CVS,-5.84,Orlando FL,32816,5507.55,0
2025-09-17,18:13:00,BP,-16.55,Oviedo FL,32765,5491.0,0
2025-09-17,08:25:00,Burger King,-33.23,Oviedo FL,32765,5457.77,0
2025-09-18,10:20:00,Shell,-24.49,Orlando FL,32816,5433.28,0
2025-09-18,18:49:00,Concert Tickets,-32.42,Winter Park FL,32789,5400.86,0
2025-09-21,08:11:00,Walmart,-135.14,Oviedo FL,32765,5265.72,0
2025-09-22,08:00:00,Paycheck,2000.0,Oviedo FL,32765,7265.72,0
2025-09-22,14:06:00,Burger King,-31.93,Orlando FL,32816,7233.79,0
2025-09-23,11:48:00,Starbucks,-70.41,Winter Park FL,32789,7163.38,0
2025-09-24,20:55:00,Accelerators,-195.02,Pyongyang NK,83073,6968.36,1
2025-09-24,13:24:00,McDonald's,-63.27,Oviedo FL,32765,7100.11,0
2025-09-26,12:10:00,Subway,-20.2,Winter Park FL,32789,7079.91,0
2025-09-26,12:52:00,Concert Tickets,-22.66,Orlando FL,32816,7057.25,0
2025-09-26,21:10:00,McDonald's,-76.11,Winter Park FL,32789,6981.14,0
2025-09-28,21:37:00,Exxon,-25.93,Winter Park FL,32789,6955.21,0
2025-09-28,20:06:00,Shell,-26.87,Orlando FL,32816,6928.34,0
2025-09-28,16:13:00,CVS,-56.99,Winter Park FL,32789,6871.35,0
2025-09-29,16:23:00,Walgreens,-44.83,Orlando FL,32816,6826.52,0
2025-09-29,21:30:00,Starbucks,-59.76,Orlando FL,32816,6766.76,0
2025-09-29,17:40:00,McDonald's,-57.05,Orlando FL,32816,6709.71,0
2025-09-30,17:29:00,Subway,-20.66,Oviedo FL,32765,6689.05,0
2025-10-01,09:00:00,Rent,-960.0,Oviedo FL,32765,5729.05,0
2025-10-01,09:00:00,Insurance,-197.46,Oviedo FL,32765,5531.59,0
2025-10-01,09:00:00,Car,-300.0,Oviedo FL,32765,5231.59,0
2025-10-01,14:22:00,Concert Tickets,-40.34,Winter Park FL,32789,5191.25,0
2025-10-01,11:12:00,McDonald's,-7.17,Oviedo FL,32765,5184.08,0
2025-10-01,14:58:00,Burger King,-17.13,Orlando FL,32816,5166.95,0
2025-10-02,15:11:00,Starbucks,-31.8,Oviedo FL,32765,5135.15,0
2025-10-02,18:47:00,BP,-17.2,Oviedo FL,32765,5117.95,0
2025-10-02,09:20:00,Amusement Park,-15.78,Oviedo FL,32765,5102.17,0
2025-10-03,15:19:00,Target,-83.07,Orlando FL,32816,5019.1,0
2025-10-03,17:26:00,Movie Theater,-35.63,Winter Park FL,32789,4983.47,0
2025-10-03,20:14:00,McDonald's,-8.82,Winter Park FL,32789,4974.65,0
2025-10-04,09:57:00,Amusement Park,-47.81,Orlando FL,32816,4926.84,0
2025-10-04,08:41:00,Publix,-93.21,Oviedo FL,32765,4833.63,0
2025-10-04,19:23:00,Fat Joe,-418.81,Pittsburgh PA,56416,4414.82,1
2025-10-04,19:57:00,McDonald's,-36.24,Orlando FL,32816,4797.39,0
2025-10-05,16:58:00,Starbucks,-29.27,Oviedo FL,32765,4768.12,0
2025-10-05,18:47:00,AutoZone,-133.3,Oviedo FL,32765,4634.82,0
2025-10-05,21:58:00,CVS,-32.32,Orlando FL,32816,4602.5,0
2025-10-06,08:00:00,Paycheck,2000.0,Oviedo FL,32765,6602.5,0
2025-10-06,17:02:00,Exxon,-54.89,Winter Park FL,32789,6547.61,0
2025-10-07,09:00:00,Spotify,-11.99,Oviedo FL,32765,6535.62,0
2025-10-07,09:00:00,Internet,-70.89,Oviedo FL,32765,6464.73,0
2025-10-07,09:00:00,ChatGPT Plus,-20.0,Oviedo FL,32765,6444.73,0
2025-10-07,15:42:00,Burger King,-16.7,Winter Park FL,32789,6428.03,0
2025-10-07,20:32:00,McDonald's,-50.28,Winter Park FL,32789,6377.75,0
2025-10-07,14:22:00,Target,-144.2,Winter Park FL,32789,6233.55,0
2025-10-08,01:28:00,Fat Joe,-776.95,Honolulu HI,67155,5456.6,1
2025-10-08,10:51:00,AutoZone,-189.19,Orlando FL,32816,6044.36,0
2025-10-09,09:17:00,Jiffy Lube,-369.44,Orlando FL,32816,5674.92,0
2025-10-09,19:22:00,Target,-130.54,Orlando FL,32816,5544.38,0
2025-10-09,21:29:00,Five Below,-33.37,Oviedo FL,32765,5511.01,0
2025-10-10,17:03:00,Exxon,-10.14,Orlando FL,32816,5500.87,0
2025-10-10,20:15:00,Midas,-119.26,Winter Park FL,32789,5381.61,0
2025-10-10,13:01:00,Publix,-43.81,Oviedo FL,32765,5337.8,0
2025-10-11,08:31:00,Exxon,-13.97,Oviedo FL,32765,5323.83,0
2025-10-12,16:27:00,Subway,-13.96,Oviedo FL,32765,5309.87,0
2025-10-13,17:53:00,Dollar Tree,-11.77,Winter Park FL,32789,5298.1,0
2025-10-13,06:35:00,IBM,-2664.49,New York NY,94162,2633.61,1
2025-10-13,10:02:00,CVS,-8.24,Oviedo FL,32765,5289.86,0
2025-10-13,18:42:00,Kroger,-51.29,Oviedo FL,32765,5238.57,0
2025-10-14,18:58:00,CVS,-40.46,Orlando FL,32816,5198.11,0
2025-10-14,17:20:00,Burger King,-30.19,Winter Park FL,32789,5167.92,0
2025-10-14,13:30:00,Target,-52.5,Orlando FL,32816,5115.42,0
2025-10-16,20:36:00,Movie Theater,-25.49,Oviedo FL,32765,5089.93,0
2025-10-16,11:21:00,Publix,-87.46,Orlando FL,32816,5002.47,0
2025-10-17,21:10:00,Subway,-23.05,Winter Park FL,32789,4979.42,0
2025-10-17,01:10:00,Fraud,-1570.92,Mexico City MC,38014,3408.5,1
2025-10-17,15:15:00,Best Buy,-10.84,Winter Park FL,32789,4968.58,0
2025-10-17,20:26:00,Dollar Tree,-20.42,Orlando FL,32816,4948.16,0
2025-10-18,09:17:00,Impractical Jokers,-2798.45,Pyongyang NK,65748,2149.71,1
2025-10-18,12:49:00,Target,-37.61,Orlando FL,32816,4910.55,0
2025-10-19,17:00:00,Chevron,-29.4,Winter Park FL,32789,4881.15,0
2025-10-19,08:54:00,Netflix,-34.37,Orlando FL,32816,4846.78,0
2025-10-20,08:00:00,Paycheck,2000.0,Oviedo FL,32765,6846.78,0
2025-10-21,10:58:00,Amusement Park,-83.45,Orlando FL,32816,6763.33,0
2025-10-21,18:26:00,Amazon,-30.28,Oviedo FL,32765,6733.05,0
2025-10-23,14:15:00,Subway,-68.83,Oviedo FL,32765,6664.22,0
2025-10-23,13:45:00,Publix,-156.0,Winter Park FL,32789,6508.22,0
2025-10-23,13:17:00,Midas,-359.76,Oviedo FL,32765,6148.46,0
2025-10-24,02:24:00,Servicenow,-2404.47,Tokyo JP,66318,3743.99,1
2025-10-24,09:05:00,CVS,-95.94,Winter Park FL,32789,6052.52,0
2025-10-25,14:33:00,Netflix,-75.62,Oviedo FL,32765,5976.9,0
2025-10-25,20:02:00,Midas,-120.58,Winter Park FL,32789,5856.32,0
2025-10-25,17:00:00,Burger King,-21.46,Winter Park FL,32789,5834.86,0
2025-10-26,09:41:00,BP,-18.17,Winter Park FL,32789,5816.69,0
2025-10-26,13:49:00,Netflix,-12.39,Orlando FL,32816,5804.3,0
2025-10-26,08:09:00,Subway,-28.31,Orlando FL,32816,5775.99,0
2025-10-27,09:37:00,Shell,-14.99,Winter Park FL,32789,5761.0,0
2025-10-27,14:58:00,Exxon,-13.47,Winter Park FL,32789,5747.53,0
2025-10-28,10:36:00,Starbucks,-9.62,Orlando FL,32816,5737.91,0
2025-10-30,09:57:00,Pawn Stars,-1650.98,Charleston SC,72514,4086.93,1
2025-10-30,21:35:00,Chevron,-12.56,Oviedo FL,32765,5725.35,0
2025-10-30,16:47:00,Five Below,-49.79,Winter Park FL,32789,5675.56,0
2025-10-31,08:37:00,Amazon,-44.38,Orlando FL,32816,5631.18,0
2025-10-31,11:49:00,Movie Theater,-58.95,Oviedo FL,32765,5572.23,0
2025-11-01,09:00:00,Rent,-960.0,Oviedo FL,32765,4612.23,0
2025-11-01,09:00:00,Insurance,-197.46,Oviedo FL,32765,4414.77,0
2025-11-01,09:00:00,Car,-300.0,Oviedo FL,32765,4114.77,0
2025-11-02,09:19:00,CVS,-14.08,Winter Park FL,32789,4100.69,0
2025-11-02,14:57:00,Starbucks,-7.35,Oviedo FL,32765,4093.34,0
2025-11-02,15:35:00,Netflix,-10.58,Orlando FL,32816,4082.76,0
2025-11-03,08:00:00,Paycheck,2000.0,Oviedo FL,32765,6082.76,0
2025-11-03,20:30:00,Kroger,-194.83,Oviedo FL,32765,5887.93,0
2025-11-05,16:34:00,Chevron,-14.33,Orlando FL,32816,5873.6,0
2025-11-05,21:07:00,Impractical Jokers,-1601.09,Pittsburgh PA,19150,4272.51,1
2025-11-05,19:42:00,BP,-27.14,Oviedo FL,32765,5846.46,0
2025-11-06,19:05:00,Best Buy,-45.79,Orlando FL,32816,5800.67,0
2025-11-06,12:36:00,Best Buy,-38.82,Winter Park FL,32789,5761.85,0
2025-11-07,09:00:00,Spotify,-11.99,Oviedo FL,32765,5749.86,0
2025-11-07,09:00:00,Internet,-70.89,Oviedo FL,32765,5678.97,0
2025-11-07,09:00:00,ChatGPT Plus,-20.0,Oviedo FL,32765,5658.97,0
2025-11-07,18:46:00,McDonald's,-37.4,Oviedo FL,32765,5621.57,0
2025-11-07,13:53:00,CVS,-31.92,Oviedo FL,32765,5589.65,0
2025-11-07,21:21:00,Movie Theater,-33.96,Winter Park FL,32789,5555.69,0
2025-11-08,09:08:00,Exxon,-10.34,Winter Park FL,32789,5545.35,0
2025-11-08,10:54:00,Best Buy,-87.67,Orlando FL,32816,5457.68,0
2025-11-08,16:31:00,Publix,-67.67,Orlando FL,32816,5390.01,0
2025-11-10,12:12:00,Concert Tickets,-14.35,Winter Park FL,32789,5375.66,0
2025-11-10,13:27:00,Whole Foods,-99.42,Oviedo FL,32765,5276.24,0
2025-11-11,20:45:00,Publix,-45.97,Winter Park FL,32789,5230.27,0
2025-11-11,12:21:00,McDonald's,-35.26,Orlando FL,32816,5195.01,0
2025-11-11,09:54:00,CVS,-28.73,Orlando FL,32816,5166.28,0
2025-11-15,11:20:00,Amazon,-144.97,Oviedo FL,32765,5021.31,0
2025-11-15,12:10:00,Subway,-34.43,Winter Park FL,32789,4986.88,0
2025-11-16,11:03:00,Concert Tickets,-10.86,Orlando FL,32816,4976.02,0
2025-11-17,08:00:00,Paycheck,2000.0,Oviedo FL,32765,6976.02,0
2025-11-17,13:02:00,McDonald's,-37.89,Winter Park FL,32789,6938.13,0
2025-11-17,13:06:00,Starbucks,-48.24,Oviedo FL,32765,6889.89,0
2025-11-18,16:56:00,Amazon,-129.34,Orlando FL,32816,6760.55,0
2025-11-21,19:34:00,McDonald's,-27.54,Winter Park FL,32789,6733.01,0
2025-11-21,08:07:00,Amazon,-281.19,Orlando FL,32816,6451.82,0
2025-11-22,10:30:00,Monster Energy,-2037.19,Honolulu HI,79133,4414.63,1
2025-11-22,12:35:00,Burger King,-14.34,Orlando FL,32816,6437.48,0
2025-11-22,12:17:00,Servicenow,-391.99,Groton CT,93017,6045.49,1
2025-11-22,11:06:00,Netflix,-64.6,Oviedo FL,32765,6372.88,0
2025-11-23,10:37:00,Trader Joe's,-104.4,Orlando FL,32816,6268.48,0
2025-11-25,11:01:00,Starbucks,-10.11,Orlando FL,32816,6258.37,0
2025-11-25,19:11:00,AutoZone,-276.49,Orlando FL,32816,5981.88,0
2025-11-27,19:07:00,Midas,-87.12,Oviedo FL,32765,5894.76,0
2025-11-28,13:36:00,Chevron,-10.11,Orlando FL,32816,5884.65,0
2025-11-29,10:46:00,Movie Theater,-11.12,Orlando FL,32816,5873.53,0
2025-11-29,07:51:00,Fraud,-606.74,Groton CT,68034,5266.79,1
2025-11-29,11:32:00,CVS,-41.34,Orlando FL,32816,5832.19,0
2025-11-30,08:09:00,Publix,-55.42,Winter Park FL,32789,5776.77,0
2025-11-30,18:40:00,Paypal,-1820.6,Honolulu HI,51734,3956.17,1
2025-11-30,15:28:00,Starbucks,-27.93,Oviedo FL,32765,5748.84,0
2025-11-30,20:20:00,Movie Theater,-43.01,Orlando FL,32816,5705.83,0
2025-11-30,22:25:00,Servicenow,-1286.37,Tokyo JP,85397,4419.46,1
2025-12-01,08:00:00,Paycheck,2000.0,Oviedo FL,32765,7705.83,0
2025-12-01,09:00:00,Rent,-960.0,Oviedo FL,32765,6745.83,0
2025-12-01,09:00:00,Insurance,-197.46,Oviedo FL,32765,6548.37,0
2025-12-01,09:00:00,Car,-300.0,Oviedo FL,32765,6248.37,0
2025-12-01,11:17:00,Chevron,-56.24,Oviedo FL,32765,6192.13,0
2025-12-01,11:58:00,Burger King,-27.05,Winter Park FL,32789,6165.08,0
2025-12-02,09:30:00,McDonald's,-78.63,Oviedo FL,32765,6086.45,0
2025-12-02,13:56:00,Starbucks,-71.37,Winter Park FL,32789,6015.08,0
2025-12-03,16:14:00,Subway,-47.74,Winter Park FL,32789,5967.34,0
2025-12-03,21:40:00,Five Below,-36.3,Winter Park FL,32789,5931.04,0
2025-12-05,18:16:00,Whole Foods,-97.84,Orlando FL,32816,5833.2,0
2025-12-05,19:03:00,Burger King,-13.89,Oviedo FL,32765,5819.31,0
2025-12-05,11:36:00,Target,-125.14,Orlando FL,32816,5694.17,0
2025-12-07,09:00:00,Spotify,-11.99,Oviedo FL,32765,5682.18,0
2025-12-07,09:00:00,Internet,-70.89,Oviedo FL,32765,5611.29,0
2025-12-07,09:00:00,ChatGPT Plus,-20.0,Oviedo FL,32765,5591.29,0
2025-12-09,10:13:00,Exxon,-29.08,Oviedo FL,32765,5562.21,0
2025-12-09,17:01:00,Subway,-31.33,Winter Park FL,32789,5530.88,0
2025-12-09,15:10:00,Accelerators,-681.11,Mexico City MC,61582,4849.77,1
2025-12-09,17:53:00,Kroger,-62.27,Oviedo FL,32765,5468.61,0
2025-12-10,16:47:00,Walgreens,-40.31,Orlando FL,32816,5428.3,0
2025-12-11,13:49:00,Subway,-29.54,Winter Park FL,32789,5398.76,0
2025-12-12,14:35:00,Burger King,-7.41,Oviedo FL,32765,5391.35,0
2025-12-13,17:56:00,Impractical Jokers,-2129.03,Honolulu HI,66882,3262.32,1
2025-12-13,09:32:00,Burger King,-39.82,Winter Park FL,32789,5351.53,0
2025-12-13,14:31:00,Burger King,-35.38,Oviedo FL,32765,5316.15,0
2025-12-13,00:47:00,Magic the Gathering,-820.37,Pyongyang NK,69412,4495.78,1
2025-12-14,13:15:00,Burger King,-24.93,Orlando FL,32816,5291.22,0
2025-12-14,18:25:00,Five Below,-9.96,Orlando FL,32816,5281.26,0
2025-12-14,19:01:00,Onlyfans,-2482.9,Mexico City MC,82981,2798.36,1
2025-12-15,08:00:00,Paycheck,2000.0,Oviedo FL,32765,7281.26,0
2025-12-15,15:12:00,Walmart,-167.13,Oviedo FL,32765,7114.13,0
2025-12-15,11:56:00,Subway,-19.73,Winter Park FL,32789,7094.4,0
2025-12-15,08:47:00,Burger King,-28.92,Winter Park FL,32789,7065.48,0
2025-12-16,12:00:00,Publix,-183.9,Oviedo FL,32765,6881.58,0
2025-12-16,19:07:00,McDonald's,-28.41,Oviedo FL,32765,6853.17,0
2025-12-17,22:15:00,IBM,-2485.64,Honolulu HI,44319,4367.53,1
2025-12-17,14:59:00,Starbucks,-14.66,Winter Park FL,32789,6838.51,0
2025-12-17,11:28:00,Amusement Park,-44.6,Winter Park FL,32789,6793.91,0
2025-12-17,09:15:00,Starbucks,-53.61,Orlando FL,32816,6740.3,0
2025-12-18,11:42:00,Starbucks,-23.67,Orlando FL,32816,6716.63,0
2025-12-18,12:09:00,Amusement Park,-58.19,Oviedo FL,32765,6658.44,0
2025-12-19,18:33:00,McDonald's,-49.32,Orlando FL,32816,6609.12,0
2025-12-19,20:53:00,BP,-41.37,Oviedo FL,32765,6567.75,0
2025-12-19,16:54:00,Five Below,-36.92,Oviedo FL,32765,6530.83,0
2025-12-20,14:30:00,Chevron,-32.95,Orlando FL,32816,6497.88,0
2025-12-21,17:25:00,BP,-43.57,Winter Park FL,32789,6454.31,0
2025-12-21,21:05:00,Kroger,-173.69,Winter Park FL,32789,6280.62,0
2025-12-21,21:44:00,Midas,-169.48,Oviedo FL,32765,6111.14,0
2025-12-22,13:13:00,Netflix,-32.71,Orlando FL,32816,6078.43,0
2025-12-22,12:18:00,Accelerators,-2273.04,London EN,50277,3805.39,1
2025-12-23,19:13:00,Best Buy,-21.38,Oviedo FL,32765,6057.05,0
2025-12-25,07:51:00,Impractical Jokers,-1526.31,Charleston SC,37198,4530.74,1
2025-12-26,13:38:00,Pep Boys,-175.79,Winter Park FL,32789,5881.26,0
2025-12-26,19:30:00,Dollar Tree,-22.5,Winter Park FL,32789,5858.76,0
2025-12-26,14:06:00,Dollar Tree,-40.06,Orlando FL,32816,5818.7,0
2025-12-27,12:30:00,Concert Tickets,-55.79,Winter Park FL,32789,5762.91,0
2025-12-28,14:21:00,Walmart,-116.14,Oviedo FL,32765,5646.77,0
2025-12-29,08:00:00,Paycheck,2000.0,Oviedo FL,32765,7646.77,0
2025-12-29,17:19:00,Whole Foods,-121.81,Winter Park FL,32789,7524.96,0
2025-12-29,15:39:00,Subway,-39.9,Oviedo FL,32765,7485.06,0
2025-12-29,20:36:00,Netflix,-64.21,Oviedo FL,32765,7420.85,0
2025-12-31,12:09:00,IBM,-2930.04,Los Angeles CA,47949,4490.81,1
2026-01-01,09:00:00,Rent,-960.0,Oviedo FL,32765,6460.85,0
2026-01-01,09:00:00,Insurance,-197.46,Oviedo FL,32765,6263.39,0
2026-01-01,09:00:00,Car,-300.0,Oviedo FL,32765,5963.39,0
2026-01-03,20:05:00,Movie Theater,-23.56,Oviedo FL,32765,5939.83,0
2026-01-03,17:48:00,Accelerators,-2403.44,Charleston SC,17043,3536.39,1
2026-01-03,21:40:00,Shell,-16.31,Winter Park FL,32789,5923.52,0
2026-01-03,12:14:00,Kroger,-62.34,Winter Park FL,32789,5861.18,0
2026-01-04,23:24:00,Monster Energy,-659.11,Mexico City MC,29018,5202.07,1
2026-01-04,16:30:00,Concert Tickets,-22.04,Winter Park FL,32789,5839.14,0
2026-01-05,13:38:00,Whole Foods,-76.97,Orlando FL,32816,5762.17,0
2026-01-05,08:46:00,Subway,-33.03,Oviedo FL,32765,5729.14,0
2026-01-05,17:50:00,McDonald's,-34.69,Orlando FL,32816,5694.45,0
2026-01-06,17:47:00,Trader Joe's,-37.99,Oviedo FL,32765,5656.46,0
2026-01-07,09:00:00,Spotify,-11.99,Oviedo FL,32765,5644.47,0
2026-01-07,09:00:00,Internet,-70.89,Oviedo FL,32765,5573.58,0
2026-01-07,09:00:00,ChatGPT Plus,-20.0,Oviedo FL,32765,5553.58,0
2026-01-07,07:48:00,Impractical Jokers,-242.68,Charleston SC,36425,5310.9,1
2026-01-07,13:13:00,Target,-104.8,Orlando FL,32816,5448.78,0
2026-01-10,11:07:00,Exxon,-17.13,Orlando FL,32816,5431.65,0
2026-01-10,18:35:00,Concert Tickets,-36.26,Winter Park FL,32789,5395.39,0
2026-01-10,15:12:00,Walmart,-66.52,Oviedo FL,32765,5328.87,0
2026-01-11,18:23:00,Paypal,-1973.49,Tokyo JP,45627,3355.38,1
2026-01-11,13:00:00,BP,-11.96,Winter Park FL,32789,5316.91,0
2026-01-12,08:00:00,Paycheck,2000.0,Oviedo FL,32765,7316.91,0
2026-01-13,04:09:00,Accelerators,-196.34,London EN,73680,7120.57,1
2026-01-16,16:11:00,Accelerators,-1963.61,Pyongyang NK,71459,5353.3,1
2026-01-16,20:53:00,AutoZone,-345.27,Oviedo FL,32765,6971.64,0
2026-01-16,16:53:00,Starbucks,-77.47,Orlando FL,32816,6894.17,0
2026-01-17,11:36:00,Subway,-43.57,Winter Park FL,32789,6850.6,0
2026-01-17,19:33:00,Servicenow,-1793.19,Honolulu HI,56553,5057.41,1
2026-01-18,15:56:00,Burger King,-41.67,Winter Park FL,32789,6808.93,0
2026-01-19,08:28:00,Target,-214.09,Orlando FL,32816,6594.84,0
2026-01-19,11:21:00,Concert Tickets,-92.89,Orlando FL,32816,6501.95,0
2026-01-19,06:02:00,Accelerators,-2778.97,Groton CT,17249,3722.98,1
2026-01-20,19:35:00,Starbucks,-24.16,Winter Park FL,32789,6477.79,0
2026-01-20,01:21:00,Lockheed Martin,-2272.59,Pittsburgh PA,98338,4205.2,1
2026-01-20,09:31:00,Publix,-179.94,Winter Park FL,32789,6297.85,0
2026-01-20,21:39:00,Concert Tickets,-113.92,Oviedo FL,32765,6183.93,0
2026-01-23,10:57:00,BP,-39.09,Orlando FL,32816,6144.84,0
2026-01-24,09:57:00,Chevron,-19.83,Winter Park FL,32789,6125.01,0
2026-01-24,13:09:00,Publix,-81.86,Winter Park FL,32789,6043.15,0
2026-01-26,08:00:00,Paycheck,2000.0,Oviedo FL,32765,8043.15,0
2026-01-29,12:23:00,Amusement Park,-26.28,Oviedo FL,32765,8016.87,0
2026-01-30,14:02:00,Burger King,-57.3,Orlando FL,32816,7959.57,0
2026-01-30,11:33:00,Starbucks,-73.97,Winter Park FL,32789,7885.6,0
2026-01-30,20:24:00,Exxon,-45.38,Oviedo FL,32765,7840.22,0
2026-01-31,20:50:00,Walgreens,-43.77,Orlando FL,32816,7796.45,0
2026-02-01,09:00:00,Rent,-960.0,Oviedo FL,32765,6836.45,0
2026-02-01,09:00:00,Insurance,-197.46,Oviedo FL,32765,6638.99,0
2026-02-01,09:00:00,Car,-300.0,Oviedo FL,32765,6338.99,0
2026-02-01,22:22:00,Monster Energy,-1420.43,Honolulu HI,54170,4918.56,1
2026-02-01,08:59:00,Walmart,-83.61,Orlando FL,32816,6255.38,0
2026-02-01,18:18:00,Trader Joe's,-192.28,Oviedo FL,32765,6063.1,0
2026-02-01,16:12:00,Kroger,-83.04,Orlando FL,32816,5980.06,0
2026-02-02,10:32:00,Walmart,-144.6,Oviedo FL,32765,5835.46,0
2026-02-02,09:44:00,Starbucks,-29.1,Oviedo FL,32765,5806.36,0
2026-02-02,09:45:00,BP,-26.74,Winter Park FL,32789,5779.62,0
2026-02-03,12:37:00,Subway,-20.67,Oviedo FL,32765,5758.95,0
2026-02-03,12:00:00,Starbucks,-15.5,Oviedo FL,32765,5743.45,0
2026-02-03,15:06:00,Netflix,-56.3,Winter Park FL,32789,5687.15,0
2026-02-05,19:20:00,Burger King,-26.68,Orlando FL,32816,5660.47,0
2026-02-06,10:54:00,Fraud,-2062.75,Charleston SC,85336,3597.72,1
2026-02-06,20:09:00,Trader Joe's,-65.99,Orlando FL,32816,5594.48,0
2026-02-06,13:22:00,Target,-101.95,Oviedo FL,32765,5492.53,0
2026-02-07,09:00:00,Spotify,-11.99,Oviedo FL,32765,5480.54,0
2026-02-07,09:00:00,Internet,-70.89,Oviedo FL,32765,5409.65,0
2026-02-07,09:00:00,ChatGPT Plus,-20.0,Oviedo FL,32765,5389.65,0
2026-02-07,16:45:00,Starbucks,-31.38,Winter Park FL,32789,5358.27,0
2026-02-07,21:05:00,Pep Boys,-138.35,Orlando FL,32816,5219.92,0
2026-02-07,13:44:00,BP,-13.77,Orlando FL,32816,5206.15,0
2026-02-08,08:31:00,Concert Tickets,-32.43,Orlando FL,32816,5173.72,0
2026-02-08,18:54:00,Subway,-34.57,Orlando FL,32816,5139.15,0
2026-02-09,08:00:00,Paycheck,2000.0,Oviedo FL,32765,7139.15,0
2026-02-10,16:04:00,Walgreens,-48.85,Orlando FL,32816,7090.3,0
2026-02-10,17:29:00,CVS,-13.4,Orlando FL,32816,7076.9,0
2026-02-10,00:55:00,Impractical Jokers,-2399.58,Tokyo JP,43341,4677.32,1
2026-02-11,09:02:00,Kroger,-147.88,Orlando FL,32816,6929.02,0
2026-02-12,20:25:00,Walmart,-39.88,Oviedo FL,32765,6889.14,0
2026-02-14,08:43:00,Whole Foods,-131.49,Oviedo FL,32765,6757.65,0
2026-02-14,18:17:00,Amusement Park,-77.35,Orlando FL,32816,6680.3,0
2026-02-15,20:24:00,Burger King,-72.43,Orlando FL,32816,6607.87,0
2026-02-17,12:15:00,Publix,-94.8,Winter Park FL,32789,6513.07,0
2026-02-17,16:40:00,Subway,-48.14,Winter Park FL,32789,6464.93,0
2026-02-17,15:55:00,McDonald's,-78.24,Winter Park FL,32789,6386.69,0
2026-02-18,14:01:00,Movie Theater,-40.41,Orlando FL,32816,6346.28,0
2026-02-18,19:31:00,Kroger,-151.34,Oviedo FL,32765,6194.94,0
2026-02-20,18:15:00,Kroger,-165.74,Winter Park FL,32789,6029.2,0
2026-02-21,21:07:00,Concert Tickets,-35.57,Oviedo FL,32765,5993.63,0
2026-02-21,13:07:00,Whole Foods,-61.74,Orlando FL,32816,5931.89,0
2026-02-22,03:12:00,Fraud,-2937.77,New York NY,37512,2994.12,1
2026-02-22,08:24:00,Whole Foods,-98.28,Orlando FL,32816,5833.61,0
2026-02-22,10:46:00,Subway,-5.82,Orlando FL,32816,5827.79,0
2026-02-23,08:00:00,Paycheck,2000.0,Oviedo FL,32765,7827.79,0
2026-02-23,08:25:00,Concert Tickets,-79.51,Orlando FL,32816,7748.28,0
2026-02-23,03:54:00,Accelerators,-1621.8,Los Angeles CA,46988,6126.48,1
2026-02-23,16:30:00,Walmart,-152.87,Winter Park FL,32789,7595.41,0
2026-02-23,01:41:00,Monster Energy,-600.98,New York NY,86438,6994.43,1
2026-02-24,18:30:00,BP,-45.99,Orlando FL,32816,7549.42,0
2026-02-24,08:53:00,McDonald's,-64.82,Orlando FL,32816,7484.6,0
2026-02-24,03:21:00,Paypal,-147.01,London EN,77080,7337.59,1
2026-02-24,21:17:00,Burger King,-76.92,Winter Park FL,32789,7407.68,0
2026-02-25,21:37:00,Starbucks,-32.95,Winter Park FL,32789,7374.73,0
2026-02-26,08:17:00,Chevron,-34.8,Orlando FL,32816,7339.93,0
2026-02-26,11:53:00,Trader Joe's,-77.39,Winter Park FL,32789,7262.54,0
2026-02-27,15:03:00,Pawn Stars,-609.11,Los Angeles CA,48099,6653.43,1
2026-02-27,21:28:00,Best Buy,-243.42,Oviedo FL,32765,7019.12,0
2026-02-28,08:37:00,Burger King,-36.08,Oviedo FL,32765,6983.04,0
2026-03-01,09:00:00,Rent,-960.0,Oviedo FL,32765,6023.04,0
2026-03-01,09:00:00,Insurance,-197.46,Oviedo FL,32765,5825.58,0
2026-03-01,09:00:00,Car,-300.0,Oviedo FL,32765,5525.58,0
2026-03-01,20:16:00,Pep Boys,-70.46,Orlando FL,32816,5455.12,0
2026-03-01,21:55:00,Amazon,-112.2,Orlando FL,32816,5342.92,0
2026-03-02,10:41:00,Concert Tickets,-52.2,Winter Park FL,32789,5290.72,0
2026-03-02,19:20:00,Trader Joe's,-64.54,Oviedo FL,32765,5226.18,0
2026-03-02,12:40:00,Chevron,-15.49,Oviedo FL,32765,5210.69,0
2026-03-05,12:22:00,Movie Theater,-35.74,Winter Park FL,32789,5174.95,0
2026-03-06,17:46:00,Netflix,-44.81,Oviedo FL,32765,5130.14,0
2026-03-06,13:53:00,Target,-94.49,Winter Park FL,32789,5035.65,0
2026-03-06,17:32:00,Best Buy,-93.88,Winter Park FL,32789,4941.77,0
2026-03-07,09:00:00,Spotify,-11.99,Oviedo FL,32765,4929.78,0
2026-03-07,09:00:00,Internet,-70.89,Oviedo FL,32765,4858.89,0
2026-03-07,09:00:00,ChatGPT Plus,-20.0,Oviedo FL,32765,4838.89,0
2026-03-07,20:51:00,Movie Theater,-40.28,Oviedo FL,32765,4798.61,0
2026-03-07,21:07:00,Whole Foods,-37.01,Winter Park FL,32789,4761.6,0
2026-03-07,10:26:00,McDonald's,-39.38,Orlando FL,32816,4722.22,0
2026-03-09,08:00:00,Paycheck,2000.0,Oviedo FL,32765,6722.22,0
2026-03-09,16:04:00,Fraud,-1672.61,Anchorage AL,32272,5049.61,1
2026-03-09,13:03:00,Starbucks,-73.69,Oviedo FL,32765,6648.53,0
2026-03-10,23:00:00,Onlyfans,-967.91,New York NY,49578,5680.62,1
2026-03-12,10:23:00,Lockheed Martin,-2290.76,Charleston SC,48122,4357.77,1
2026-03-12,14:07:00,Subway,-66.73,Oviedo FL,32765,6581.8,0
2026-03-12,21:19:00,Whole Foods,-83.47,Winter Park FL,32789,6498.33,0
2026-03-12,21:29:00,Jiffy Lube,-240.59,Oviedo FL,32765,6257.74,0
2026-03-13,16:59:00,Fat Joe,-1065.05,Anchorage AL,43746,5192.69,1
2026-03-13,08:06:00,Jiffy Lube,-237.48,Oviedo FL,32765,6020.26,0
2026-03-14,10:07:00,Movie Theater,-72.61,Winter Park FL,32789,5947.65,0
2026-03-14,15:58:00,Starbucks,-13.05,Orlando FL,32816,5934.6,0
2026-03-15,09:53:00,Movie Theater,-29.66,Oviedo FL,32765,5904.94,0
2026-03-15,05:06:00,IBM,-2702.39,Anchorage AL,72747,3202.55,1
2026-03-18,20:14:00,Pawn Stars,-1414.77,Mexico City MC,55145,4490.17,1
2026-03-18,11:22:00,Amazon,-146.48,Oviedo FL,32765,5758.46,0
2026-03-18,18:33:00,Pep Boys,-99.79,Orlando FL,32816,5658.67,0
2026-03-19,21:08:00,McDonald's,-35.39,Winter Park FL,32789,5623.28,0
2026-03-19,14:55:00,Target,-10.07,Oviedo FL,32765,5613.21,0
2026-03-20,14:36:00,Dollar Tree,-42.01,Winter Park FL,32789,5571.2,0
2026-03-20,14:00:00,Amazon,-127.16,Winter Park FL,32789,5444.04,0
2026-03-21,09:14:00,Best Buy,-34.26,Oviedo FL,32765,5409.78,0
2026-03-21,09:21:00,Trader Joe's,-65.38,Oviedo FL,32765,5344.4,0
2026-03-21,12:54:00,Walgreens,-6.3,Winter Park FL,32789,5338.1,0
2026-03-23,08:00:00,Paycheck,2000.0,Oviedo FL,32765,7338.1,0
2026-03-23,14:07:00,Target,-121.75,Oviedo FL,32765,7216.35,0
2026-03-24,19:52:00,Pep Boys,-124.92,Orlando FL,32816,7091.43,0
2026-03-24,20:52:00,Pep Boys,-251.51,Winter Park FL,32789,6839.92,0
2026-03-24,08:21:00,Target,-276.73,Winter Park FL,32789,6563.19,0
2026-03-25,16:19:00,Movie Theater,-82.09,Oviedo FL,32765,6481.1,0
2026-03-25,21:04:00,CVS,-23.08,Oviedo FL,32765,6458.02,0
2026-03-28,20:38:00,Trader Joe's,-105.95,Winter Park FL,32789,6352.07,0
2026-03-29,05:18:00,Pawn Stars,-1501.76,Groton CT,87498,4850.31,1
2026-03-29,19:57:00,Best Buy,-88.07,Orlando FL,32816,6264.0,0
2026-03-29,21:28:00,Subway,-64.03,Orlando FL,32816,6199.97,0
2026-03-29,18:09:00,Netflix,-108.18,Winter Park FL,32789,6091.79,0
2026-03-30,19:15:00,Subway,-56.16,Orlando FL,32816,6035.63,0
2026-04-01,09:00:00,Rent,-960.0,Oviedo FL,32765,5075.63,0
2026-04-01,09:00:00,Insurance,-197.46,Oviedo FL,32765,4878.17,0
2026-04-01,09:00:00,Car,-300.0,Oviedo FL,32765,4578.17,0
2026-04-01,18:22:00,Concert Tickets,-28.68,Oviedo FL,32765,4549.49,0
2026-04-02,13:58:00,Subway,-13.39,Oviedo FL,32765,4536.1,0
2026-04-02,16:33:00,IBM,-1564.33,Mexico City MC,76497,2971.77,1
2026-04-02,14:48:00,Burger King,-37.1,Winter Park FL,32789,4499.0,0
2026-04-02,10:13:00,Amazon,-122.77,Oviedo FL,32765,4376.23,0
2026-04-05,08:55:00,Subway,-36.42,Orlando FL,32816,4339.81,0
2026-04-05,15:37:00,Best Buy,-13.04,Oviedo FL,32765,4326.77,0
2026-04-05,15:25:00,Burger King,-8.77,Winter Park FL,32789,4318.0,0
2026-04-06,08:00:00,Paycheck,2000.0,Oviedo FL,32765,6318.0,0
2026-04-06,02:11:00,IBM,-1062.43,Honolulu HI,35854,5255.57,1
2026-04-06,14:31:00,Jiffy Lube,-139.59,Winter Park FL,32789,6178.41,0
2026-04-07,09:00:00,Spotify,-11.99,Oviedo FL,32765,6166.42,0
2026-04-07,09:00:00,Internet,-70.89,Oviedo FL,32765,6095.53,0
2026-04-07,09:00:00,ChatGPT Plus,-20.0,Oviedo FL,32765,6075.53,0
2026-04-07,15:02:00,Starbucks,-21.68,Orlando FL,32816,6053.85,0
2026-04-08,15:37:00,Walmart,-162.28,Oviedo FL,32765,5891.57,0
2026-04-08,21:12:00,Starbucks,-17.72,Orlando FL,32816,5873.85,0
2026-04-09,13:36:00,Best Buy,-66.12,Orlando FL,32816,5807.73,0
2026-04-11,15:47:00,Walgreens,-13.89,Oviedo FL,32765,5793.84,0
2026-04-11,13:16:00,Pep Boys,-122.89,Orlando FL,32816,5670.95,0
2026-04-11,19:19:00,Dollar Tree,-25.15,Oviedo FL,32765,5645.8,0
2026-04-12,15:19:00,Amusement Park,-12.94,Orlando FL,32816,5632.86,0
2026-04-12,17:43:00,Accelerators,-509.87,Pyongyang NK,91506,5122.99,1
2026-04-13,10:38:00,Publix,-48.88,Orlando FL,32816,5583.98,0
2026-04-13,17:22:00,Starbucks,-29.59,Oviedo FL,32765,5554.39,0
2026-04-13,09:50:00,Movie Theater,-56.7,Oviedo FL,32765,5497.69,0
2026-04-14,20:39:00,Movie Theater,-57.64,Winter Park FL,32789,5440.05,0
2026-04-14,15:41:00,McDonald's,-5.42,Oviedo FL,32765,5434.63,0
2026-04-14,23:56:00,Monster Energy,-402.04,Anchorage AL,73895,5032.59,1
2026-04-15,18:52:00,Subway,-21.11,Orlando FL,32816,5413.52,0
2026-04-16,10:54:00,Trader Joe's,-68.72,Winter Park FL,32789,5344.8,0
2026-04-16,08:47:00,Amusement Park,-52.1,Oviedo FL,32765,5292.7,0
2026-04-17,15:52:00,Walmart,-11.69,Winter Park FL,32789,5281.01,0
2026-04-18,18:41:00,Publix,-66.66,Winter Park FL,32789,5214.35,0
2026-04-18,23:58:00,Monster Energy,-1585.68,Groton CT,68583,3628.67,1
2026-04-19,15:27:00,Netflix,-48.36,Winter Park FL,32789,5165.99,0
2026-04-19,15:17:00,Whole Foods,-79.96,Oviedo FL,32765,5086.03,0
2026-04-19,08:45:00,Shell,-19.55,Oviedo FL,32765,5066.48,0
2026-04-20,08:00:00,Paycheck,2000.0,Oviedo FL,32765,7066.48,0
2026-04-21,18:59:00,Amazon,-209.17,Orlando FL,32816,6857.31,0
2026-04-21,08:24:00,BP,-21.86,Oviedo FL,32765,6835.45,0
2026-04-22,22:48:00,IBM,-583.45,New York NY,19307,6252.0,1
2026-04-22,18:04:00,Subway,-53.57,Oviedo FL,32765,6781.88,0
2026-04-23,08:20:00,Monster Energy,-2356.03,London EN,79658,4425.85,1
2026-04-23,19:54:00,Five Below,-96.61,Oviedo FL,32765,6685.27,0
2026-04-23,20:40:00,Exxon,-53.06,Oviedo FL,32765,6632.21,0
2026-04-23,10:52:00,IBM,-1015.89,Pyongyang NK,70114,5616.32,1
2026-04-23,08:10:00,Chevron,-29.06,Orlando FL,32816,6603.15,0
2026-04-24,12:53:00,Chevron,-44.68,Oviedo FL,32765,6558.47,0
2026-04-25,12:16:00,McDonald's,-15.07,Orlando FL,32816,6543.4,0
2026-04-25,10:02:00,Best Buy,-147.54,Orlando FL,32816,6395.86,0
2026-04-26,12:50:00,Five Below,-73.55,Oviedo FL,32765,6322.31,0
2026-04-26,17:19:00,Shell,-31.2,Winter Park FL,32789,6291.11,0
2026-04-28,11:26:00,Concert Tickets,-72.89,Oviedo FL,32765,6218.22,0
2026-04-29,14:34:00,Target,-58.56,Oviedo FL,32765,6159.66,0
2026-04-29,08:52:00,Walgreens,-33.93,Orlando FL,32816,6125.73,0
2026-04-29,20:20:00,BP,-48.39,Winter Park FL,32789,6077.34,0
2026-04-30,20:45:00,Burger King,-56.56,Oviedo FL,32765,6020.78,0
2026-04-30,18:06:00,Chevron,-53.04,Winter Park FL,32789,5967.74,0
2026-05-01,09:00:00,Rent,-960.0,Oviedo FL,32765,5007.74,0
2026-05-01,09:00:00,Insurance,-197.46,Oviedo FL,32765,4810.28,0
2026-05-01,09:00:00,Car,-300.0,Oviedo FL,32765,4510.28,0
2026-05-02,08:21:00,Amazon,-138.96,Winter Park FL,32789,4371.32,0
2026-05-02,18:42:00,Subway,-25.41,Oviedo FL,32765,4345.91,0
2026-05-02,10:54:00,Amazon,-122.47,Oviedo FL,32765,4223.44,0
2026-05-03,18:20:00,CVS,-41.71,Orlando FL,32816,4181.73,0
2026-05-03,16:06:00,Netflix,-29.33,Winter Park FL,32789,4152.4,0
2026-05-04,08:00:00,Paycheck,2000.0,Oviedo FL,32765,6152.4,0
2026-05-04,10:52:00,Subway,-11.59,Orlando FL,32816,6140.81,0
2026-05-04,10:09:00,Starbucks,-62.95,Winter Park FL,32789,6077.86,0
2026-05-04,07:01:00,Paypal,-2775.76,Honolulu HI,29649,3302.1,1
2026-05-06,08:27:00,IBM,-1561.59,Mexico City MC,47243,4516.27,1
2026-05-06,17:18:00,McDonald's,-46.96,Oviedo FL,32765,6030.9,0
2026-05-06,15:40:00,Jiffy Lube,-324.98,Orlando FL,32816,5705.92,0
2026-05-07,09:00:00,Spotify,-11.99,Oviedo FL,32765,5693.93,0
2026-05-07,09:00:00,Internet,-70.89,Oviedo FL,32765,5623.04,0
2026-05-07,09:00:00,ChatGPT Plus,-20.0,Oviedo FL,32765,5603.04,0
2026-05-07,07:21:00,Fraud,-2245.84,Los Angeles CA,21347,3357.2,1
2026-05-08,11:22:00,McDonald's,-10.07,Orlando FL,32816,5592.97,0
2026-05-08,10:47:00,Trader Joe's,-56.78,Winter Park FL,32789,5536.19,0
2026-05-09,21:52:00,CVS,-38.19,Winter Park FL,32789,5498.0,0
2026-05-09,08:04:00,Target,-80.02,Winter Park FL,32789,5417.98,0
2026-05-09,10:42:00,Monster Energy,-1803.49,Anchorage AL,80079,3614.49,1
2026-05-10,18:35:00,Trader Joe's,-43.53,Orlando FL,32816,5374.45,0
2026-05-11,09:08:00,Shell,-29.59,Oviedo FL,32765,5344.86,0
2026-05-12,13:37:00,Exxon,-28.58,Orlando FL,32816,5316.28,0
2026-05-15,17:55:00,Chevron,-22.66,Oviedo FL,32765,5293.62,0
2026-05-15,16:36:00,Kroger,-91.17,Orlando FL,32816,5202.45,0
2026-05-17,19:52:00,Amazon,-133.64,Oviedo FL,32765,5068.81,0
2026-05-17,08:54:00,Best Buy,-105.99,Orlando FL,32816,4962.82,0
2026-05-17,18:50:00,Fraud,-237.3,Charleston SC,23135,4725.52,1
2026-05-17,20:41:00,Walgreens,-47.97,Oviedo FL,32765,4914.85,0
2026-05-18,08:00:00,Paycheck,2000.0,Oviedo FL,32765,6914.85,0
2026-05-18,11:45:00,Jiffy Lube,-206.95,Oviedo FL,32765,6707.9,0
2026-05-18,11:20:00,Amusement Park,-41.35,Winter Park FL,32789,6666.55,0
2026-05-18,12:33:00,Best Buy,-43.18,Orlando FL,32816,6623.37,0
2026-05-19,17:58:00,Burger King,-62.87,Orlando FL,32816,6560.5,0
2026-05-21,10:46:00,Amusement Park,-48.31,Oviedo FL,32765,6512.19,0
2026-05-21,11:48:00,Walmart,-120.89,Winter Park FL,32789,6391.3,0
2026-05-22,08:41:00,Burger King,-17.55,Oviedo FL,32765,6373.75,0
2026-05-22,00:31:00,Monster Energy,-1612.87,Charleston SC,99573,4760.88,1
2026-05-22,17:56:00,Publix,-160.37,Winter Park FL,32789,6213.38,0
2026-05-22,19:17:00,Concert Tickets,-73.34,Oviedo FL,32765,6140.04,0
2026-05-23,21:46:00,Best Buy,-188.95,Winter Park FL,32789,5951.09,0
2026-05-23,08:39:00,Walmart,-90.99,Orlando FL,32816,5860.1,0
2026-05-23,12:33:00,Burger King,-20.88,Orlando FL,32816,5839.22,0
2026-05-24,09:08:00,Kroger,-98.9,Winter Park FL,32789,5740.32,0
2026-05-24,18:41:00,Burger King,-6.61,Winter Park FL,32789,5733.71,0
2026-05-25,12:25:00,Whole Foods,-92.37,Oviedo FL,32765,5641.34,0
2026-05-26,10:47:00,Starbucks,-16.37,Orlando FL,32816,5624.97,0
2026-05-27,16:18:00,Concert Tickets,-47.17,Oviedo FL,32765,5577.8,0
2026-05-27,11:05:00,Pawn Stars,-1056.37,Pittsburgh PA,47348,4521.43,1
2026-05-27,21:29:00,Publix,-95.23,Oviedo FL,32765,5482.57,0
2026-05-27,12:44:00,Shell,-15.47,Winter Park FL,32789,5467.1,0
2026-05-28,18:22:00,McDonald's,-10.65,Winter Park FL,32789,5456.45,0
2026-05-28,01:59:00,Monster Energy,-643.0,Groton CT,65375,4813.45,1
2026-05-28,19:12:00,Amusement Park,-23.76,Oviedo FL,32765,5432.69,0
2026-05-29,13:08:00,Burger King,-30.64,Oviedo FL,32765,5402.05,0
2026-05-29,08:36:00,Burger King,-13.39,Winter Park FL,32789,5388.66,0
2026-05-30,08:31:00,Shell,-28.33,Winter Park FL,32789,5360.33,0
2026-05-30,08:32:00,Movie Theater,-53.16,Oviedo FL,32765,5307.17,0
2026-05-30,08:32:00,Starbucks,-32.56,Winter Park FL,32789,5274.61,0
2026-06-01,08:00:00,Paycheck,2000.0,Oviedo FL,32765,7274.61,0
2026-06-01,09:00:00,Rent,-960.0,Oviedo FL,32765,6314.61,0
2026-06-01,09:00:00,Insurance,-197.46,Oviedo FL,32765,6117.15,0
2026-06-01,09:00:00,Car,-300.0,Oviedo FL,32765,5817.15,0
2026-06-02,15:52:00,Walgreens,-12.7,Winter Park FL,32789,5804.45,0
2026-06-02,20:37:00,Burger King,-38.04,Orlando FL,32816,5766.41,0
2026-06-03,13:39:00,McDonald's,-8.3,Winter Park FL,32789,5758.11,0
2026-06-03,08:18:00,Walgreens,-7.46,Winter Park FL,32789,5750.65,0
2026-06-04,16:39:00,AutoZone,-158.67,Oviedo FL,32765,5591.98,0
2026-06-04,04:29:00,Magic the Gathering,-941.9,London EN,84375,4650.08,1
2026-06-05,21:57:00,Starbucks,-17.99,Winter Park FL,32789,5573.99,0
2026-06-05,08:43:00,Amusement Park,-33.73,Oviedo FL,32765,5540.26,0
2026-06-05,20:06:00,Concert Tickets,-16.25,Oviedo FL,32765,5524.01,0
2026-06-06,21:56:00,Fraud,-1068.89,Groton CT,29626,4455.12,1
2026-06-06,16:23:00,Subway,-22.15,Orlando FL,32816,5501.86,0
2026-06-06,17:34:00,Pep Boys,-60.59,Orlando FL,32816,5441.27,0
2026-06-07,09:00:00,Spotify,-11.99,Oviedo FL,32765,5429.28,0
2026-06-07,09:00:00,Internet,-70.89,Oviedo FL,32765,5358.39,0
2026-06-07,09:00:00,ChatGPT Plus,-20.0,Oviedo FL,32765,5338.39,0
2026-06-07,09:30:00,Netflix,-34.59,Oviedo FL,32765,5303.8,0
2026-06-07,07:35:00,IBM,-2793.71,Los Angeles CA,15806,2510.09,1
2026-06-07,18:01:00,Burger King,-37.04,Orlando FL,32816,5266.76,0
2026-06-07,17:25:00,Publix,-72.65,Oviedo FL,32765,5194.11,0
2026-06-07,08:49:00,Fat Joe,-2789.17,London EN,98209,2404.94,1
2026-06-09,11:29:00,Accelerators,-1891.32,Anchorage AL,76268,3302.79,1
2026-06-09,10:46:00,McDonald's,-33.42,Orlando FL,32816,5160.69,0
2026-06-10,20:15:00,Walmart,-72.43,Winter Park FL,32789,5088.26,0
2026-06-13,11:15:00,Five Below,-21.58,Winter Park FL,32789,5066.68,0
2026-06-13,21:43:00,Starbucks,-9.86,Oviedo FL,32765,5056.82,0
2026-06-13,15:58:00,Walgreens,-34.87,Orlando FL,32816,5021.95,0
2026-06-14,10:21:00,Exxon,-20.19,Winter Park FL,32789,5001.76,0
2026-06-14,21:01:00,Subway,-36.9,Oviedo FL,32765,4964.86,0
2026-06-14,09:25:00,Concert Tickets,-23.73,Winter Park FL,32789,4941.13,0
2026-06-15,08:00:00,Paycheck,2000.0,Oviedo FL,32765,6941.13,0
2026-06-15,08:00:00,Amazon,-263.8,Orlando FL,32816,6677.33,0
2026-06-15,08:13:00,Trader Joe's,-133.2,Winter Park FL,32789,6544.13,0
2026-06-18,15:15:00,AutoZone,-391.83,Winter Park FL,32789,6152.3,0
2026-06-18,11:09:00,Chevron,-50.24,Winter Park FL,32789,6102.06,0
2026-06-18,19:40:00,Starbucks,-59.17,Oviedo FL,32765,6042.89,0
2026-06-19,21:13:00,Concert Tickets,-69.36,Orlando FL,32816,5973.53,0
2026-06-22,19:56:00,Exxon,-28.89,Winter Park FL,32789,5944.64,0
2026-06-22,19:04:00,Netflix,-19.12,Winter Park FL,32789,5925.52,0
2026-06-23,11:08:00,Starbucks,-37.62,Winter Park FL,32789,5887.9,0
2026-06-23,13:21:00,Shell,-20.07,Oviedo FL,32765,5867.83,0
2026-06-24,19:11:00,Exxon,-29.68,Winter Park FL,32789,5838.15,0
2026-06-24,12:11:00,Starbucks,-28.04,Orlando FL,32816,5810.11,0
2026-06-25,19:02:00,Starbucks,-32.02,Oviedo FL,32765,5778.09,0
2026-06-25,02:38:00,Pawn Stars,-1938.46,Los Angeles CA,16404,3839.63,1
2026-06-25,17:10:00,Five Below,-37.68,Winter Park FL,32789,5740.41,0
2026-06-25,20:59:00,Accelerators,-1842.26,Charleston SC,69490,3898.15,1
2026-06-27,05:56:00,Impractical Jokers,-1560.05,Groton CT,62952,4180.36,1
2026-06-27,14:01:00,Burger King,-6.78,Oviedo FL,32765,5733.63,0
2026-06-27,11:14:00,Whole Foods,-33.9,Orlando FL,32816,5699.73,0
2026-06-28,16:35:00,Shell,-11.86,Orlando FL,32816,5687.87,0
2026-06-28,16:07:00,Subway,-34.0,Orlando FL,32816,5653.87,0
2026-06-29,08:00:00,Paycheck,2000.0,Oviedo FL,32765,7653.87,0
2026-06-29,21:13:00,Target,-190.29,Oviedo FL,32765,7463.58,0
2026-06-29,13:57:00,Walgreens,-69.38,Orlando FL,32816,7394.2,0
2026-06-29,09:41:00,Five Below,-75.17,Orlando FL,32816,7319.03,0
2026-07-01,09:00:00,Rent,-960.0,Oviedo FL,32765,6359.03,0
2026-07-01,09:00:00,Insurance,-197.46,Oviedo FL,32765,6161.57,0
2026-07-01,09:00:00,Car,-300.0,Oviedo FL,32765,5861.57,0
2026-07-03,14:02:00,Walmart,-105.04,Orlando FL,32816,5756.53,0
2026-07-03,17:01:00,Five Below,-6.41,Orlando FL,32816,5750.12,0
2026-07-04,19:33:00,Amazon,-143.98,Orlando FL,32816,5606.14,0
2026-07-04,21:09:00,Kroger,-30.25,Orlando FL,32816,5575.89,0
2026-07-06,11:30:00,Publix,-32.99,Winter Park FL,32789,5542.9,0
2026-07-06,12:20:00,BP,-15.15,Orlando FL,32816,5527.75,0
2026-07-06,15:30:00,Servicenow,-1976.56,Mexico City MC,40914,3551.19,1
2026-07-07,09:00:00,Spotify,-11.99,Oviedo FL,32765,5515.76,0
2026-07-07,09:00:00,Internet,-70.89,Oviedo FL,32765,5444.87,0
2026-07-07,09:00:00,ChatGPT Plus,-20.0,Oviedo FL,32765,5424.87,0
2026-07-07,21:53:00,Starbucks,-35.2,Winter Park FL,32789,5389.67,0
2026-07-07,19:16:00,Burger King,-35.03,Oviedo FL,32765,5354.64,0
2026-07-07,17:20:00,Whole Foods,-98.67,Orlando FL,32816,5255.97,0
2026-07-08,12:24:00,Movie Theater,-38.67,Orlando FL,32816,5217.3,0
2026-07-08,19:14:00,Trader Joe's,-60.51,Winter Park FL,32789,5156.79,0
2026-07-09,12:11:00,Burger King,-12.11,Orlando FL,32816,5144.68,0
2026-07-09,18:06:00,Target,-16.13,Orlando FL,32816,5128.55,0
2026-07-11,09:03:00,McDonald's,-11.28,Oviedo FL,32765,5117.27,0
2026-07-12,12:34:00,Fraud,-1409.58,Tokyo JP,27205,3707.69,1
2026-07-12,09:49:00,Subway,-31.8,Oviedo FL,32765,5085.47,0
2026-07-12,13:19:00,Five Below,-8.67,Orlando FL,32816,5076.8,0
2026-07-12,18:03:00,AutoZone,-52.8,Winter Park FL,32789,5024.0,0
2026-07-13,08:00:00,Paycheck,2000.0,Oviedo FL,32765,7024.0,0
2026-07-13,09:44:00,Trader Joe's,-148.05,Winter Park FL,32789,6875.95,0
2026-07-13,19:56:00,McDonald's,-16.54,Winter Park FL,32789,6859.41,0
2026-07-13,21:35:00,Best Buy,-266.36,Winter Park FL,32789,6593.05,0
2026-07-14,12:13:00,Starbucks,-28.74,Winter Park FL,32789,6564.31,0
2026-07-15,20:43:00,Concert Tickets,-95.39,Oviedo FL,32765,6468.92,0
2026-07-15,19:18:00,Amazon,-191.51,Orlando FL,32816,6277.41,0
2026-07-16,21:29:00,Amusement Park,-41.11,Orlando FL,32816,6236.3,0
2026-07-16,21:09:00,Walgreens,-62.05,Orlando FL,32816,6174.25,0
2026-07-18,10:06:00,Amusement Park,-102.12,Orlando FL,32816,6072.13,0
2026-07-19,17:53:00,Trader Joe's,-167.0,Orlando FL,32816,5905.13,0
2026-07-19,21:55:00,Walgreens,-33.02,Orlando FL,32816,5872.11,0
2026-07-19,10:36:00,Lockheed Martin,-1734.92,Mexico City MC,95018,4137.19,1
2026-07-20,17:57:00,Amazon,-77.0,Orlando FL,32816,5795.11,0
2026-07-20,14:30:00,Movie Theater,-21.78,Winter Park FL,32789,5773.33,0
2026-07-20,17:53:00,Amazon,-135.57,Winter Park FL,32789,5637.76,0
2026-07-22,14:39:00,Burger King,-29.17,Oviedo FL,32765,5608.59,0
2026-07-22,12:34:00,Subway,-22.58,Winter Park FL,32789,5586.01,0
2026-07-22,14:04:00,Chevron,-17.39,Orlando FL,32816,5568.62,0
2026-07-23,16:09:00,Kroger,-95.98,Winter Park FL,32789,5472.64,0
2026-07-23,14:35:00,Lockheed Martin,-1848.69,Charleston SC,84369,3623.95,1
2026-07-23,08:33:00,Burger King,-15.69,Orlando FL,32816,5456.95,0
2026-07-24,10:34:00,Starbucks,-7.3,Oviedo FL,32765,5449.65,0
2026-07-25,21:44:00,Shell,-21.95,Orlando FL,32816,5427.7,0
2026-07-26,16:31:00,Netflix,-11.48,Oviedo FL,32765,5416.22,0
2026-07-26,15:40:00,Fraud,-2298.84,Mexico City MC,86877,3117.38,1
2026-07-26,16:27:00,Starbucks,-35.82,Orlando FL,32816,5380.4,0
2026-07-27,08:00:00,Paycheck,2000.0,Oviedo FL,32765,7380.4,0
2026-07-29,13:33:00,Starbucks,-41.06,Oviedo FL,32765,7339.34,0
2026-07-29,16:23:00,McDonald's,-69.72,Oviedo FL,32765,7269.62,0
2026-08-01,09:00:00,Rent,-960.0,Oviedo FL,32765,6309.62,0
2026-08-01,09:00:00,Insurance,-197.46,Oviedo FL,32765,6112.16,0
2026-08-01,09:00:00,Car,-300.0,Oviedo FL,32765,5812.16,0
2026-08-03,19:15:00,Jiffy Lube,-72.37,Orlando FL,32816,5739.79,0
2026-08-05,01:35:00,Impractical Jokers,-419.71,Pittsburgh PA,90893,5320.08,1
2026-08-05,12:37:00,McDonald's,-13.9,Oviedo FL,32765,5725.89,0
2026-08-05,08:19:00,Accelerators,-1672.31,Anchorage AL,45703,4053.58,1
2026-08-05,12:04:00,Publix,-39.28,Orlando FL,32816,5686.61,0
2026-08-07,09:00:00,Spotify,-11.99,Oviedo FL,32765,5674.62,0
2026-08-07,09:00:00,Internet,-70.89,Oviedo FL,32765,5603.73,0
2026-08-07,09:00:00,ChatGPT Plus,-20.0,Oviedo FL,32765,5583.73,0
2026-08-08,19:13:00,Magic the Gathering,-2974.26,Charleston SC,19395,2609.47,1
2026-08-09,06:23:00,Fraud,-814.85,Groton CT,33608,4768.88,1
2026-08-10,08:00:00,Paycheck,2000.0,Oviedo FL,32765,7583.73,0
2026-08-10,12:14:00,Accelerators,-2490.99,Mexico City MC,68188,5092.74,1
2026-08-10,21:16:00,Walgreens,-15.97,Winter Park FL,32789,7567.76,0
2026-08-10,10:36:00,Best Buy,-52.45,Orlando FL,32816,7515.31,0
2026-08-10,20:30:00,Lockheed Martin,-418.52,Mexico City MC,84276,7096.79,1
2026-08-10,20:58:00,Starbucks,-71.27,Orlando FL,32816,7444.04,0
2026-08-11,17:58:00,Servicenow,-1420.05,Los Angeles CA,22451,6023.99,1
2026-08-11,18:40:00,Starbucks,-20.18,Oviedo FL,32765,7423.86,0
2026-08-12,13:35:00,Kroger,-161.21,Oviedo FL,32765,7262.65,0
2026-08-12,15:49:00,Whole Foods,-61.85,Oviedo FL,32765,7200.8,0
2026-08-12,08:15:00,Kroger,-185.8,Orlando FL,32816,7015.0,0
2026-08-13,16:39:00,Walmart,-108.55,Winter Park FL,32789,6906.45,0
2026-08-14,10:09:00,Target,-187.22,Oviedo FL,32765,6719.23,0
2026-08-15,11:44:00,Jiffy Lube,-305.21,Oviedo FL,32765,6414.02,0
2026-08-16,10:15:00,CVS,-95.57,Winter Park FL,32789,6318.45,0
2026-08-17,12:20:00,Whole Foods,-84.37,Orlando FL,32816,6234.08,0
2026-08-17,21:44:00,Publix,-182.14,Orlando FL,32816,6051.94,0
2026-08-17,11:39:00,Netflix,-100.58,Winter Park FL,32789,5951.36,0
2026-08-18,18:09:00,Walgreens,-41.13,Winter Park FL,32789,5910.23,0
2026-08-18,12:27:00,BP,-28.43,Orlando FL,32816,5881.8,0
2026-08-19,20:48:00,BP,-16.86,Orlando FL,32816,5864.94,0
2026-08-19,14:39:00,Trader Joe's,-66.91,Winter Park FL,32789,5798.03,0
2026-08-19,13:21:00,Starbucks,-7.74,Orlando FL,32816,5790.29,0
2026-08-20,12:23:00,Amazon,-94.78,Winter Park FL,32789,5695.51,0
2026-08-20,06:05:00,Fat Joe,-1580.05,Los Angeles CA,38790,4115.46,1
2026-08-21,14:41:00,McDonald's,-14.38,Orlando FL,32816,5681.13,0
2026-08-22,08:54:00,Burger King,-29.17,Oviedo FL,32765,5651.96,0
2026-08-22,19:28:00,Netflix,-33.15,Winter Park FL,32789,5618.81,0
2026-08-22,21:19:00,Kroger,-61.19,Orlando FL,32816,5557.62,0
2026-08-23,05:36:00,Fraud,-1932.76,Tokyo JP,39132,3624.86,1
2026-08-24,08:00:00,Paycheck,2000.0,Oviedo FL,32765,7557.62,0
2026-08-24,08:27:00,Chevron,-50.34,Winter Park FL,32789,7507.28,0
2026-08-24,11:20:00,Concert Tickets,-77.45,Orlando FL,32816,7429.83,0
2026-08-24,20:20:00,Best Buy,-124.29,Oviedo FL,32765,7305.54,0
2026-08-26,12:13:00,Walmart,-192.85,Winter Park FL,32789,7112.69,0
2026-08-26,18:05:00,Jiffy Lube,-188.68,Winter Park FL,32789,6924.01,0
2026-08-26,03:40:00,IBM,-1609.12,Los Angeles CA,52658,5314.89,1
2026-08-26,11:32:00,Starbucks,-38.71,Winter Park FL,32789,6885.3,0
2026-08-27,18:28:00,Trader Joe's,-166.13,Oviedo FL,32765,6719.17,0
2026-08-27,17:03:00,Walgreens,-13.08,Winter Park FL,32789,6706.09,0
2026-08-27,08:33:00,McDonald's,-71.86,Oviedo FL,32765,6634.23,0
2026-08-28,09:22:00,McDonald's,-28.68,Winter Park FL,32789,6605.55,0
2026-08-30,06:27:00,Fat Joe,-2340.59,London EN,61899,4264.96,1
2026-08-31,08:15:00,Starbucks,-73.69,Orlando FL,32816,6531.86,0
2026-08-31,07:51:00,Accelerators,-2485.35,Mexico City MC,21561,4046.51,1
2026-09-01,09:00:00,Rent,-960.0,Oviedo FL,32765,5571.86,0
2026-09-01,09:00:00,Insurance,-197.46,Oviedo FL,32765,5374.4,0
2026-09-01,09:00:00,Car,-300.0,Oviedo FL,32765,5074.4,0
2026-09-01,15:25:00,Subway,-23.93,Orlando FL,32816,5050.47,0
2026-09-01,03:00:00,IBM,-2833.35,Anchorage AL,50004,2217.12,1
2026-09-02,12:18:00,Walmart,-117.17,Orlando FL,32816,4933.3,0
2026-09-03,09:37:00,Subway,-20.71,Winter Park FL,32789,4912.59,0
2026-09-04,19:50:00,Amusement Park,-37.66,Orlando FL,32816,4874.93,0
2026-09-04,18:00:00,Netflix,-41.67,Orlando FL,32816,4833.26,0
2026-09-05,12:25:00,Five Below,-19.06,Winter Park FL,32789,4814.2,0
2026-09-05,21:07:00,Pep Boys,-40.01,Oviedo FL,32765,4774.19,0
2026-09-05,10:44:00,Starbucks,-16.65,Oviedo FL,32765,4757.54,0
2026-09-05,06:06:00,IBM,-521.32,Pittsburgh PA,23758,4236.22,1
2026-09-07,08:00:00,Paycheck,2000.0,Oviedo FL,32765,6757.54,0
2026-09-07,09:00:00,Spotify,-11.99,Oviedo FL,32765,6745.55,0
2026-09-07,09:00:00,Internet,-70.89,Oviedo FL,32765,6674.66,0
2026-09-07,09:00:00,ChatGPT Plus,-20.0,Oviedo FL,32765,6654.66,0
2026-09-07,16:29:00,Subway,-26.12,Oviedo FL,32765,6628.54,0
2026-09-07,15:59:00,Fat Joe,-315.12,Pyongyang NK,26351,6313.42,1
2026-09-07,09:08:00,Dollar Tree,-47.88,Oviedo FL,32765,6580.66,0
2026-09-08,10:18:00,McDonald's,-53.86,Winter Park FL,32789,6526.8,0
2026-09-08,10:43:00,Jiffy Lube,-219.72,Orlando FL,32816,6307.08,0
2026-09-08,19:12:00,Burger King,-67.61,Orlando FL,32816,6239.47,0
2026-09-09,17:29:00,Paypal,-659.63,Pyongyang NK,47303,5579.84,1
2026-09-10,14:28:00,Amazon,-257.49,Orlando FL,32816,5981.98,0
2026-09-11,10:06:00,Subway,-32.67,Orlando FL,32816,5949.31,0
2026-09-11,20:48:00,Amusement Park,-16.17,Winter Park FL,32789,5933.14,0
2026-09-12,12:59:00,BP,-15.11,Winter Park FL,32789,5918.03,0
2026-09-12,20:31:00,Monster Energy,-1811.67,Anchorage AL,87828,4106.36,1
2026-09-13,19:54:00,Movie Theater,-37.82,Winter Park FL,32789,5880.21,0
2026-09-13,15:56:00,Starbucks,-11.72,Oviedo FL,32765,5868.49,0
2026-09-14,18:56:00,Fat Joe,-2294.29,Mexico City MC,82709,3574.2,1
2026-09-14,13:24:00,Best Buy,-75.84,Oviedo FL,32765,5792.65,0
2026-09-15,08:29:00,Best Buy,-52.75,Oviedo FL,32765,5739.9,0
2026-09-16,16:12:00,Starbucks,-37.21,Winter Park FL,32789,5702.69,0
2026-09-16,10:01:00,Subway,-16.47,Oviedo FL,32765,5686.22,0
2026-09-16,18:22:00,Amazon,-41.26,Orlando FL,32816,5644.96,0
2026-09-17,17:58:00,Starbucks,-26.68,Winter Park FL,32789,5618.28,0
2026-09-17,18:13:00,Movie Theater,-48.66,Oviedo FL,32765,5569.62,0
2026-09-17,08:19:00,Starbucks,-28.64,Orlando FL,32816,5540.98,0
2026-09-18,08:25:00,Kroger,-83.04,Oviedo FL,32765,5457.94,0
2026-09-19,17:26:00,Target,-104.6,Winter Park FL,32789,5353.34,0
2026-09-21,08:00:00,Paycheck,2000.0,Oviedo FL,32765,7353.34,0
2026-09-21,03:39:00,Lockheed Martin,-2767.01,Groton CT,49762,4586.33,1
2026-09-22,21:55:00,Fat Joe,-2676.92,Tokyo JP,19660,4676.42,1
2026-09-23,11:37:00,Lockheed Martin,-1789.51,Mexico City MC,98860,5563.83,1
2026-09-23,09:58:00,Shell,-29.84,Orlando FL,32816,7323.5,0
2026-09-23,10:18:00,Lockheed Martin,-2450.23,Pyongyang NK,55713,4873.27,1
2026-09-24,15:48:00,Amazon,-175.81,Oviedo FL,32765,7147.69,0
2026-09-25,10:40:00,Subway,-72.1,Orlando FL,32816,7075.59,0
2026-09-25,18:55:00,Five Below,-95.1,Oviedo FL,32765,6980.49,0
2026-09-25,18:59:00,Exxon,-34.43,Orlando FL,32816,6946.06,0
2026-09-26,20:25:00,Burger King,-29.49,Orlando FL,32816,6916.57,0
2026-09-26,21:15:00,Target,-40.23,Oviedo FL,32765,6876.34,0
2026-09-27,18:43:00,Burger King,-75.15,Winter Park FL,32789,6801.19,0
2026-09-27,11:50:00,Burger King,-74.66,Oviedo FL,32765,6726.53,0
2026-09-29,20:19:00,Amusement Park,-111.25,Oviedo FL,32765,6615.28,0
2026-10-01,09:00:00,Rent,-960.0,Oviedo FL,32765,5655.28,0
2026-10-01,09:00:00,Insurance,-197.46,Oviedo FL,32765,5457.82,0
2026-10-01,09:00:00,Car,-300.0,Oviedo FL,32765,5157.82,0
2026-10-01,10:51:00,Starbucks,-34.17,Winter Park FL,32789,5123.65,0
2026-10-01,10:54:00,Burger King,-23.65,Oviedo FL,32765,5100.0,0
2026-10-01,18:21:00,Five Below,-23.03,Winter Park FL,32789,5076.97,0
2026-10-01,11:26:00,Onlyfans,-2754.99,Los Angeles CA,55255,2321.98,1
2026-10-02,14:44:00,CVS,-5.36,Winter Park FL,32789,5071.61,0
2026-10-02,05:08:00,Servicenow,-2142.93,Charleston SC,29987,2928.68,1
2026-10-02,21:38:00,Burger King,-25.91,Oviedo FL,32765,5045.7,0
2026-10-02,16:08:00,Kroger,-50.39,Oviedo FL,32765,4995.31,0
2026-10-04,12:41:00,AutoZone,-199.62,Winter Park FL,32789,4795.69,0
2026-10-04,09:14:00,Target,-110.86,Oviedo FL,32765,4684.83,0
2026-10-04,13:18:00,Kroger,-88.42,Winter Park FL,32789,4596.41,0
2026-10-05,08:00:00,Paycheck,2000.0,Oviedo FL,32765,6596.41,0
2026-10-05,11:53:00,AutoZone,-167.25,Orlando FL,32816,6429.16,0
2026-10-06,13:20:00,Servicenow,-2311.06,Pittsburgh PA,68811,4118.1,1
2026-10-06,18:54:00,Concert Tickets,-98.79,Orlando FL,32816,6330.37,0
2026-10-06,19:13:00,Burger King,-56.42,Winter Park FL,32789,6273.95,0
2026-10-06,21:45:00,Kroger,-112.68,Winter Park FL,32789,6161.27,0
2026-10-07,09:00:00,Spotify,-11.99,Oviedo FL,32765,6149.28,0
2026-10-07,09:00:00,Internet,-70.89,Oviedo FL,32765,6078.39,0
2026-10-07,09:00:00,ChatGPT Plus,-20.0,Oviedo FL,32765,6058.39,0
2026-10-07,17:13:00,Target,-288.94,Oviedo FL,32765,5769.45,0
2026-10-07,21:11:00,Walmart,-129.62,Oviedo FL,32765,5639.83,0
2026-10-08,09:09:00,Trader Joe's,-71.95,Winter Park FL,32789,5567.88,0
2026-10-08,08:31:00,Publix,-72.29,Winter Park FL,32789,5495.59,0
2026-10-09,05:57:00,Monster Energy,-2090.62,Honolulu HI,99621,3404.97,1
2026-10-09,17:19:00,Shell,-27.52,Winter Park FL,32789,5468.07,0
2026-10-09,18:18:00,BP,-22.06,Orlando FL,32816,5446.01,0
2026-10-09,11:03:00,Fraud,-2858.13,Tokyo JP,57274,2587.88,1
2026-10-09,20:19:00,McDonald's,-14.49,Winter Park FL,32789,5431.52,0
2026-10-10,13:06:00,Amusement Park,-38.85,Winter Park FL,32789,5392.67,0
2026-10-10,11:03:00,Pep Boys,-93.54,Winter Park FL,32789,5299.13,0
2026-10-11,20:38:00,Publix,-69.31,Orlando FL,32816,5229.82,0
2026-10-11,18:46:00,Burger King,-33.79,Winter Park FL,32789,5196.03,0
2026-10-11,10:15:00,Magic the Gathering,-989.65,Honolulu HI,13151,4206.38,1
2026-10-12,08:09:00,Starbucks,-33.46,Orlando FL,32816,5162.57,0
2026-10-12,18:07:00,Dollar Tree,-13.5,Oviedo FL,32765,5149.07,0
2026-10-14,14:56:00,Whole Foods,-86.36,Winter Park FL,32789,5062.71,0
2026-10-14,09:39:00,Trader Joe's,-42.18,Oviedo FL,32765,5020.53,0
2026-10-14,04:42:00,Monster Energy,-1723.04,Charleston SC,19506,3297.49,1
2026-10-15,10:21:00,Kroger,-41.53,Winter Park FL,32789,4979.0,0
2026-10-15,17:11:00,Burger King,-19.15,Orlando FL,32816,4959.85,0
2026-10-15,21:24:00,Servicenow,-2469.94,Charleston SC,83104,2489.91,1
2026-10-15,20:49:00,Concert Tickets,-36.88,Orlando FL,32816,4922.97,0
2026-10-17,08:12:00,Target,-125.79,Orlando FL,32816,4797.18,0
2026-10-17,11:28:00,BP,-26.07,Orlando FL,32816,4771.11,0
2026-10-17,16:13:00,CVS,-29.93,Winter Park FL,32789,4741.18,0
2026-10-19,08:00:00,Paycheck,2000.0,Oviedo FL,32765,6741.18,0
2026-10-22,19:01:00,Target,-67.18,Oviedo FL,32765,6674.0,0
2026-10-22,17:32:00,Best Buy,-156.65,Oviedo FL,32765,6517.35,0
2026-10-22,16:39:00,Starbucks,-47.49,Winter Park FL,32789,6469.86,0
2026-10-23,08:13:00,Starbucks,-25.91,Orlando FL,32816,6443.95,0
2026-10-23,10:07:00,Burger King,-44.01,Orlando FL,32816,6399.94,0
2026-10-23,09:13:00,Dollar Tree,-88.58,Winter Park FL,32789,6311.36,0
2026-10-24,18:34:00,Burger King,-40.96,Winter Park FL,32789,6270.4,0
2026-10-24,10:46:00,Starbucks,-73.22,Winter Park FL,32789,6197.18,0
2026-10-25,16:05:00,Best Buy,-68.73,Orlando FL,32816,6128.45,0
2026-10-25,12:07:00,Starbucks,-40.03,Winter Park FL,32789,6088.42,0
2026-10-28,15:38:00,Walmart,-100.19,Orlando FL,32816,5988.23,0
2026-10-29,13:15:00,Subway,-34.73,Winter Park FL,32789,5953.5,0
2026-10-29,16:08:00,Netflix,-54.3,Winter Park FL,32789,5899.2,0
2026-10-30,08:49:00,McDonald's,-23.63,Oviedo FL,32765,5875.57,0
2026-10-30,03:52:00,Monster Energy,-2970.01,Los Angeles CA,18518,2905.56,1
2026-10-30,20:35:00,Starbucks,-33.05,Oviedo FL,32765,5842.52,0
2026-10-30,21:45:00,Burger King,-15.11,Orlando FL,32816,5827.41,0
2026-10-31,16:17:00,Burger King,-11.53,Orlando FL,32816,5815.88,0
2026-11-01,09:00:00,Rent,-960.0,Oviedo FL,32765,4855.88,0
2026-11-01,09:00:00,Insurance,-197.46,Oviedo FL,32765,4658.42,0
2026-11-01,09:00:00,Car,-300.0,Oviedo FL,32765,4358.42,0
2026-11-01,10:56:00,Chevron,-27.89,Winter Park FL,32789,4330.53,0
2026-11-02,08:00:00,Paycheck,2000.0,Oviedo FL,32765,6330.53,0
2026-11-02,12:35:00,Starbucks,-34.96,Oviedo FL,32765,6295.57,0
2026-11-02,18:40:00,Walmart,-136.84,Oviedo FL,32765,6158.73,0
2026-11-03,19:36:00,McDonald's,-74.79,Orlando FL,32816,6083.94,0
2026-11-03,18:38:00,CVS,-73.99,Oviedo FL,32765,6009.95,0
2026-11-03,21:52:00,Subway,-14.12,Orlando FL,32816,5995.83,0
2026-11-04,21:23:00,Exxon,-27.58,Oviedo FL,32765,5968.25,0
2026-11-06,11:50:00,McDonald's,-30.17,Oviedo FL,32765,5938.08,0
2026-11-06,16:30:00,Subway,-8.79,Orlando FL,32816,5929.29,0
2026-11-07,09:00:00,Spotify,-11.99,Oviedo FL,32765,5917.3,0
2026-11-07,09:00:00,Internet,-70.89,Oviedo FL,32765,5846.41,0
2026-11-07,09:00:00,ChatGPT Plus,-20.0,Oviedo FL,32765,5826.41,0
2026-11-07,21:02:00,Exxon,-12.99,Oviedo FL,32765,5813.42,0
2026-11-07,21:00:00,Netflix,-41.89,Orlando FL,32816,5771.53,0
2026-11-08,05:14:00,Pawn Stars,-564.11,Honolulu HI,42560,5207.42,1
2026-11-09,18:43:00,Walmart,-32.14,Winter Park FL,32789,5739.39,0
2026-11-09,21:06:00,BP,-14.99,Oviedo FL,32765,5724.4,0
2026-11-09,13:18:00,Dollar Tree,-22.98,Oviedo FL,32765,5701.42,0
2026-11-10,17:44:00,McDonald's,-21.54,Orlando FL,32816,5679.88,0
2026-11-11,10:44:00,Starbucks,-11.77,Winter Park FL,32789,5668.11,0
2026-11-11,13:15:00,BP,-20.12,Oviedo FL,32765,5647.99,0
2026-11-12,18:13:00,Five Below,-9.02,Oviedo FL,32765,5638.97,0
2026-11-12,09:22:00,Target,-39.29,Winter Park FL,32789,5599.68,0
2026-11-12,18:53:00,Target,-125.26,Oviedo FL,32765,5474.42,0
2026-11-13,10:18:00,Subway,-18.92,Orlando FL,32816,5455.5,0
2026-11-13,13:13:00,McDonald's,-23.32,Orlando FL,32816,5432.18,0
2026-11-13,12:01:00,Publix,-80.17,Orlando FL,32816,5352.01,0
2026-11-15,18:10:00,Best Buy,-43.33,Oviedo FL,32765,5308.68,0
2026-11-16,08:00:00,Paycheck,2000.0,Oviedo FL,32765,7308.68,0
2026-11-16,11:32:00,Publix,-69.99,Oviedo FL,32765,7238.69,0
2026-11-17,18:05:00,Concert Tickets,-21.34,Orlando FL,32816,7217.35,0
2026-11-17,09:56:00,Best Buy,-281.31,Winter Park FL,32789,6936.04,0
2026-11-18,04:00:00,Pawn Stars,-316.3,Los Angeles CA,62260,6619.74,1
2026-11-18,19:42:00,CVS,-64.01,Oviedo FL,32765,6872.03,0
2026-11-19,03:38:00,Monster Energy,-1947.44,Groton CT,84823,4924.59,1
2026-11-19,15:12:00,Target,-195.78,Orlando FL,32816,6676.25,0
2026-11-20,19:48:00,CVS,-37.79,Winter Park FL,32789,6638.46,0
2026-11-21,09:18:00,Kroger,-101.57,Oviedo FL,32765,6536.89,0
2026-11-21,23:44:00,Paypal,-2154.75,Tokyo JP,88999,4382.14,1
2026-11-21,14:48:00,Subway,-21.8,Orlando FL,32816,6515.09,0
2026-11-21,10:36:00,CVS,-16.56,Winter Park FL,32789,6498.53,0
2026-11-22,14:27:00,Subway,-49.63,Orlando FL,32816,6448.9,0
2026-11-23,08:47:00,Kroger,-88.49,Orlando FL,32816,6360.41,0
2026-11-23,17:19:00,Burger King,-36.24,Orlando FL,32816,6324.17,0
2026-11-24,13:46:00,Kroger,-137.59,Winter Park FL,32789,6186.58,0
2026-11-25,18:21:00,Chevron,-49.75,Winter Park FL,32789,6136.83,0
2026-11-25,17:25:00,Concert Tickets,-82.7,Winter Park FL,32789,6054.13,0
2026-11-25,16:47:00,Burger King,-37.79,Winter Park FL,32789,6016.34,0
2026-11-26,21:22:00,Starbucks,-35.23,Winter Park FL,32789,5981.11,0
2026-11-26,11:54:00,Best Buy,-69.26,Orlando FL,32816,5911.85,0
2026-11-28,15:54:00,Dollar Tree,-30.81,Oviedo FL,32765,5881.04,0
2026-11-28,17:56:00,Exxon,-21.16,Orlando FL,32816,5859.88,0
2026-11-30,08:00:00,Paycheck,2000.0,Oviedo FL,32765,7859.88,0
2026-11-30,08:56:00,Target,-178.05,Orlando FL,32816,7681.83,0
2026-12-01,09:00:00,Rent,-960.0,Oviedo FL,32765,6721.83,0
2026-12-01,09:00:00,Insurance,-197.46,Oviedo FL,32765,6524.37,0
2026-12-01,09:00:00,Car,-300.0,Oviedo FL,32765,6224.37,0
2026-12-01,10:14:00,Amusement Park,-38.75,Oviedo FL,32765,6185.62,0
2026-12-01,19:03:00,Fat Joe,-893.84,Mexico City MC,96043,5291.78,1
2026-12-02,10:57:00,Accelerators,-2920.31,Los Angeles CA,56805,3265.31,1
2026-12-02,14:41:00,Burger King,-31.32,Winter Park FL,32789,6154.3,0
2026-12-03,08:11:00,Five Below,-15.19,Oviedo FL,32765,6139.11,0
2026-12-03,20:00:00,AutoZone,-214.84,Winter Park FL,32789,5924.27,0
2026-12-04,10:01:00,Netflix,-32.24,Winter Park FL,32789,5892.03,0
2026-12-05,11:48:00,McDonald's,-32.57,Oviedo FL,32765,5859.46,0
2026-12-05,13:15:00,Whole Foods,-90.86,Orlando FL,32816,5768.6,0
2026-12-06,19:27:00,McDonald's,-20.08,Orlando FL,32816,5748.52,0
2026-12-07,09:00:00,Spotify,-11.99,Oviedo FL,32765,5736.53,0
2026-12-07,09:00:00,Internet,-70.89,Oviedo FL,32765,5665.64,0
2026-12-07,09:00:00,ChatGPT Plus,-20.0,Oviedo FL,32765,5645.64,0
2026-12-07,01:21:00,Magic the Gathering,-2998.06,Honolulu HI,40787,2647.58,1
2026-12-07,10:02:00,Exxon,-17.39,Orlando FL,32816,5628.25,0
2026-12-07,08:53:00,Concert Tickets,-24.53,Oviedo FL,32765,5603.72,0
2026-12-07,03:25:00,Fat Joe,-2253.49,Tokyo JP,31924,3350.23,1
2026-12-07,20:00:00,Five Below,-44.11,Oviedo FL,32765,5559.61,0
2026-12-08,16:08:00,Subway,-30.54,Winter Park FL,32789,5529.07,0
2026-12-08,11:07:00,Starbucks,-36.15,Winter Park FL,32789,5492.92,0
2026-12-10,12:03:00,AutoZone,-142.7,Oviedo FL,32765,5350.22,0
2026-12-10,13:26:00,Amazon,-113.92,Winter Park FL,32789,5236.3,0
2026-12-10,06:24:00,IBM,-1463.92,New York NY,16625,3772.38,1
2026-12-11,20:36:00,Burger King,-8.55,Orlando FL,32816,5227.75,0
2026-12-11,08:54:00,Burger King,-26.27,Winter Park FL,32789,5201.48,0
2026-12-12,08:17:00,Amazon,-49.63,Oviedo FL,32765,5151.85,0
2026-12-13,12:38:00,Amazon,-12.76,Orlando FL,32816,5139.09,0
2026-12-13,21:03:00,Chevron,-20.36,Oviedo FL,32765,5118.73,0
2026-12-13,08:04:00,Accelerators,-2161.14,Mexico City MC,55377,2957.59,1
2026-12-14,08:00:00,Paycheck,2000.0,Oviedo FL,32765,7118.73,0
2026-12-15,18:45:00,Burger King,-48.69,Oviedo FL,32765,7070.04,0
2026-12-15,20:39:00,Subway,-68.54,Oviedo FL,32765,7001.5,0
2026-12-16,17:03:00,Amazon,-76.49,Oviedo FL,32765,6925.01,0
2026-12-16,08:37:00,AutoZone,-254.87,Orlando FL,32816,6670.14,0
2026-12-17,12:45:00,Burger King,-24.3,Winter Park FL,32789,6645.84,0
2026-12-17,14:31:00,Subway,-64.33,Winter Park FL,32789,6581.51,0
2026-12-18,19:10:00,Starbucks,-11.23,Orlando FL,32816,6570.28,0
2026-12-20,13:00:00,Movie Theater,-32.99,Winter Park FL,32789,6537.29,0
2026-12-20,09:01:00,Movie Theater,-96.06,Orlando FL,32816,6441.23,0
2026-12-20,12:35:00,Walmart,-289.77,Winter Park FL,32789,6151.46,0
2026-12-21,16:28:00,Amazon,-255.68,Orlando FL,32816,5895.78,0
2026-12-23,09:13:00,Midas,-117.5,Orlando FL,32816,5778.28,0
2026-12-23,21:21:00,Burger King,-7.15,Orlando FL,32816,5771.13,0
2026-12-24,09:14:00,Trader Joe's,-46.29,Oviedo FL,32765,5724.84,0
2026-12-24,18:29:00,Whole Foods,-94.06,Orlando FL,32816,5630.78,0
2026-12-25,08:37:00,Walgreens,-42.59,Orlando FL,32816,5588.19,0
2026-12-25,12:51:00,Burger King,-23.53,Orlando FL,32816,5564.66,0
2026-12-26,20:20:00,McDonald's,-28.73,Orlando FL,32816,5535.93,0
2026-12-26,12:25:00,Movie Theater,-10.08,Oviedo FL,32765,5525.85,0
2026-12-27,20:15:00,McDonald's,-20.66,Winter Park FL,32789,5505.19,0
2026-12-27,18:17:00,Shell,-21.24,Oviedo FL,32765,5483.95,0
2026-12-28,08:00:00,Paycheck,2000.0,Oviedo FL,32765,7483.95,0
2026-12-28,13:11:00,Starbucks,-69.93,Orlando FL,32816,7414.02,0
2026-12-28,20:03:00,Servicenow,-218.09,Honolulu HI,41648,7195.93,1
2026-12-28,15:41:00,Jiffy Lube,-283.16,Winter Park FL,32789,7130.86,0
2026-12-29,11:27:00,Amusement Park,-90.3,Winter Park FL,32789,7040.56,0
2026-12-31,09:57:00,Burger King,-61.18,Winter Park FL,32789,6979.38,0
2027-01-01,09:00:00,Rent,-960.0,Oviedo FL,32765,6019.38,0
2027-01-01,09:00:00,Insurance,-197.46,Oviedo FL,32765,5821.92,0
2027-01-01,09:00:00,Car,-300.0,Oviedo FL,32765,5521.92,0
2027-01-01,14:26:00,Starbucks,-20.92,Orlando FL,32816,5501.0,0
2027-01-01,09:17:00,Starbucks,-21.7,Winter Park FL,32789,5479.3,0
2027-01-01,10:38:00,Concert Tickets,-24.56,Orlando FL,32816,5454.74,0
2027-01-04,08:57:00,Paypal,-625.56,Anchorage AL,53264,4829.18,1
2027-01-04,18:57:00,Walmart,-140.23,Oviedo FL,32765,5314.51,0
2027-01-05,19:10:00,Whole Foods,-55.84,Orlando FL,32816,5258.67,0
2027-01-05,17:01:00,Amusement Park,-38.34,Oviedo FL,32765,5220.33,0
2027-01-06,16:46:00,McDonald's,-38.09,Winter Park FL,32789,5182.24,0
2027-01-06,18:10:00,Subway,-26.47,Winter Park FL,32789,5155.77,0
2027-01-07,09:00:00,Spotify,-11.99,Oviedo FL,32765,5143.78,0
2027-01-07,09:00:00,Internet,-70.89,Oviedo FL,32765,5072.89,0
2027-01-07,09:00:00,ChatGPT Plus,-20.0,Oviedo FL,32765,5052.89,0
2027-01-08,19:42:00,Burger King,-37.41,Orlando FL,32816,5015.48,0
2027-01-08,17:12:00,Subway,-12.19,Orlando FL,32816,5003.29,0
2027-01-09,16:08:00,McDonald's,-12.25,Winter Park FL,32789,4991.04,0
2027-01-09,12:51:00,Amusement Park,-59.67,Winter Park FL,32789,4931.37,0
2027-01-09,15:26:00,Trader Joe's,-46.57,Oviedo FL,32765,4884.8,0
2027-01-10,14:15:00,Walmart,-108.92,Orlando FL,32816,4775.88,0
2027-01-10,20:44:00,Trader Joe's,-83.9,Orlando FL,32816,4691.98,0
2027-01-11,08:00:00,Paycheck,2000.0,Oviedo FL,32765,6691.98,0
2027-01-11,13:56:00,Chevron,-55.53,Oviedo FL,32765,6636.45,0
2027-01-11,19:37:00,Burger King,-45.36,Winter Park FL,32789,6591.09,0
2027-01-11,18:25:00,CVS,-77.82,Oviedo FL,32765,6513.27,0
2027-01-13,11:00:00,Burger King,-73.42,Oviedo FL,32765,6439.85,0
2027-01-13,19:52:00,Walgreens,-80.05,Oviedo FL,32765,6359.8,0
2027-01-14,16:25:00,Amusement Park,-36.37,Winter Park FL,32789,6323.43,0
2027-01-14,19:40:00,Best Buy,-265.24,Oviedo FL,32765,6058.19,0
2027-01-14,15:19:00,McDonald's,-21.74,Oviedo FL,32765,6036.45,0
2027-01-15,15:02:00,Burger King,-54.35,Oviedo FL,32765,5982.1,0
2027-01-15,16:59:00,CVS,-31.27,Orlando FL,32816,5950.83,0
2027-01-15,13:26:00,Shell,-25.39,Orlando FL,32816,5925.44,0
2027-01-16,19:12:00,Subway,-10.53,Oviedo FL,32765,5914.91,0
2027-01-16,15:35:00,Whole Foods,-38.98,Winter Park FL,32789,5875.93,0
2027-01-17,19:26:00,CVS,-31.01,Orlando FL,32816,5844.92,0
2027-01-17,10:16:00,Publix,-97.82,Oviedo FL,32765,5747.1,0
2027-01-18,16:17:00,Burger King,-20.95,Orlando FL,32816,5726.15,0
2027-01-18,18:14:00,Whole Foods,-45.13,Oviedo FL,32765,5681.02,0
2027-01-18,20:31:00,McDonald's,-21.87,Oviedo FL,32765,5659.15,0
2027-01-21,18:42:00,Kroger,-70.55,Orlando FL,32816,5588.6,0
2027-01-21,20:22:00,Starbucks,-9.63,Oviedo FL,32765,5578.97,0
2027-01-24,21:15:00,Target,-101.27,Winter Park FL,32789,5477.7,0
2027-01-25,08:00:00,Paycheck,2000.0,Oviedo FL,32765,7477.7,0
2027-01-25,20:43:00,Walmart,-231.66,Winter Park FL,32789,7246.04,0
2027-01-28,12:18:00,Burger King,-46.82,Oviedo FL,32765,7199.22,0
2027-01-28,08:11:00,Subway,-14.79,Orlando FL,32816,7184.43,0
2027-01-28,20:34:00,Magic the Gathering,-967.6,Los Angeles CA,17342,6216.83,1
2027-01-29,09:40:00,Chevron,-42.04,Orlando FL,32816,7142.39,0
2027-01-30,14:42:00,Starbucks,-44.2,Orlando FL,32816,7098.19,0
2027-02-01,09:00:00,Rent,-960.0,Oviedo FL,32765,6138.19,0
2027-02-01,09:00:00,Insurance,-197.46,Oviedo FL,32765,5940.73,0
2027-02-01,09:00:00,Car,-300.0,Oviedo FL,32765,5640.73,0
2027-02-02,21:23:00,Burger King,-8.2,Oviedo FL,32765,5632.53,0
2027-02-03,08:33:00,Kroger,-65.6,Oviedo FL,32765,5566.93,0
2027-02-04,20:24:00,Starbucks,-6.03,Orlando FL,32816,5560.9,0
2027-02-04,10:20:00,Kroger,-76.18,Orlando FL,32816,5484.72,0
2027-02-04,17:27:00,Trader Joe's,-75.96,Orlando FL,32816,5408.76,0
2027-02-05,21:17:00,McDonald's,-9.96,Winter Park FL,32789,5398.8,0
2027-02-07,09:00:00,Spotify,-11.99,Oviedo FL,32765,5386.81,0
2027-02-07,09:00:00,Internet,-70.89,Oviedo FL,32765,5315.92,0
2027-02-07,09:00:00,ChatGPT Plus,-20.0,Oviedo FL,32765,5295.92,0
2027-02-07,14:25:00,Best Buy,-59.03,Orlando FL,32816,5236.89,0
2027-02-07,19:18:00,Best Buy,-84.96,Winter Park FL,32789,5151.93,0
2027-02-07,08:40:00,Subway,-30.88,Orlando FL,32816,5121.05,0
2027-02-08,08:00:00,Paycheck,2000.0,Oviedo FL,32765,7121.05,0
2027-02-08,20:32:00,Amazon,-64.49,Orlando FL,32816,7056.56,0
2027-02-08,16:49:00,Amusement Park,-92.1,Winter Park FL,32789,6964.46,0
2027-02-08,13:16:00,Paypal,-193.39,Los Angeles CA,92326,6771.07,1
2027-02-09,14:44:00,Concert Tickets,-82.19,Winter Park FL,32789,6882.27,0
2027-02-09,10:33:00,BP,-57.46,Winter Park FL,32789,6824.81,0
2027-02-10,08:17:00,Walgreens,-28.66,Winter Park FL,32789,6796.15,0
2027-02-10,21:52:00,Jiffy Lube,-153.9,Winter Park FL,32789,6642.25,0
2027-02-10,21:55:00,Accelerators,-451.06,Pittsburgh PA,57714,6191.19,1
2027-02-10,14:27:00,Starbucks,-49.02,Winter Park FL,32789,6593.23,0
2027-02-12,12:08:00,Best Buy,-96.81,Winter Park FL,32789,6496.42,0
2027-02-13,20:55:00,Subway,-65.17,Winter Park FL,32789,6431.25,0
2027-02-13,11:18:00,Walgreens,-14.52,Winter Park FL,32789,6416.73,0
2027-02-14,10:12:00,Whole Foods,-90.28,Winter Park FL,32789,6326.45,0
2027-02-14,14:28:00,Shell,-27.27,Winter Park FL,32789,6299.18,0
2027-02-15,20:06:00,Starbucks,-23.57,Oviedo FL,32765,6275.61,0
2027-02-15,17:00:00,Whole Foods,-144.83,Orlando FL,32816,6130.78,0
2027-02-15,12:00:00,Shell,-48.69,Orlando FL,32816,6082.09,0
2027-02-16,01:28:00,Fat Joe,-125.18,Mexico City MC,99113,5956.91,1
2027-02-16,10:50:00,Burger King,-30.18,Winter Park FL,32789,6051.91,0
2027-02-17,17:12:00,Starbucks,-44.99,Orlando FL,32816,6006.92,0
2027-02-18,15:51:00,Starbucks,-66.94,Oviedo FL,32765,5939.98,0
2027-02-18,16:43:00,Trader Joe's,-66.05,Orlando FL,32816,5873.93,0
2027-02-20,15:54:00,Subway,-33.0,Orlando FL,32816,5840.93,0
2027-02-22,08:00:00,Paycheck,2000.0,Oviedo FL,32765,7840.93,0
2027-02-25,14:26:00,Midas,-264.57,Oviedo FL,32765,7576.36,0
2027-02-25,11:09:00,Burger King,-60.89,Oviedo FL,32765,7515.47,0
2027-02-25,15:02:00,Publix,-92.89,Winter Park FL,32789,7422.58,0
2027-02-25,14:17:00,Lockheed Martin,-1124.59,Pyongyang NK,81476,6297.99,1
2027-02-27,09:30:00,CVS,-53.04,Orlando FL,32816,7369.54,0
2027-03-01,09:00:00,Rent,-960.0,Oviedo FL,32765,6409.54,0
2027-03-01,09:00:00,Insurance,-197.46,Oviedo FL,32765,6212.08,0
2027-03-01,09:00:00,Car,-300.0,Oviedo FL,32765,5912.08,0
2027-03-02,16:01:00,Target,-115.62,Winter Park FL,32789,5796.46,0
2027-03-02,11:44:00,Pep Boys,-164.41,Winter Park FL,32789,5632.05,0
2027-03-02,06:27:00,Pawn Stars,-1165.79,Pyongyang NK,47173,4466.26,1
2027-03-03,13:00:00,AutoZone,-186.26,Winter Park FL,32789,5445.79,0
2027-03-03,21:00:00,McDonald's,-17.35,Oviedo FL,32765,5428.44,0
2027-03-07,09:00:00,Spotify,-11.99,Oviedo FL,32765,5416.45,0
2027-03-07,09:00:00,Internet,-70.89,Oviedo FL,32765,5345.56,0
2027-03-07,09:00:00,ChatGPT Plus,-20.0,Oviedo FL,32765,5325.56,0
2027-03-07,14:51:00,Movie Theater,-51.91,Orlando FL,32816,5273.65,0
2027-03-07,17:42:00,Amazon,-69.02,Winter Park FL,32789,5204.63,0
2027-03-07,17:10:00,Subway,-34.14,Winter Park FL,32789,5170.49,0
2027-03-08,08:00:00,Paycheck,2000.0,Oviedo FL,32765,7170.49,0
2027-03-08,14:14:00,Pep Boys,-343.26,Winter Park FL,32789,6827.23,0
2027-03-08,09:04:00,Whole Foods,-179.67,Oviedo FL,32765,6647.56,0
2027-03-09,18:53:00,Movie Theater,-45.46,Oviedo FL,32765,6602.1,0
2027-03-09,10:20:00,Subway,-35.7,Oviedo FL,32765,6566.4,0
2027-03-09,19:34:00,Dollar Tree,-48.2,Orlando FL,32816,6518.2,0
2027-03-10,08:47:00,Movie Theater,-89.8,Orlando FL,32816,6428.4,0
2027-03-11,21:14:00,Amusement Park,-60.87,Winter Park FL,32789,6367.53,0
2027-03-14,18:13:00,Best Buy,-152.14,Oviedo FL,32765,6215.39,0
2027-03-14,13:10:00,Concert Tickets,-84.45,Winter Park FL,32789,6130.94,0
2027-03-15,17:33:00,Burger King,-13.75,Oviedo FL,32765,6117.19,0
2027-03-16,19:34:00,Target,-247.48,Orlando FL,32816,5869.71,0
2027-03-16,19:57:00,Movie Theater,-53.69,Oviedo FL,32765,5816.02,0
2027-03-16,11:43:00,Shell,-13.78,Winter Park FL,32789,5802.24,0
2027-03-17,11:16:00,Subway,-17.15,Oviedo FL,32765,5785.09,0
2027-03-17,20:34:00,Kroger,-92.34,Orlando FL,32816,5692.75,0
2027-03-18,11:43:00,Subway,-9.19,Oviedo FL,32765,5683.56,0
2027-03-18,20:38:00,McDonald's,-33.28,Oviedo FL,32765,5650.28,0
2027-03-20,13:24:00,Exxon,-22.07,Oviedo FL,32765,5628.21,0
2027-03-22,08:00:00,Paycheck,2000.0,Oviedo FL,32765,7628.21,0
2027-03-22,14:42:00,BP,-51.03,Orlando FL,32816,7577.18,0
2027-03-22,10:39:00,Five Below,-37.71,Oviedo FL,32765,7539.47,0
2027-03-22,21:22:00,Accelerators,-2604.98,Honolulu HI,75300,4934.49,1
2027-03-22,09:24:00,Amusement Park,-53.04,Winter Park FL,32789,7486.43,0
2027-03-22,17:29:00,Monster Energy,-2481.89,Los Angeles CA,51945,5004.54,1
2027-03-23,14:07:00,Chevron,-46.17,Oviedo FL,32765,7440.26,0
2027-03-23,12:39:00,McDonald's,-37.3,Winter Park FL,32789,7402.96,0
2027-03-24,14:48:00,Walmart,-219.29,Winter Park FL,32789,7183.67,0
2027-03-24,18:04:00,McDonald's,-30.71,Orlando FL,32816,7152.96,0
2027-03-25,08:44:00,Walmart,-69.88,Oviedo FL,32765,7083.08,0
2027-03-25,21:17:00,Publix,-189.46,Oviedo FL,32765,6893.62,0
2027-03-25,01:06:00,IBM,-2989.58,Anchorage AL,90879,3904.04,1
2027-03-26,19:03:00,Shell,-47.02,Oviedo FL,32765,6846.6,0
2027-03-26,03:20:00,Monster Energy,-250.92,Mexico City MC,54543,6595.68,1
2027-03-26,16:05:00,Subway,-26.14,Oviedo FL,32765,6820.46,0
2027-03-26,14:38:00,Amusement Park,-84.71,Winter Park FL,32789,6735.75,0
2027-03-27,21:06:00,Onlyfans,-2651.56,New York NY,91581,4084.19,1
2027-03-27,16:18:00,Subway,-73.14,Oviedo FL,32765,6662.61,0
2027-03-28,08:28:00,Burger King,-69.7,Winter Park FL,32789,6592.91,0
2027-03-28,12:51:00,Burger King,-56.38,Winter Park FL,32789,6536.53,0
2027-03-28,11:03:00,Walmart,-78.47,Winter Park FL,32789,6458.06,0
2027-03-29,08:42:00,Pawn Stars,-1858.88,Charleston SC,57874,4599.18,1
2027-03-29,11:10:00,Pep Boys,-193.97,Oviedo FL,32765,6264.09,0
2027-03-29,17:50:00,BP,-32.1,Oviedo FL,32765,6231.99,0
2027-03-29,17:56:00,Servicenow,-239.35,Honolulu HI,78522,5992.64,1
2027-03-31,17:07:00,Amazon,-205.12,Oviedo FL,32765,6026.87,0
2027-04-01,09:00:00,Rent,-960.0,Oviedo FL,32765,5066.87,0
2027-04-01,09:00:00,Insurance,-197.46,Oviedo FL,32765,4869.41,0
2027-04-01,09:00:00,Car,-300.0,Oviedo FL,32765,4569.41,0
2027-04-01,06:23:00,Lockheed Martin,-870.89,Charleston SC,88635,3698.52,1
2027-04-01,08:15:00,Amazon,-31.75,Winter Park FL,32789,4537.66,0
2027-04-01,12:12:00,Starbucks,-24.23,Orlando FL,32816,4513.43,0
2027-04-02,14:02:00,Publix,-78.99,Orlando FL,32816,4434.44,0
2027-04-05,08:00:00,Paycheck,2000.0,Oviedo FL,32765,6434.44,0
2027-04-06,18:01:00,Best Buy,-250.94,Oviedo FL,32765,6183.5,0
2027-04-06,10:46:00,Whole Foods,-80.16,Orlando FL,32816,6103.34,0
2027-04-07,09:00:00,Spotify,-11.99,Oviedo FL,32765,6091.35,0
2027-04-07,09:00:00,Internet,-70.89,Oviedo FL,32765,6020.46,0
2027-04-07,09:00:00,ChatGPT Plus,-20.0,Oviedo FL,32765,6000.46,0
2027-04-07,11:14:00,Best Buy,-94.41,Orlando FL,32816,5906.05,0
2027-04-07,09:07:00,Midas,-74.9,Oviedo FL,32765,5831.15,0
2027-04-07,15:52:00,McDonald's,-15.26,Winter Park FL,32789,5815.89,0
2027-04-08,20:36:00,Burger King,-27.91,Winter Park FL,32789,5787.98,0
2027-04-09,16:28:00,Concert Tickets,-59.59,Oviedo FL,32765,5728.39,0
2027-04-11,02:28:00,IBM,-209.1,Charleston SC,98619,5519.29,1
2027-04-14,13:09:00,Exxon,-15.52,Oviedo FL,32765,5712.87,0
2027-04-14,16:40:00,McDonald's,-27.73,Oviedo FL,32765,5685.14,0
2027-04-16,13:05:00,Starbucks,-7.25,Orlando FL,32816,5677.89,0
2027-04-17,16:41:00,Starbucks,-14.03,Winter Park FL,32789,5663.86,0
2027-04-17,14:58:00,Target,-52.47,Oviedo FL,32765,5611.39,0
2027-04-18,12:53:00,Kroger,-79.9,Orlando FL,32816,5531.49,0
2027-04-18,15:00:00,Movie Theater,-20.24,Orlando FL,32816,5511.25,0
2027-04-19,08:00:00,Paycheck,2000.0,Oviedo FL,32765,7511.25,0
2027-04-19,11:44:00,Exxon,-25.36,Winter Park FL,32789,7485.89,0
2027-04-19,21:01:00,Kroger,-179.53,Winter Park FL,32789,7306.36,0
2027-04-19,20:06:00,Target,-227.06,Orlando FL,32816,7079.3,0
2027-04-21,20:55:00,Shell,-55.91,Oviedo FL,32765,7023.39,0
2027-04-21,03:00:00,Monster Energy,-1861.17,Tokyo JP,81131,5162.22,1
2027-04-21,19:42:00,Burger King,-27.66,Winter Park FL,32789,6995.73,0
2027-04-21,13:22:00,Walgreens,-31.97,Orlando FL,32816,6963.76,0
2027-04-22,13:40:00,Walmart,-177.21,Winter Park FL,32789,6786.55,0
2027-04-22,21:50:00,Best Buy,-192.83,Oviedo FL,32765,6593.72,0
2027-04-22,14:03:00,Jiffy Lube,-262.62,Orlando FL,32816,6331.1,0
2027-04-25,11:00:00,CVS,-89.84,Oviedo FL,32765,6241.26,0
2027-04-25,04:06:00,Lockheed Martin,-1788.52,Tokyo JP,48390,4452.74,1
2027-04-25,17:41:00,Kroger,-101.0,Orlando FL,32816,6140.26,0
2027-04-25,08:52:00,Concert Tickets,-73.34,Winter Park FL,32789,6066.92,0
2027-04-26,17:49:00,Subway,-48.61,Orlando FL,32816,6018.31,0
2027-04-26,14:38:00,AutoZone,-91.0,Winter Park FL,32789,5927.31,0
2027-04-26,21:28:00,Fraud,-699.69,Charleston SC,97404,5227.62,1
2027-04-27,18:33:00,Trader Joe's,-81.53,Orlando FL,32816,5845.78,0
2027-04-28,16:55:00,Concert Tickets,-31.48,Orlando FL,32816,5814.3,0
2027-04-28,20:40:00,Monster Energy,-2895.04,Charleston SC,53792,2919.26,1
2027-04-28,08:39:00,McDonald's,-25.5,Winter Park FL,32789,5788.8,0
2027-04-28,16:24:00,Movie Theater,-27.2,Orlando FL,32816,5761.6,0
2027-04-29,17:45:00,Starbucks,-14.07,Oviedo FL,32765,5747.53,0
2027-04-29,12:23:00,Best Buy,-63.26,Oviedo FL,32765,5684.27,0
2027-04-29,19:37:00,Subway,-27.98,Orlando FL,32816,5656.29,0
2027-04-30,10:47:00,Walgreens,-26.12,Winter Park FL,32789,5630.17,0
2027-05-01,09:00:00,Rent,-960.0,Oviedo FL,32765,4670.17,0
2027-05-01,09:00:00,Insurance,-197.46,Oviedo FL,32765,4472.71,0
2027-05-01,09:00:00,Car,-300.0,Oviedo FL,32765,4172.71,0
2027-05-01,08:29:00,Movie Theater,-50.5,Orlando FL,32816,4122.21,0
2027-05-01,15:24:00,McDonald's,-13.66,Oviedo FL,32765,4108.55,0
2027-05-02,14:38:00,Five Below,-47.86,Orlando FL,32816,4060.69,0
2027-05-02,15:44:00,Walmart,-102.82,Orlando FL,32816,3957.87,0
2027-05-03,08:00:00,Paycheck,2000.0,Oviedo FL,32765,5957.87,0
2027-05-03,16:31:00,Fraud,-2896.9,Honolulu HI,29114,3060.97,1
2027-05-03,18:33:00,Best Buy,-136.6,Oviedo FL,32765,5821.27,0
2027-05-03,21:01:00,Netflix,-21.21,Winter Park FL,32789,5800.06,0
2027-05-03,13:15:00,Best Buy,-138.72,Oviedo FL,32765,5661.34,0
2027-05-04,14:14:00,Walmart,-67.86,Oviedo FL,32765,5593.48,0
2027-05-04,09:47:00,Subway,-17.5,Oviedo FL,32765,5575.98,0
2027-05-04,12:24:00,Pep Boys,-42.57,Oviedo FL,32765,5533.41,0
2027-05-05,18:02:00,Accelerators,-2153.29,London EN,73332,3380.12,1
2027-05-05,14:38:00,Publix,-51.71,Orlando FL,32816,5481.7,0
2027-05-06,18:01:00,Whole Foods,-95.61,Winter Park FL,32789,5386.09,0
2027-05-06,16:41:00,Walmart,-15.62,Oviedo FL,32765,5370.47,0
2027-05-06,10:10:00,Target,-44.62,Oviedo FL,32765,5325.85,0
2027-05-07,09:00:00,Spotify,-11.99,Oviedo FL,32765,5313.86,0
2027-05-07,09:00:00,Internet,-70.89,Oviedo FL,32765,5242.97,0
2027-05-07,09:00:00,ChatGPT Plus,-20.0,Oviedo FL,32765,5222.97,0
2027-05-07,17:58:00,Whole Foods,-49.64,Oviedo FL,32765,5173.33,0
2027-05-07,15:54:00,Starbucks,-31.29,Winter Park FL,32789,5142.04,0
2027-05-08,09:27:00,BP,-15.27,Orlando FL,32816,5126.77,0
2027-05-08,11:51:00,Trader Joe's,-86.27,Orlando FL,32816,5040.5,0
2027-05-08,21:31:00,Starbucks,-24.87,Oviedo FL,32765,5015.63,0
2027-05-09,12:24:00,Whole Foods,-39.8,Winter Park FL,32789,4975.83,0
2027-05-10,20:45:00,Amazon,-94.07,Orlando FL,32816,4881.76,0
2027-05-11,23:43:00,Accelerators,-1150.18,London EN,43418,3731.58,1
2027-05-12,21:28:00,Walgreens,-47.59,Orlando FL,32816,4834.17,0
2027-05-12,17:10:00,Jiffy Lube,-95.92,Winter Park FL,32789,4738.25,0
2027-05-13,11:43:00,Amusement Park,-39.2,Winter Park FL,32789,4699.05,0
2027-05-14,13:30:00,CVS,-27.45,Oviedo FL,32765,4671.6,0
2027-05-14,16:25:00,Subway,-34.64,Orlando FL,32816,4636.96,0
2027-05-14,19:57:00,Burger King,-17.4,Oviedo FL,32765,4619.56,0
2027-05-15,10:40:00,Publix,-60.47,Winter Park FL,32789,4559.09,0
2027-05-16,16:20:00,Monster Energy,-2359.72,Pyongyang NK,55867,2199.37,1
2027-05-16,21:26:00,CVS,-39.94,Winter Park FL,32789,4519.15,0
2027-05-16,13:06:00,Kroger,-41.24,Orlando FL,32816,4477.91,0
2027-05-16,10:27:00,Target,-113.72,Winter Park FL,32789,4364.19,0
2027-05-16,09:41:00,Monster Energy,-2123.46,Charleston SC,78247,2240.73,1
2027-05-17,08:00:00,Paycheck,2000.0,Oviedo FL,32765,6364.19,0
2027-05-17,17:30:00,Starbucks,-14.16,Oviedo FL,32765,6350.03,0
2027-05-17,10:16:00,Chevron,-27.54,Oviedo FL,32765,6322.49,0
2027-05-18,09:14:00,Amazon,-274.31,Orlando FL,32816,6048.18,0
2027-05-18,16:07:00,Magic the Gathering,-602.81,Honolulu HI,85886,5445.37,1
2027-05-18,10:18:00,Whole Foods,-194.46,Oviedo FL,32765,5853.72,0
2027-05-19,13:10:00,McDonald's,-35.63,Oviedo FL,32765,5818.09,0
2027-05-19,11:04:00,Publix,-96.15,Orlando FL,32816,5721.94,0
2027-05-19,16:15:00,Exxon,-10.02,Winter Park FL,32789,5711.92,0
2027-05-20,08:14:00,Amusement Park,-46.93,Orlando FL,32816,5664.99,0
2027-05-20,13:43:00,Chevron,-15.32,Winter Park FL,32789,5649.67,0
2027-05-20,23:22:00,Servicenow,-160.03,Anchorage AL,41875,5489.64,1
2027-05-21,14:03:00,Chevron,-19.41,Oviedo FL,32765,5630.26,0
2027-05-22,03:06:00,Impractical Jokers,-2745.4,New York NY,80047,2884.86,1
2027-05-22,20:47:00,Walmart,-86.84,Orlando FL,32816,5543.42,0
2027-05-22,17:35:00,BP,-19.26,Orlando FL,32816,5524.16,0
2027-05-22,20:45:00,Whole Foods,-82.41,Orlando FL,32816,5441.75,0
2027-05-24,17:10:00,Subway,-39.82,Orlando FL,32816,5401.93,0
2027-05-24,07:03:00,Magic the Gathering,-2284.32,Los Angeles CA,85151,3117.61,1
2027-05-24,08:52:00,Shell,-11.74,Orlando FL,32816,5390.19,0
2027-05-24,19:04:00,AutoZone,-112.56,Orlando FL,32816,5277.63,0
2027-05-25,17:21:00,Publix,-88.59,Oviedo FL,32765,5189.04,0
2027-05-25,13:27:00,Amazon,-138.7,Winter Park FL,32789,5050.34,0
2027-05-27,06:28:00,Fraud,-718.64,New York NY,63964,4331.7,1
2027-05-27,21:47:00,Amazon,-56.25,Winter Park FL,32789,4994.09,0
2027-05-29,11:24:00,Walgreens,-32.36,Orlando FL,32816,4961.73,0
2027-05-31,08:00:00,Paycheck,2000.0,Oviedo FL,32765,6961.73,0
2027-05-31,10:55:00,Walgreens,-92.07,Orlando FL,32816,6869.66,0
2027-05-31,02:47:00,Monster Energy,-1211.91,Honolulu HI,33969,5657.75,1
2027-05-31,08:07:00,Subway,-30.12,Oviedo FL,32765,6839.54,0
2027-05-31,22:03:00,Monster Energy,-528.54,Pyongyang NK,26220,6311.0,1
2027-05-31,19:18:00,Starbucks,-38.2,Orlando FL,32816,6801.34,0
2027-06-01,09:00:00,Rent,-960.0,Oviedo FL,32765,5841.34,0
2027-06-01,09:00:00,Insurance,-197.46,Oviedo FL,32765,5643.88,0
2027-06-01,09:00:00,Car,-300.0,Oviedo FL,32765,5343.88,0
2027-06-01,14:54:00,Publix,-71.27,Orlando FL,32816,5272.61,0
2027-06-03,13:52:00,McDonald's,-28.97,Orlando FL,32816,5243.64,0
2027-06-03,19:56:00,Monster Energy,-2032.95,Pyongyang NK,49817,3210.69,1
2027-06-03,19:56:00,Jiffy Lube,-165.38,Oviedo FL,32765,5078.26,0
2027-06-03,20:56:00,McDonald's,-16.86,Winter Park FL,32789,5061.4,0
2027-06-07,09:00:00,Spotify,-11.99,Oviedo FL,32765,5049.41,0
2027-06-07,09:00:00,Internet,-70.89,Oviedo FL,32765,4978.52,0
2027-06-07,09:00:00,ChatGPT Plus,-20.0,Oviedo FL,32765,4958.52,0
2027-06-07,15:04:00,IBM,-2184.02,Los Angeles CA,94803,2774.5,1
2027-06-07,11:53:00,McDonald's,-9.37,Winter Park FL,32789,4949.15,0
2027-06-07,16:26:00,Subway,-24.33,Orlando FL,32816,4924.82,0
2027-06-08,17:39:00,McDonald's,-29.69,Orlando FL,32816,4895.13,0
2027-06-09,17:50:00,AutoZone,-79.97,Oviedo FL,32765,4815.16,0
2027-06-09,09:19:00,Shell,-20.24,Orlando FL,32816,4794.92,0
2027-06-10,19:40:00,Target,-31.64,Orlando FL,32816,4763.28,0
2027-06-11,10:10:00,Walgreens,-33.05,Orlando FL,32816,4730.23,0
2027-06-11,17:20:00,Trader Joe's,-64.8,Oviedo FL,32765,4665.43,0
2027-06-12,08:55:00,Publix,-43.97,Winter Park FL,32789,4621.46,0
2027-06-12,15:40:00,Chevron,-26.22,Winter Park FL,32789,4595.24,0
2027-06-12,09:34:00,Amazon,-46.45,Orlando FL,32816,4548.79,0
2027-06-14,08:00:00,Paycheck,2000.0,Oviedo FL,32765,6548.79,0
2027-06-15,13:17:00,Concert Tickets,-78.65,Winter Park FL,32789,6470.14,0
2027-06-16,15:52:00,Dollar Tree,-96.24,Oviedo FL,32765,6373.9,0
2027-06-16,08:42:00,Starbucks,-42.96,Oviedo FL,32765,6330.94,0
2027-06-17,19:32:00,Lockheed Martin,-329.62,Anchorage AL,98432,6001.32,1
2027-06-17,12:41:00,Subway,-69.11,Winter Park FL,32789,6261.83,0
2027-06-17,13:01:00,Magic the Gathering,-999.15,Honolulu HI,16019,5262.68,1
2027-06-18,18:43:00,Chevron,-44.87,Oviedo FL,32765,6216.96,0
2027-06-22,10:07:00,Movie Theater,-104.09,Oviedo FL,32765,6112.87,0
2027-06-22,16:09:00,BP,-40.25,Orlando FL,32816,6072.62,0
2027-06-25,18:27:00,Concert Tickets,-105.91,Oviedo FL,32765,5966.71,0
2027-06-25,06:58:00,Impractical Jokers,-1508.39,Groton CT,62654,4458.32,1
2027-06-25,21:26:00,Walgreens,-42.72,Oviedo FL,32765,5923.99,0
2027-06-25,14:52:00,Subway,-16.34,Winter Park FL,32789,5907.65,0
2027-06-26,11:51:00,Whole Foods,-86.31,Oviedo FL,32765,5821.34,0
2027-06-26,10:25:00,CVS,-21.04,Winter Park FL,32789,5800.3,0
2027-06-27,13:49:00,Burger King,-16.11,Winter Park FL,32789,5784.19,0
2027-06-27,10:28:00,Amusement Park,-49.19,Oviedo FL,32765,5735.0,0
2027-06-28,08:00:00,Paycheck,2000.0,Oviedo FL,32765,7735.0,0
2027-06-30,10:09:00,Starbucks,-27.82,Oviedo FL,32765,7707.18,0
2027-06-30,20:01:00,Dollar Tree,-78.31,Oviedo FL,32765,7628.87,0
2027-07-01,09:00:00,Rent,-960.0,Oviedo FL,32765,6668.87,0
2027-07-01,09:00:00,Insurance,-197.46,Oviedo FL,32765,6471.41,0
2027-07-01,09:00:00,Car,-300.0,Oviedo FL,32765,6171.41,0
2027-07-01,14:16:00,Burger King,-32.24,Winter Park FL,32789,6139.17,0
2027-07-01,09:23:00,Target,-218.99,Winter Park FL,32789,5920.18,0
2027-07-02,14:49:00,Midas,-68.89,Oviedo FL,32765,5851.29,0
2027-07-02,20:13:00,Burger King,-24.73,Oviedo FL,32765,5826.56,0
2027-07-03,18:35:00,Amusement Park,-21.9,Orlando FL,32816,5804.66,0
2027-07-03,08:47:00,Amazon,-128.46,Winter Park FL,32789,5676.2,0
2027-07-03,09:34:00,Walmart,-129.84,Orlando FL,32816,5546.36,0
2027-07-05,11:46:00,Jiffy Lube,-111.69,Orlando FL,32816,5434.67,0
2027-07-06,09:32:00,Burger King,-22.91,Oviedo FL,32765,5411.76,0
2027-07-07,09:00:00,Spotify,-11.99,Oviedo FL,32765,5399.77,0
2027-07-07,09:00:00,Internet,-70.89,Oviedo FL,32765,5328.88,0
2027-07-07,09:00:00,ChatGPT Plus,-20.0,Oviedo FL,32765,5308.88,0
2027-07-07,14:44:00,Burger King,-20.49,Orlando FL,32816,5288.39,0
2027-07-07,11:46:00,Shell,-15.74,Orlando FL,32816,5272.65,0
2027-07-07,19:04:00,Netflix,-54.73,Orlando FL,32816,5217.92,0
2027-07-08,11:16:00,Five Below,-32.38,Winter Park FL,32789,5185.54,0
2027-07-08,02:37:00,Magic the Gathering,-2836.54,Groton CT,27562,2349.0,1
2027-07-08,09:48:00,Midas,-151.36,Oviedo FL,32765,5034.18,0
2027-07-09,08:57:00,Pawn Stars,-2065.44,Anchorage AL,95018,2968.74,1
2027-07-10,19:12:00,Movie Theater,-16.35,Orlando FL,32816,5017.83,0
2027-07-11,19:07:00,McDonald's,-25.12,Orlando FL,32816,4992.71,0
2027-07-11,17:19:00,Subway,-10.28,Winter Park FL,32789,4982.43,0
2027-07-11,10:18:00,Starbucks,-27.1,Oviedo FL,32765,4955.33,0
2027-07-12,08:00:00,Paycheck,2000.0,Oviedo FL,32765,6955.33,0
2027-07-12,19:49:00,Five Below,-82.78,Winter Park FL,32789,6872.55,0
2027-07-13,17:41:00,Concert Tickets,-74.73,Orlando FL,32816,6797.82,0
2027-07-13,17:34:00,Subway,-16.8,Oviedo FL,32765,6781.02,0
2027-07-13,13:36:00,Amusement Park,-26.44,Orlando FL,32816,6754.58,0
2027-07-15,08:00:00,Starbucks,-72.26,Winter Park FL,32789,6682.32,0
2027-07-16,13:37:00,Subway,-67.61,Oviedo FL,32765,6614.71,0
2027-07-16,11:30:00,Movie Theater,-43.71,Orlando FL,32816,6571.0,0
2027-07-17,16:08:00,McDonald's,-10.37,Oviedo FL,32765,6560.63,0
2027-07-17,10:10:00,Midas,-256.92,Oviedo FL,32765,6303.71,0
2027-07-19,17:53:00,Whole Foods,-87.32,Oviedo FL,32765,6216.39,0
2027-07-19,16:05:00,Chevron,-48.39,Winter Park FL,32789,6168.0,0
2027-07-20,19:34:00,McDonald's,-49.69,Oviedo FL,32765,6118.31,0
2027-07-20,00:43:00,Accelerators,-2663.57,Tokyo JP,67840,3454.74,1
2027-07-20,14:09:00,McDonald's,-59.06,Winter Park FL,32789,6059.25,0
2027-07-20,12:19:00,Walmart,-201.54,Winter Park FL,32789,5857.71,0
2027-07-21,14:02:00,Burger King,-10.71,Orlando FL,32816,5847.0,0
2027-07-21,10:45:00,Subway,-17.4,Winter Park FL,32789,5829.6,0
2027-07-23,16:38:00,Exxon,-21.28,Winter Park FL,32789,5808.32,0
2027-07-23,19:11:00,McDonald's,-17.31,Oviedo FL,32765,5791.01,0
2027-07-23,15:52:00,Subway,-24.14,Orlando FL,32816,5766.87,0
2027-07-24,21:20:00,Shell,-21.66,Winter Park FL,32789,5745.21,0
2027-07-24,11:17:00,Starbucks,-13.69,Orlando FL,32816,5731.52,0
2027-07-25,21:06:00,Midas,-149.53,Orlando FL,32816,5581.99,0
2027-07-26,08:00:00,Paycheck,2000.0,Oviedo FL,32765,7581.99,0
2027-07-26,15:22:00,Burger King,-33.36,Orlando FL,32816,7548.63,0
2027-07-26,17:27:00,Starbucks,-48.61,Oviedo FL,32765,7500.02,0
2027-07-27,15:16:00,Pawn Stars,-2427.59,Groton CT,25856,5072.43,1
2027-07-27,20:44:00,Best Buy,-235.36,Oviedo FL,32765,7264.66,0
2027-07-27,12:35:00,Five Below,-56.93,Orlando FL,32816,7207.73,0
2027-07-27,09:02:00,CVS,-17.25,Orlando FL,32816,7190.48,0
2027-07-29,05:12:00,Fraud,-1705.98,New York NY,89363,5484.5,1
2027-07-29,10:35:00,Starbucks,-27.86,Oviedo FL,32765,7162.62,0
2027-07-30,14:38:00,Concert Tickets,-67.71,Winter Park FL,32789,7094.91,0
2027-07-30,09:05:00,Subway,-57.44,Winter Park FL,32789,7037.47,0
2027-07-30,18:57:00,IBM,-1485.47,Charleston SC,42318,5552.0,1
2027-07-30,13:07:00,Subway,-33.15,Orlando FL,32816,7004.32,0
2027-07-31,18:18:00,Exxon,-52.47,Orlando FL,32816,6951.85,0
2027-07-31,18:10:00,Burger King,-20.89,Orlando FL,32816,6930.96,0
2027-08-01,09:00:00,Rent,-960.0,Oviedo FL,32765,5970.96,0
2027-08-01,09:00:00,Insurance,-197.46,Oviedo FL,32765,5773.5,0
2027-08-01,09:00:00,Car,-300.0,Oviedo FL,32765,5473.5,0
2027-08-01,14:11:00,Jiffy Lube,-131.09,Oviedo FL,32765,5342.41,0
2027-08-02,12:01:00,Netflix,-26.66,Oviedo FL,32765,5315.75,0
2027-08-03,19:13:00,Target,-118.22,Oviedo FL,32765,5197.53,0
2027-08-03,10:47:00,Exxon,-22.2,Orlando FL,32816,5175.33,0
2027-08-03,13:53:00,McDonald's,-14.37,Winter Park FL,32789,5160.96,0
2027-08-04,09:31:00,Jiffy Lube,-165.75,Orlando FL,32816,4995.21,0
2027-08-04,12:13:00,Subway,-7.41,Orlando FL,32816,4987.8,0
2027-08-05,15:18:00,Fraud,-1977.9,London EN,98369,3009.9,1
2027-08-05,13:12:00,Target,-46.88,Oviedo FL,32765,4940.92,0
2027-08-05,06:45:00,Lockheed Martin,-561.17,Pittsburgh PA,72711,4379.75,1
2027-08-05,19:43:00,Starbucks,-36.53,Oviedo FL,32765,4904.39,0
2027-08-06,11:11:00,Starbucks,-29.05,Orlando FL,32816,4875.34,0
2027-08-06,17:23:00,Servicenow,-1527.17,New York NY,90933,3348.17,1
2027-08-06,20:19:00,Dollar Tree,-41.74,Oviedo FL,32765,4833.6,0
2027-08-06,14:40:00,Chevron,-24.14,Oviedo FL,32765,4809.46,0
2027-08-07,09:00:00,Spotify,-11.99,Oviedo FL,32765,4797.47,0
2027-08-07,09:00:00,Internet,-70.89,Oviedo FL,32765,4726.58,0
2027-08-07,09:00:00,ChatGPT Plus,-20.0,Oviedo FL,32765,4706.58,0
2027-08-07,01:21:00,Fat Joe,-2446.59,Charleston SC,56637,2259.99,1
2027-08-07,09:21:00,Best Buy,-63.02,Orlando FL,32816,4643.56,0
2027-08-07,19:35:00,Concert Tickets,-43.24,Orlando FL,32816,4600.32,0
2027-08-08,18:53:00,Netflix,-12.41,Orlando FL,32816,4587.91,0
2027-08-08,09:47:00,Amazon,-49.87,Orlando FL,32816,4538.04,0
2027-08-08,09:21:00,Jiffy Lube,-76.79,Winter Park FL,32789,4461.25,0
2027-08-09,08:00:00,Paycheck,2000.0,Oviedo FL,32765,6461.25,0
2027-08-10,09:02:00,Starbucks,-9.88,Orlando FL,32816,6451.37,0
2027-08-10,16:55:00,CVS,-16.86,Oviedo FL,32765,6434.51,0
2027-08-10,15:05:00,Kroger,-165.48,Oviedo FL,32765,6269.03,0
2027-08-11,18:12:00,Shell,-33.7,Oviedo FL,32765,6235.33,0
2027-08-14,20:14:00,Trader Joe's,-64.56,Winter Park FL,32789,6170.77,0
2027-08-14,19:55:00,Walmart,-68.71,Orlando FL,32816,6102.06,0
2027-08-16,16:27:00,Target,-116.34,Orlando FL,32816,5985.72,0
2027-08-16,22:53:00,Fraud,-1429.16,Pyongyang NK,94406,4556.56,1
2027-08-16,15:05:00,Walmart,-27.67,Oviedo FL,32765,5958.05,0
2027-08-19,18:32:00,Five Below,-17.84,Orlando FL,32816,5940.21,0
2027-08-19,13:18:00,McDonald's,-37.84,Orlando FL,32816,5902.37,0
2027-08-19,02:49:00,Pawn Stars,-1232.63,Anchorage AL,76247,4669.74,1
2027-08-20,08:32:00,McDonald's,-17.8,Orlando FL,32816,5884.57,0
2027-08-20,15:57:00,Subway,-19.1,Winter Park FL,32789,5865.47,0
2027-08-20,13:43:00,Best Buy,-141.32,Winter Park FL,32789,5724.15,0
2027-08-23,08:00:00,Paycheck,2000.0,Oviedo FL,32765,7724.15,0
2027-08-23,09:26:00,Burger King,-29.55,Winter Park FL,32789,7694.6,0
2027-08-23,12:59:00,Burger King,-29.47,Oviedo FL,32765,7665.13,0
2027-08-23,21:55:00,CVS,-61.63,Orlando FL,32816,7603.5,0
2027-08-24,16:13:00,Amazon,-140.73,Winter Park FL,32789,7462.77,0
2027-08-24,19:18:00,CVS,-61.63,Orlando FL,32816,7401.14,0
2027-08-24,12:53:00,BP,-29.57,Oviedo FL,32765,7371.57,0
2027-08-25,20:44:00,Shell,-21.6,Winter Park FL,32789,7349.97,0
2027-08-25,15:39:00,AutoZone,-117.74,Winter Park FL,32789,7232.23,0
2027-08-26,16:09:00,Trader Joe's,-171.58,Winter Park FL,32789,7060.65,0
2027-08-26,08:13:00,McDonald's,-48.22,Winter Park FL,32789,7012.43,0
2027-08-27,07:13:00,Accelerators,-502.92,Anchorage AL,38184,6509.51,1
2027-08-28,04:34:00,Accelerators,-240.69,Groton CT,26436,6771.74,1
2027-08-28,16:27:00,Movie Theater,-82.15,Winter Park FL,32789,6930.28,0
2027-08-29,11:28:00,Fraud,-542.06,New York NY,33373,6388.22,1
2027-08-29,21:47:00,Walgreens,-71.21,Oviedo FL,32765,6859.07,0
2027-08-30,09:31:00,Exxon,-56.22,Winter Park FL,32789,6802.85,0
2027-08-30,16:38:00,CVS,-26.66,Winter Park FL,32789,6776.19,0
2027-08-31,20:45:00,McDonald's,-17.06,Oviedo FL,32765,6759.13,0
2027-09-01,09:00:00,Rent,-960.0,Oviedo FL,32765,5799.13,0
2027-09-01,09:00:00,Insurance,-197.46,Oviedo FL,32765,5601.67,0
2027-09-01,09:00:00,Car,-300.0,Oviedo FL,32765,5301.67,0
2027-09-02,09:35:00,Burger King,-38.6,Orlando FL,32816,5263.07,0
2027-09-02,15:18:00,Target,-60.23,Winter Park FL,32789,5202.84,0
2027-09-02,08:40:00,Trader Joe's,-52.3,Oviedo FL,32765,5150.54,0
2027-09-03,09:31:00,McDonald's,-27.11,Winter Park FL,32789,5123.43,0
2027-09-03,13:50:00,Exxon,-24.41,Orlando FL,32816,5099.02,0
2027-09-03,20:31:00,Subway,-14.89,Orlando FL,32816,5084.13,0
2027-09-04,21:53:00,Chevron,-14.19,Oviedo FL,32765,5069.94,0
2027-09-04,12:24:00,Walmart,-32.0,Winter Park FL,32789,5037.94,0
2027-09-04,16:25:00,Target,-98.53,Orlando FL,32816,4939.41,0
2027-09-05,18:34:00,Burger King,-22.21,Winter Park FL,32789,4917.2,0
2027-09-06,08:00:00,Paycheck,2000.0,Oviedo FL,32765,6917.2,0
2027-09-06,21:21:00,Starbucks,-64.41,Orlando FL,32816,6852.79,0
2027-09-06,12:43:00,Starbucks,-34.47,Orlando FL,32816,6818.32,0
2027-09-07,09:00:00,Spotify,-11.99,Oviedo FL,32765,6806.33,0
2027-09-07,09:00:00,Internet,-70.89,Oviedo FL,32765,6735.44,0
2027-09-07,09:00:00,ChatGPT Plus,-20.0,Oviedo FL,32765,6715.44,0
2027-09-07,15:07:00,Exxon,-46.9,Oviedo FL,32765,6668.54,0
2027-09-09,16:35:00,Servicenow,-2575.28,Pyongyang NK,50937,4093.26,1
2027-09-09,08:17:00,McDonald's,-34.21,Oviedo FL,32765,6634.33,0
2027-09-09,11:40:00,Subway,-10.01,Orlando FL,32816,6624.32,0
2027-09-10,17:36:00,McDonald's,-46.54,Winter Park FL,32789,6577.78,0
2027-09-11,08:14:00,Impractical Jokers,-1710.26,Pittsburgh PA,68140,4867.52,1
2027-09-11,15:57:00,Best Buy,-22.52,Winter Park FL,32789,6555.26,0
2027-09-13,15:39:00,McDonald's,-43.2,Oviedo FL,32765,6512.06,0
2027-09-13,14:00:00,Walgreens,-33.38,Orlando FL,32816,6478.68,0
2027-09-14,11:03:00,Jiffy Lube,-281.65,Winter Park FL,32789,6197.03,0
2027-09-14,11:57:00,Amazon,-74.48,Winter Park FL,32789,6122.55,0
2027-09-15,19:55:00,Best Buy,-71.41,Orlando FL,32816,6051.14,0
2027-09-15,13:10:00,Subway,-30.3,Oviedo FL,32765,6020.84,0
2027-09-15,17:44:00,Walgreens,-83.33,Oviedo FL,32765,5937.51,0
2027-09-16,10:34:00,Best Buy,-64.91,Orlando FL,32816,5872.6,0
2027-09-16,10:59:00,Best Buy,-80.13,Orlando FL,32816,5792.47,0
2027-09-16,21:14:00,Target,-53.8,Winter Park FL,32789,5738.67,0
2027-09-18,12:30:00,Walgreens,-6.09,Orlando FL,32816,5732.58,0
2027-09-18,15:48:00,Pep Boys,-54.86,Oviedo FL,32765,5677.72,0
2027-09-19,12:03:00,Movie Theater,-45.91,Orlando FL,32816,5631.81,0
2027-09-20,08:00:00,Paycheck,2000.0,Oviedo FL,32765,7631.81,0
2027-09-21,20:20:00,Chevron,-44.56,Winter Park FL,32789,7587.25,0
2027-09-22,18:42:00,McDonald's,-49.91,Winter Park FL,32789,7537.34,0
2027-09-23,21:43:00,Five Below,-64.52,Orlando FL,32816,7472.82,0
2027-09-23,19:03:00,Subway,-14.03,Oviedo FL,32765,7458.79,0
2027-09-23,08:40:00,Burger King,-69.64,Oviedo FL,32765,7389.15,0
2027-09-25,11:10:00,Dollar Tree,-77.61,Orlando FL,32816,7311.54,0
2027-09-26,19:28:00,Onlyfans,-2551.6,Charleston SC,17871,4759.94,1
2027-09-26,20:13:00,McDonald's,-36.81,Oviedo FL,32765,7274.73,0
2027-09-26,20:45:00,Burger King,-69.09,Orlando FL,32816,7205.64,0
2027-09-27,20:50:00,Burger King,-25.69,Winter Park FL,32789,7179.95,0
2027-09-28,18:12:00,Walmart,-131.43,Orlando FL,32816,7048.52,0
2027-09-28,18:25:00,Walgreens,-61.67,Oviedo FL,32765,6986.85,0
2027-09-29,19:16:00,McDonald's,-19.85,Orlando FL,32816,6967.0,0
2027-09-30,15:13:00,Kroger,-182.05,Orlando FL,32816,6784.95,0
2027-10-01,09:00:00,Rent,-960.0,Oviedo FL,32765,5824.95,0
2027-10-01,09:00:00,Insurance,-197.46,Oviedo FL,32765,5627.49,0
2027-10-01,09:00:00,Car,-300.0,Oviedo FL,32765,5327.49,0
2027-10-01,11:51:00,Best Buy,-126.96,Winter Park FL,32789,5200.53,0
2027-10-01,11:34:00,Publix,-87.95,Oviedo FL,32765,5112.58,0
2027-10-01,17:07:00,Starbucks,-38.02,Orlando FL,32816,5074.56,0
2027-10-01,08:43:00,IBM,-2692.72,Pyongyang NK,23455,2381.84,1
2027-10-02,21:16:00,CVS,-46.21,Winter Park FL,32789,5028.35,0
2027-10-03,20:18:00,Starbucks,-10.54,Oviedo FL,32765,5017.81,0
2027-10-04,08:00:00,Paycheck,2000.0,Oviedo FL,32765,7017.81,0
2027-10-04,12:34:00,McDonald's,-44.97,Winter Park FL,32789,6972.84,0
2027-10-04,20:57:00,Trader Joe's,-105.88,Oviedo FL,32765,6866.96,0
2027-10-04,12:26:00,CVS,-51.05,Winter Park FL,32789,6815.91,0
2027-10-05,21:06:00,Target,-245.7,Winter Park FL,32789,6570.21,0
2027-10-07,09:00:00,Spotify,-11.99,Oviedo FL,32765,6558.22,0
2027-10-07,09:00:00,Internet,-70.89,Oviedo FL,32765,6487.33,0
2027-10-07,09:00:00,ChatGPT Plus,-20.0,Oviedo FL,32765,6467.33,0
2027-10-07,21:19:00,AutoZone,-354.83,Winter Park FL,32789,6112.5,0
2027-10-08,17:34:00,Kroger,-167.04,Oviedo FL,32765,5945.46,0
2027-10-08,13:37:00,Starbucks,-14.53,Orlando FL,32816,5930.93,0
2027-10-08,18:54:00,Walmart,-55.85,Orlando FL,32816,5875.08,0
2027-10-11,14:20:00,Five Below,-31.1,Orlando FL,32816,5843.98,0
2027-10-11,21:42:00,Burger King,-20.34,Orlando FL,32816,5823.64,0
2027-10-11,20:53:00,Fat Joe,-2784.82,Charleston SC,62691,3038.82,1
2027-10-11,12:19:00,Best Buy,-14.79,Winter Park FL,32789,5808.85,0
2027-10-12,23:06:00,Monster Energy,-1656.69,Charleston SC,95217,4152.16,1
2027-10-12,19:46:00,Netflix,-48.62,Oviedo FL,32765,5760.23,0
2027-10-13,15:41:00,Shell,-25.46,Winter Park FL,32789,5734.77,0
2027-10-13,13:27:00,Subway,-8.25,Oviedo FL,32765,5726.52,0
2027-10-13,16:46:00,Onlyfans,-907.47,Anchorage AL,40607,4819.05,1
2027-10-13,19:59:00,Amusement Park,-23.81,Winter Park FL,32789,5702.71,0
2027-10-14,08:08:00,Trader Joe's,-30.94,Winter Park FL,32789,5671.77,0
2027-10-15,21:16:00,Burger King,-13.16,Oviedo FL,32765,5658.61,0
2027-10-15,12:51:00,Starbucks,-38.65,Oviedo FL,32765,5619.96,0
2027-10-16,12:00:00,Accelerators,-1727.67,Los Angeles CA,95171,3892.29,1
2027-10-16,15:40:00,Subway,-23.46,Orlando FL,32816,5596.5,0
2027-10-16,12:38:00,Walmart,-147.09,Winter Park FL,32789,5449.41,0
2027-10-16,19:47:00,Trader Joe's,-93.61,Orlando FL,32816,5355.8,0
2027-10-16,02:21:00,Onlyfans,-282.54,London EN,84664,5073.26,1
2027-10-17,09:40:00,Whole Foods,-40.93,Winter Park FL,32789,5314.87,0
2027-10-18,08:00:00,Paycheck,2000.0,Oviedo FL,32765,7314.87,0
2027-10-20,14:05:00,Trader Joe's,-166.78,Oviedo FL,32765,7148.09,0
2027-10-20,20:52:00,Movie Theater,-105.48,Winter Park FL,32789,7042.61,0
2027-10-20,12:10:00,Burger King,-25.85,Winter Park FL,32789,7016.76,0
2027-10-21,11:19:00,Fat Joe,-1539.8,London EN,14743,5476.96,1
2027-10-21,19:53:00,Midas,-269.51,Oviedo FL,32765,6747.25,0
2027-10-21,10:31:00,Starbucks,-11.55,Oviedo FL,32765,6735.7,0
2027-10-23,11:26:00,Impractical Jokers,-1451.76,Anchorage AL,38416,5283.94,1
2027-10-24,11:32:00,Starbucks,-47.84,Winter Park FL,32789,6687.86,0
2027-10-24,08:08:00,McDonald's,-12.39,Winter Park FL,32789,6675.47,0
2027-10-24,15:58:00,McDonald's,-40.11,Orlando FL,32816,6635.36,0
2027-10-24,20:13:00,Lockheed Martin,-1062.9,Anchorage AL,15282,5572.46,1
2027-10-25,09:54:00,BP,-38.75,Oviedo FL,32765,6596.61,0
2027-10-25,00:21:00,Pawn Stars,-2314.95,London EN,75809,4281.66,1
2027-10-25,08:15:00,Kroger,-131.39,Oviedo FL,32765,6465.22,0
2027-10-25,01:40:00,Servicenow,-174.21,London EN,96789,6291.01,1
2027-10-25,16:52:00,McDonald's,-39.86,Winter Park FL,32789,6425.36,0
2027-10-26,09:30:00,Netflix,-76.92,Oviedo FL,32765,6348.44,0
2027-10-26,19:45:00,Jiffy Lube,-313.14,Winter Park FL,32789,6035.3,0
2027-10-28,08:42:00,Walmart,-291.42,Winter Park FL,32789,5743.88,0
2027-10-28,08:42:00,Starbucks,-12.4,Oviedo FL,32765,5731.48,0
2027-10-28,11:02:00,Subway,-27.62,Orlando FL,32816,5703.86,0
2027-10-28,16:26:00,Paypal,-686.5,Anchorage AL,74176,5017.36,1
2027-10-29,15:40:00,Concert Tickets,-16.51,Winter Park FL,32789,5687.35,0
2027-10-29,19:04:00,Walmart,-115.3,Winter Park FL,32789,5572.05,0
2027-10-30,12:46:00,Starbucks,-26.95,Winter Park FL,32789,5545.1,0
2027-10-30,11:15:00,McDonald's,-36.4,Oviedo FL,32765,5508.7,0
2027-10-30,16:49:00,BP,-20.81,Winter Park FL,32789,5487.89,0
2027-10-31,08:13:00,Publix,-79.54,Winter Park FL,32789,5408.35,0
2027-11-01,08:00:00,Paycheck,2000.0,Oviedo FL,32765,7408.35,0
2027-11-01,09:00:00,Rent,-960.0,Oviedo FL,32765,6448.35,0
2027-11-01,09:00:00,Insurance,-197.46,Oviedo FL,32765,6250.89,0
2027-11-01,09:00:00,Car,-300.0,Oviedo FL,32765,5950.89,0
2027-11-02,12:54:00,Pep Boys,-142.07,Winter Park FL,32789,5808.82,0
2027-11-03,21:24:00,Starbucks,-10.55,Oviedo FL,32765,5798.27,0
2027-11-03,14:34:00,Amazon,-25.8,Oviedo FL,32765,5772.47,0
2027-11-03,18:15:00,Subway,-17.02,Winter Park FL,32789,5755.45,0
2027-11-04,10:48:00,Subway,-28.9,Winter Park FL,32789,5726.55,0
2027-11-05,09:17:00,Subway,-6.09,Orlando FL,32816,5720.46,0
2027-11-05,13:36:00,McDonald's,-10.37,Winter Park FL,32789,5710.09,0
2027-11-06,19:46:00,Jiffy Lube,-89.97,Winter Park FL,32789,5620.12,0
2027-11-06,08:28:00,McDonald's,-21.87,Oviedo FL,32765,5598.25,0
2027-11-07,09:00:00,Spotify,-11.99,Oviedo FL,32765,5586.26,0
2027-11-07,09:00:00,Internet,-70.89,Oviedo FL,32765,5515.37,0
2027-11-07,09:00:00,ChatGPT Plus,-20.0,Oviedo FL,32765,5495.37,0
2027-11-07,20:04:00,McDonald's,-11.75,Orlando FL,32816,5483.62,0
2027-11-09,03:18:00,Fraud,-1213.99,Los Angeles CA,11452,4269.63,1
2027-11-09,11:53:00,Whole Foods,-64.23,Oviedo FL,32765,5419.39,0
2027-11-09,12:36:00,AutoZone,-146.48,Oviedo FL,32765,5272.91,0
2027-11-09,09:37:00,Chevron,-16.47,Winter Park FL,32789,5256.44,0
2027-11-10,18:59:00,Fat Joe,-1147.35,Mexico City MC,30270,4109.09,1
2027-11-10,13:28:00,McDonald's,-6.55,Oviedo FL,32765,5249.89,0
2027-11-10,20:47:00,Kroger,-98.9,Oviedo FL,32765,5150.99,0
2027-11-10,17:23:00,McDonald's,-9.22,Oviedo FL,32765,5141.77,0
2027-11-12,08:08:00,Kroger,-77.7,Winter Park FL,32789,5064.07,0
2027-11-12,08:17:00,Subway,-28.23,Winter Park FL,32789,5035.84,0
2027-11-12,19:12:00,Impractical Jokers,-2746.99,Charleston SC,58391,2288.85,1
2027-11-13,11:03:00,Lockheed Martin,-516.11,Pittsburgh PA,64927,4519.73,1
2027-11-13,11:02:00,Subway,-9.34,Oviedo FL,32765,5026.5,0
2027-11-15,08:00:00,Paycheck,2000.0,Oviedo FL,32765,7026.5,0
2027-11-16,13:24:00,Trader Joe's,-191.84,Oviedo FL,32765,6834.66,0
2027-11-16,12:01:00,Burger King,-62.71,Winter Park FL,32789,6771.95,0
2027-11-17,21:52:00,BP,-20.91,Oviedo FL,32765,6751.04,0
2027-11-17,17:43:00,Exxon,-49.51,Oviedo FL,32765,6701.53,0
2027-11-18,10:46:00,Starbucks,-59.39,Oviedo FL,32765,6642.14,0
2027-11-18,09:29:00,Netflix,-33.32,Winter Park FL,32789,6608.82,0
2027-11-18,12:52:00,Kroger,-165.64,Orlando FL,32816,6443.18,0
2027-11-19,13:21:00,Midas,-193.99,Winter Park FL,32789,6249.19,0
2027-11-19,19:41:00,Kroger,-115.34,Oviedo FL,32765,6133.85,0
2027-11-20,18:05:00,AutoZone,-303.52,Orlando FL,32816,5830.33,0
2027-11-20,08:23:00,Amazon,-32.45,Oviedo FL,32765,5797.88,0
2027-11-21,13:43:00,McDonald's,-20.4,Winter Park FL,32789,5777.48,0
2027-11-21,15:43:00,Subway,-26.36,Winter Park FL,32789,5751.12,0
2027-11-21,14:34:00,Starbucks,-17.04,Winter Park FL,32789,5734.08,0
2027-11-22,19:39:00,Amusement Park,-38.39,Winter Park FL,32789,5695.69,0
2027-11-22,13:52:00,Concert Tickets,-48.65,Winter Park FL,32789,5647.04,0
2027-11-22,20:05:00,Trader Joe's,-70.17,Winter Park FL,32789,5576.87,0
2027-11-23,09:42:00,Walgreens,-36.03,Oviedo FL,32765,5540.84,0
2027-11-24,12:46:00,Movie Theater,-12.65,Orlando FL,32816,5528.19,0
2027-11-24,15:24:00,Shell,-15.59,Winter Park FL,32789,5512.6,0
2027-11-24,14:42:00,Whole Foods,-45.9,Oviedo FL,32765,5466.7,0
2027-11-24,08:45:00,IBM,-2679.36,Pittsburgh PA,11896,2787.34,1
2027-11-25,14:23:00,Walgreens,-26.04,Orlando FL,32816,5440.66,0
2027-11-25,20:16:00,McDonald's,-6.85,Orlando FL,32816,5433.81,0
2027-11-27,22:28:00,Impractical Jokers,-1432.18,New York NY,37627,4001.63,1
2027-11-27,09:29:00,Kroger,-61.87,Oviedo FL,32765,5371.94,0
2027-11-27,12:16:00,Starbucks,-32.48,Orlando FL,32816,5339.46,0
2027-11-27,08:41:00,Subway,-20.98,Orlando FL,32816,5318.48,0
2027-11-28,13:27:00,Amazon,-85.81,Orlando FL,32816,5232.67,0
2027-11-28,08:11:00,CVS,-23.0,Oviedo FL,32765,5209.67,0
2027-11-28,10:18:00,Movie Theater,-16.51,Oviedo FL,32765,5193.16,0
2027-11-29,08:00:00,Paycheck,2000.0,Oviedo FL,32765,7193.16,0
2027-11-30,16:51:00,Accelerators,-483.49,Anchorage AL,99740,6709.67,1
2027-11-30,21:32:00,Trader Joe's,-79.5,Orlando FL,32816,7113.66,0
2027-12-01,09:00:00,Rent,-960.0,Oviedo FL,32765,6153.66,0
2027-12-01,09:00:00,Insurance,-197.46,Oviedo FL,32765,5956.2,0
2027-12-01,09:00:00,Car,-300.0,Oviedo FL,32765,5656.2,0
2027-12-01,12:06:00,Walgreens,-25.92,Oviedo FL,32765,5630.28,0
2027-12-01,09:38:00,Target,-54.3,Winter Park FL,32789,5575.98,0
2027-12-01,14:52:00,Burger King,-13.71,Orlando FL,32816,5562.27,0
2027-12-02,08:30:00,McDonald's,-11.06,Oviedo FL,32765,5551.21,0
2027-12-02,08:01:00,Kroger,-62.14,Oviedo FL,32765,5489.07,0
2027-12-03,21:21:00,Burger King,-14.39,Winter Park FL,32789,5474.68,0
2027-12-05,09:06:00,Trader Joe's,-57.81,Orlando FL,32816,5416.87,0
2027-12-05,19:50:00,Monster Energy,-2660.38,Pyongyang NK,57455,2756.49,1
2027-12-05,14:27:00,Shell,-19.08,Winter Park FL,32789,5397.79,0
2027-12-05,09:39:00,Target,-89.07,Orlando FL,32816,5308.72,0
2027-12-05,16:37:00,Accelerators,-284.21,Tokyo JP,84796,5024.51,1
2027-12-06,18:50:00,McDonald's,-20.57,Winter Park FL,32789,5288.15,0
2027-12-06,18:04:00,Whole Foods,-72.94,Winter Park FL,32789,5215.21,0
2027-12-06,21:39:00,Dollar Tree,-49.45,Orlando FL,32816,5165.76,0
2027-12-07,09:00:00,Spotify,-11.99,Oviedo FL,32765,5153.77,0
2027-12-07,09:00:00,Internet,-70.89,Oviedo FL,32765,5082.88,0
2027-12-07,09:00:00,ChatGPT Plus,-20.0,Oviedo FL,32765,5062.88,0
2027-12-07,19:36:00,Amusement Park,-13.65,Orlando FL,32816,5049.23,0
2027-12-07,10:44:00,Starbucks,-9.75,Winter Park FL,32789,5039.48,0
2027-12-07,16:04:00,Trader Joe's,-90.91,Orlando FL,32816,4948.57,0
2027-12-09,19:29:00,Lockheed Martin,-1262.68,Pyongyang NK,86107,3685.89,1
2027-12-09,11:10:00,Starbucks,-8.99,Winter Park FL,32789,4939.58,0
2027-12-10,08:35:00,Subway,-27.06,Oviedo FL,32765,4912.52,0
2027-12-10,17:36:00,BP,-28.76,Winter Park FL,32789,4883.76,0
2027-12-10,10:18:00,Subway,-34.59,Oviedo FL,32765,4849.17,0
2027-12-11,06:44:00,Impractical Jokers,-2550.02,Pittsburgh PA,76015,2299.15,1
2027-12-11,10:40:00,Kroger,-37.35,Orlando FL,32816,4811.82,0
2027-12-11,21:12:00,Concert Tickets,-11.57,Orlando FL,32816,4800.25,0
2027-12-13,08:00:00,Paycheck,2000.0,Oviedo FL,32765,6800.25,0
2027-12-13,22:15:00,Magic the Gathering,-575.71,Los Angeles CA,90039,6224.54,1
2027-12-13,14:56:00,Exxon,-34.29,Oviedo FL,32765,6765.96,0
2027-12-13,16:32:00,Lockheed Martin,-2160.36,Tokyo JP,80445,4605.6,1
2027-12-14,15:11:00,Trader Joe's,-142.76,Winter Park FL,32789,6623.2,0
2027-12-14,19:13:00,Amusement Park,-48.37,Oviedo FL,32765,6574.83,0
2027-12-14,11:11:00,Starbucks,-18.08,Orlando FL,32816,6556.75,0
2027-12-15,03:56:00,Lockheed Martin,-644.46,Los Angeles CA,79272,5912.29,1
2027-12-16,16:14:00,Netflix,-62.71,Orlando FL,32816,6494.04,0
2027-12-16,11:10:00,Kroger,-59.06,Orlando FL,32816,6434.98,0
2027-12-18,21:03:00,Amazon,-241.42,Oviedo FL,32765,6193.56,0
2027-12-18,13:08:00,Pep Boys,-175.4,Oviedo FL,32765,6018.16,0
2027-12-19,16:23:00,McDonald's,-39.97,Oviedo FL,32765,5978.19,0
2027-12-19,18:59:00,Subway,-18.47,Winter Park FL,32789,5959.72,0
2027-12-19,20:50:00,Five Below,-46.41,Winter Park FL,32789,5913.31,0
2027-12-21,14:23:00,McDonald's,-33.72,Oviedo FL,32765,5879.59,0
2027-12-22,11:15:00,McDonald's,-8.24,Oviedo FL,32765,5871.35,0
2027-12-22,12:36:00,Starbucks,-11.72,Orlando FL,32816,5859.63,0
2027-12-22,13:28:00,Subway,-13.47,Orlando FL,32816,5846.16,0
2027-12-23,20:40:00,Target,-29.54,Orlando FL,32816,5816.62,0
2027-12-23,12:27:00,CVS,-43.76,Winter Park FL,32789,5772.86,0
2027-12-24,08:11:00,Five Below,-36.04,Orlando FL,32816,5736.82,0
2027-12-24,13:54:00,Amusement Park,-21.38,Winter Park FL,32789,5715.44,0
2027-12-24,20:44:00,Shell,-21.95,Winter Park FL,32789,5693.49,0
2027-12-25,10:31:00,Starbucks,-38.93,Oviedo FL,32765,5654.56,0
2027-12-25,18:49:00,Monster Energy,-1427.18,London EN,68192,4227.38,1
2027-12-25,10:26:00,Trader Joe's,-72.51,Orlando FL,32816,5582.05,0
2027-12-26,09:21:00,Amusement Park,-47.7,Oviedo FL,32765,5534.35,0
2027-12-26,15:11:00,Accelerators,-2752.77,Groton CT,68336,2781.58,1
2027-12-26,21:42:00,Walgreens,-42.73,Orlando FL,32816,5491.62,0
2027-12-27,08:00:00,Paycheck,2000.0,Oviedo FL,32765,7491.62,0
2027-12-28,17:46:00,Walmart,-113.33,Oviedo FL,32765,7378.29,0
2027-12-28,13:09:00,Magic the Gathering,-510.74,Tokyo JP,71545,6867.55,1
2027-12-28,10:16:00,Chevron,-23.41,Orlando FL,32816,7354.88,0
2027-12-30,20:14:00,Amusement Park,-108.35,Winter Park FL,32789,7246.53,0
2027-12-31,21:05:00,Concert Tickets,-27.32,Winter Park FL,32789,7219.21,0
2027-12-31,16:04:00,Target,-166.03,Winter Park FL,32789,7053.18,0
2028-01-01,09:00:00,Rent,-960.0,Oviedo FL,32765,6093.18,0
2028-01-01,09:00:00,Insurance,-197.46,Oviedo FL,32765,5895.72,0
2028-01-01,09:00:00,Car,-300.0,Oviedo FL,32765,5595.72,0
2028-01-03,09:31:00,Subway,-37.76,Oviedo FL,32765,5557.96,0
2028-01-04,14:31:00,Starbucks,-9.93,Winter Park FL,32789,5548.03,0
2028-01-04,18:47:00,Publix,-83.54,Oviedo FL,32765,5464.49,0
2028-01-05,09:21:00,Dollar Tree,-22.15,Winter Park FL,32789,5442.34,0
2028-01-05,14:19:00,Best Buy,-22.83,Oviedo FL,32765,5419.51,0
2028-01-05,13:51:00,Impractical Jokers,-240.51,Charleston SC,61762,5179.0,1
2028-01-06,09:18:00,Starbucks,-24.23,Winter Park FL,32789,5395.28,0
2028-01-07,09:00:00,Spotify,-11.99,Oviedo FL,32765,5383.29,0
2028-01-07,09:00:00,Internet,-70.89,Oviedo FL,32765,5312.4,0
2028-01-07,09:00:00,ChatGPT Plus,-20.0,Oviedo FL,32765,5292.4,0
2028-01-07,22:02:00,Fat Joe,-1470.9,Pyongyang NK,71590,3821.5,1
2028-01-07,17:57:00,Amazon,-20.9,Winter Park FL,32789,5271.5,0
2028-01-08,15:45:00,Publix,-58.45,Winter Park FL,32789,5213.05,0
2028-01-08,16:17:00,Five Below,-21.06,Winter Park FL,32789,5191.99,0
2028-01-08,19:17:00,Exxon,-29.48,Orlando FL,32816,5162.51,0
2028-01-09,08:46:00,Walmart,-109.81,Oviedo FL,32765,5052.7,0
2028-01-10,08:00:00,Paycheck,2000.0,Oviedo FL,32765,7052.7,0
2028-01-10,19:14:00,Kroger,-140.14,Orlando FL,32816,6912.56,0
2028-01-10,13:05:00,Burger King,-24.79,Orlando FL,32816,6887.77,0
2028-01-11,12:41:00,Fat Joe,-1862.32,New York NY,43486,5025.45,1
2028-01-11,18:06:00,BP,-40.8,Oviedo FL,32765,6846.97,0
2028-01-11,19:03:00,AutoZone,-344.24,Oviedo FL,32765,6502.73,0
2028-01-11,17:25:00,Movie Theater,-115.18,Winter Park FL,32789,6387.55,0
2028-01-12,11:32:00,Five Below,-57.46,Winter Park FL,32789,6330.09,0
2028-01-12,13:44:00,BP,-43.55,Oviedo FL,32765,6286.54,0
2028-01-12,15:06:00,Movie Theater,-93.09,Orlando FL,32816,6193.45,0
2028-01-13,08:34:00,Starbucks,-66.83,Orlando FL,32816,6126.62,0
2028-01-16,21:17:00,Exxon,-40.39,Oviedo FL,32765,6086.23,0
2028-01-16,08:25:00,BP,-51.84,Orlando FL,32816,6034.39,0
2028-01-19,09:40:00,Trader Joe's,-71.92,Oviedo FL,32765,5962.47,0
2028-01-19,10:54:00,Trader Joe's,-55.09,Oviedo FL,32765,5907.38,0
2028-01-19,21:19:00,Starbucks,-21.42,Winter Park FL,32789,5885.96,0
2028-01-20,16:40:00,Shell,-14.13,Oviedo FL,32765,5871.83,0
2028-01-20,09:14:00,Five Below,-11.15,Winter Park FL,32789,5860.68,0
2028-01-21,21:47:00,Subway,-8.09,Orlando FL,32816,5852.59,0
2028-01-22,17:00:00,Target,-29.37,Oviedo FL,32765,5823.22,0
2028-01-22,21:54:00,Kroger,-75.03,Winter Park FL,32789,5748.19,0
2028-01-22,10:45:00,BP,-10.08,Winter Park FL,32789,5738.11,0
2028-01-23,09:30:00,Concert Tickets,-28.18,Orlando FL,32816,5709.93,0
2028-01-24,08:00:00,Paycheck,2000.0,Oviedo FL,32765,7709.93,0
2028-01-24,21:38:00,Movie Theater,-100.17,Orlando FL,32816,7609.76,0
2028-01-25,08:49:00,McDonald's,-42.14,Oviedo FL,32765,7567.62,0
2028-01-25,04:40:00,Magic the Gathering,-2990.34,New York NY,79143,4577.28,1
2028-01-25,18:35:00,Subway,-62.46,Orlando FL,32816,7505.16,0
2028-01-26,20:17:00,Accelerators,-762.99,Groton CT,75118,6742.17,1
2028-01-26,16:25:00,CVS,-15.84,Oviedo FL,32765,7489.32,0
2028-01-26,23:28:00,Servicenow,-1468.57,Pyongyang NK,36038,6020.75,1
2028-01-26,18:33:00,Publix,-189.54,Winter Park FL,32789,7299.78,0
2028-01-27,12:54:00,Amazon,-200.97,Orlando FL,32816,7098.81,0
2028-01-27,09:55:00,AutoZone,-172.76,Oviedo FL,32765,6926.05,0
2028-01-28,08:12:00,Starbucks,-45.4,Orlando FL,32816,6880.65,0
2028-01-29,16:58:00,Starbucks,-32.09,Oviedo FL,32765,6848.56,0
2028-01-29,20:57:00,McDonald's,-69.5,Oviedo FL,32765,6779.06,0
2028-01-30,13:55:00,Subway,-41.96,Winter Park FL,32789,6737.1,0
2028-02-01,09:00:00,Rent,-960.0,Oviedo FL,32765,5777.1,0
2028-02-01,09:00:00,Insurance,-197.46,Oviedo FL,32765,5579.64,0
2028-02-01,09:00:00,Car,-300.0,Oviedo FL,32765,5279.64,0
2028-02-01,19:36:00,Subway,-34.97,Oviedo FL,32765,5244.67,0
2028-02-01,18:51:00,Subway,-8.09,Winter Park FL,32789,5236.58,0
2028-02-01,09:37:00,Five Below,-44.98,Winter Park FL,32789,5191.6,0
2028-02-02,12:01:00,Pep Boys,-178.13,Oviedo FL,32765,5013.47,0
2028-02-02,12:12:00,Dollar Tree,-32.75,Winter Park FL,32789,4980.72,0
2028-02-04,17:51:00,Fat Joe,-1864.4,Pittsburgh PA,76146,3116.32,1
2028-02-05,10:57:00,Starbucks,-25.05,Winter Park FL,32789,4955.67,0
2028-02-05,08:27:00,McDonald's,-26.63,Winter Park FL,32789,4929.04,0
2028-02-06,17:49:00,Trader Joe's,-46.24,Winter Park FL,32789,4882.8,0
2028-02-06,09:24:00,Subway,-7.94,Orlando FL,32816,4874.86,0
2028-02-06,19:39:00,Five Below,-16.99,Oviedo FL,32765,4857.87,0
2028-02-07,08:00:00,Paycheck,2000.0,Oviedo FL,32765,6857.87,0
2028-02-07,09:00:00,Spotify,-11.99,Oviedo FL,32765,6845.88,0
2028-02-07,09:00:00,Internet,-70.89,Oviedo FL,32765,6774.99,0
2028-02-07,09:00:00,ChatGPT Plus,-20.0,Oviedo FL,32765,6754.99,0
2028-02-07,21:59:00,Dollar Tree,-34.82,Oviedo FL,32765,6720.17,0
2028-02-07,18:36:00,McDonald's,-72.14,Oviedo FL,32765,6648.03,0
2028-02-07,10:47:00,Walgreens,-38.85,Winter Park FL,32789,6609.18,0
2028-02-09,14:00:00,Best Buy,-149.08,Winter Park FL,32789,6460.1,0
2028-02-09,21:06:00,Subway,-56.14,Orlando FL,32816,6403.96,0
2028-02-10,12:15:00,AutoZone,-268.66,Oviedo FL,32765,6135.3,0
2028-02-11,08:23:00,BP,-22.54,Orlando FL,32816,6112.76,0
2028-02-11,09:51:00,Amazon,-192.1,Winter Park FL,32789,5920.66,0
2028-02-14,17:13:00,Trader Joe's,-55.22,Winter Park FL,32789,5865.44,0
2028-02-14,09:25:00,Jiffy Lube,-171.21,Winter Park FL,32789,5694.23,0
2028-02-14,12:27:00,Starbucks,-27.29,Orlando FL,32816,5666.94,0
2028-02-15,13:14:00,Fat Joe,-2488.21,Tokyo JP,22931,3178.73,1
2028-02-15,12:05:00,Target,-101.61,Oviedo FL,32765,5565.33,0
2028-02-15,17:31:00,Concert Tickets,-11.57,Oviedo FL,32765,5553.76,0
2028-02-15,08:55:00,Netflix,-59.05,Winter Park FL,32789,5494.71,0
2028-02-16,10:47:00,Trader Joe's,-60.29,Orlando FL,32816,5434.42,0
2028-02-17,09:16:00,Shell,-10.39,Orlando FL,32816,5424.03,0
2028-02-18,16:39:00,Lockheed Martin,-532.59,Groton CT,66046,4891.44,1
2028-02-18,10:12:00,Concert Tickets,-14.5,Winter Park FL,32789,5409.53,0
2028-02-19,11:38:00,Burger King,-7.97,Oviedo FL,32765,5401.56,0
2028-02-19,11:24:00,Midas,-163.14,Winter Park FL,32789,5238.42,0
2028-02-20,20:04:00,Burger King,-32.76,Winter Park FL,32789,5205.66,0
2028-02-21,08:00:00,Paycheck,2000.0,Oviedo FL,32765,7205.66,0
2028-02-23,11:10:00,Midas,-282.81,Oviedo FL,32765,6922.85,0
2028-02-23,11:20:00,Best Buy,-31.53,Winter Park FL,32789,6891.32,0
2028-02-24,14:20:00,Publix,-100.27,Winter Park FL,32789,6791.05,0
2028-02-24,14:14:00,Jiffy Lube,-88.35,Oviedo FL,32765,6702.7,0
2028-02-24,12:53:00,Concert Tickets,-110.14,Orlando FL,32816,6592.56,0
2028-02-25,12:47:00,Walgreens,-26.46,Oviedo FL,32765,6566.1,0
2028-02-25,15:23:00,Five Below,-35.49,Orlando FL,32816,6530.61,0
2028-02-26,03:22:00,Onlyfans,-2299.37,London EN,72098,4231.24,1
2028-02-26,17:00:00,Burger King,-19.79,Orlando FL,32816,6510.82,0
2028-02-26,15:21:00,Burger King,-14.5,Winter Park FL,32789,6496.32,0
2028-02-27,17:54:00,Best Buy,-293.45,Oviedo FL,32765,6202.87,0
2028-02-27,18:43:00,Starbucks,-10.72,Orlando FL,32816,6192.15,0
2028-02-28,11:04:00,Walgreens,-77.82,Orlando FL,32816,6114.33,0
2028-02-29,19:07:00,Amazon,-99.97,Oviedo FL,32765,6014.36,0
2028-02-29,11:01:00,Shell,-33.93,Winter Park FL,32789,5980.43,0
2028-02-29,08:44:00,Starbucks,-31.63,Orlando FL,32816,5948.8,0
2028-02-29,14:23:00,Fat Joe,-1558.36,Mexico City MC,90351,4390.44,1
2028-03-01,09:00:00,Rent,-960.0,Oviedo FL,32765,4988.8,0
2028-03-01,09:00:00,Insurance,-197.46,Oviedo FL,32765,4791.34,0
2028-03-01,09:00:00,Car,-300.0,Oviedo FL,32765,4491.34,0
2028-03-01,21:57:00,Amazon,-27.69,Oviedo FL,32765,4463.65,0
2028-03-01,17:03:00,McDonald's,-13.75,Oviedo FL,32765,4449.9,0
2028-03-01,14:59:00,Target,-37.03,Orlando FL,32816,4412.87,0
2028-03-02,21:15:00,McDonald's,-17.12,Oviedo FL,32765,4395.75,0
2028-03-03,20:48:00,CVS,-35.14,Oviedo FL,32765,4360.61,0
2028-03-04,09:20:00,Starbucks,-32.72,Oviedo FL,32765,4327.89,0
2028-03-04,09:25:00,Trader Joe's,-68.74,Oviedo FL,32765,4259.15,0
2028-03-05,14:24:00,Burger King,-14.97,Oviedo FL,32765,4244.18,0
2028-03-06,08:00:00,Paycheck,2000.0,Oviedo FL,32765,6244.18,0
2028-03-06,14:12:00,Amazon,-212.7,Oviedo FL,32765,6031.48,0
2028-03-06,17:58:00,Walmart,-241.67,Winter Park FL,32789,5789.81,0
2028-03-07,09:00:00,Spotify,-11.99,Oviedo FL,32765,5777.82,0
2028-03-07,09:00:00,Internet,-70.89,Oviedo FL,32765,5706.93,0
2028-03-07,09:00:00,ChatGPT Plus,-20.0,Oviedo FL,32765,5686.93,0
2028-03-07,19:00:00,Starbucks,-21.07,Orlando FL,32816,5665.86,0
2028-03-07,08:44:00,Dollar Tree,-15.59,Winter Park FL,32789,5650.27,0
2028-03-07,21:39:00,Fat Joe,-2515.12,Anchorage AL,87141,3135.15,1
2028-03-09,02:40:00,Onlyfans,-308.81,Mexico City MC,82998,5341.46,1
2028-03-09,15:18:00,Five Below,-14.28,Orlando FL,32816,5635.99,0
2028-03-09,16:27:00,Starbucks,-7.23,Orlando FL,32816,5628.76,0
2028-03-10,15:45:00,Trader Joe's,-89.12,Winter Park FL,32789,5539.64,0
2028-03-10,14:24:00,Pep Boys,-127.43,Oviedo FL,32765,5412.21,0
2028-03-11,19:03:00,Burger King,-30.91,Oviedo FL,32765,5381.3,0
2028-03-11,12:12:00,Starbucks,-19.13,Oviedo FL,32765,5362.17,0
2028-03-11,20:33:00,Target,-20.07,Winter Park FL,32789,5342.1,0
2028-03-12,10:13:00,Burger King,-31.2,Orlando FL,32816,5310.9,0
2028-03-12,23:37:00,Fraud,-1593.93,New York NY,55579,3716.97,1
2028-03-12,11:23:00,Dollar Tree,-21.81,Winter Park FL,32789,5289.09,0
2028-03-14,16:25:00,McDonald's,-17.58,Orlando FL,32816,5271.51,0
2028-03-15,21:26:00,Subway,-19.13,Orlando FL,32816,5252.38,0
2028-03-15,20:19:00,Kroger,-83.3,Orlando FL,32816,5169.08,0
2028-03-17,13:32:00,McDonald's,-25.4,Winter Park FL,32789,5143.68,0
2028-03-17,13:52:00,Shell,-24.55,Winter Park FL,32789,5119.13,0
2028-03-18,09:09:00,Lockheed Martin,-630.48,Tokyo JP,38734,4488.65,1
2028-03-18,12:59:00,Subway,-19.07,Winter Park FL,32789,5100.06,0
2028-03-19,10:09:00,Five Below,-15.3,Orlando FL,32816,5084.76,0
2028-03-19,12:06:00,Concert Tickets,-38.13,Winter Park FL,32789,5046.63,0
2028-03-19,14:33:00,McDonald's,-9.62,Winter Park FL,32789,5037.01,0
2028-03-20,08:00:00,Paycheck,2000.0,Oviedo FL,32765,7037.01,0
2028-03-20,13:04:00,Five Below,-67.42,Winter Park FL,32789,6969.59,0
2028-03-21,01:49:00,Pawn Stars,-1773.95,Los Angeles CA,13723,5195.64,1
2028-03-22,12:37:00,Starbucks,-51.74,Oviedo FL,32765,6917.85,0
2028-03-22,08:56:00,Best Buy,-174.3,Oviedo FL,32765,6743.55,0
2028-03-23,19:46:00,Burger King,-77.49,Winter Park FL,32789,6666.06,0
2028-03-24,08:06:00,Amazon,-158.4,Oviedo FL,32765,6507.66,0
2028-03-25,20:44:00,Best Buy,-34.45,Orlando FL,32816,6473.21,0
2028-03-25,16:29:00,Netflix,-42.28,Winter Park FL,32789,6430.93,0
2028-03-25,10:04:00,Burger King,-30.79,Oviedo FL,32765,6400.14,0
2028-03-26,21:55:00,Magic the Gathering,-939.77,Pyongyang NK,17295,5460.37,1
2028-03-26,11:31:00,Exxon,-35.06,Orlando FL,32816,6365.08,0
2028-03-26,20:21:00,Dollar Tree,-12.3,Oviedo FL,32765,6352.78,0
2028-03-26,20:38:00,Amusement Park,-113.76,Winter Park FL,32789,6239.02,0
2028-03-27,17:57:00,Burger King,-42.79,Winter Park FL,32789,6196.23,0
2028-03-27,13:32:00,Starbucks,-76.23,Winter Park FL,32789,6120.0,0
2028-03-27,18:45:00,Starbucks,-49.3,Orlando FL,32816,6070.7,0
2028-03-28,21:09:00,Walmart,-233.15,Orlando FL,32816,5837.55,0
2028-03-30,10:14:00,Subway,-38.87,Orlando FL,32816,5798.68,0
2028-03-30,05:25:00,Fat Joe,-204.68,Honolulu HI,17665,5594.0,1
2028-03-30,12:01:00,Amusement Park,-18.55,Orlando FL,32816,5780.13,0
2028-03-31,01:13:00,IBM,-1999.04,Honolulu HI,69928,3781.09,1
2028-04-01,09:00:00,Rent,-960.0,Oviedo FL,32765,4820.13,0
2028-04-01,09:00:00,Insurance,-197.46,Oviedo FL,32765,4622.67,0
2028-04-01,09:00:00,Car,-300.0,Oviedo FL,32765,4322.67,0
2028-04-01,09:36:00,Publix,-51.52,Orlando FL,32816,4271.15,0
2028-04-01,19:24:00,Chevron,-15.7,Winter Park FL,32789,4255.45,0
2028-04-01,11:15:00,McDonald's,-7.27,Winter Park FL,32789,4248.18,0
2028-04-02,14:24:00,Concert Tickets,-41.33,Orlando FL,32816,4206.85,0
2028-04-02,21:22:00,Amusement Park,-23.67,Orlando FL,32816,4183.18,0
2028-04-03,08:00:00,Paycheck,2000.0,Oviedo FL,32765,6183.18,0
2028-04-03,09:05:00,Pawn Stars,-781.28,Anchorage AL,85878,5401.9,1
2028-04-03,13:14:00,Netflix,-79.71,Oviedo FL,32765,6103.47,0
2028-04-03,20:40:00,Jiffy Lube,-262.47,Orlando FL,32816,5841.0,0
2028-04-04,13:39:00,Accelerators,-2076.69,Mexico City MC,41855,3764.31,1
2028-04-04,11:52:00,Trader Joe's,-42.33,Oviedo FL,32765,5798.67,0
2028-04-04,18:33:00,Magic the Gathering,-247.29,Groton CT,34474,5551.38,1
2028-04-04,15:48:00,Starbucks,-21.52,Oviedo FL,32765,5777.15,0
2028-04-07,09:00:00,Spotify,-11.99,Oviedo FL,32765,5765.16,0
2028-04-07,09:00:00,Internet,-70.89,Oviedo FL,32765,5694.27,0
2028-04-07,09:00:00,ChatGPT Plus,-20.0,Oviedo FL,32765,5674.27,0
2028-04-07,16:01:00,Jiffy Lube,-165.31,Orlando FL,32816,5508.96,0
2028-04-07,11:17:00,Whole Foods,-72.13,Oviedo FL,32765,5436.83,0
2028-04-07,20:24:00,Concert Tickets,-44.13,Oviedo FL,32765,5392.7,0
2028-04-08,10:04:00,Onlyfans,-704.82,Pyongyang NK,81958,4687.88,1
2028-04-08,09:06:00,Burger King,-18.72,Orlando FL,32816,5373.98,0
2028-04-08,09:54:00,Target,-32.79,Winter Park FL,32789,5341.19,0
2028-04-08,08:02:00,Kroger,-93.43,Orlando FL,32816,5247.76,0
2028-04-09,13:44:00,McDonald's,-5.52,Oviedo FL,32765,5242.24,0
2028-04-09,09:45:00,Subway,-33.79,Winter Park FL,32789,5208.45,0
2028-04-09,10:16:00,Jiffy Lube,-184.82,Orlando FL,32816,5023.63,0
2028-04-10,19:21:00,Amusement Park,-27.1,Oviedo FL,32765,4996.53,0
2028-04-10,10:40:00,Walmart,-127.91,Orlando FL,32816,4868.62,0
2028-04-10,20:42:00,McDonald's,-31.79,Oviedo FL,32765,4836.83,0
2028-04-11,18:13:00,Chevron,-19.75,Oviedo FL,32765,4817.08,0
2028-04-11,08:03:00,BP,-28.24,Oviedo FL,32765,4788.84,0
2028-04-13,21:15:00,Paypal,-1986.79,Tokyo JP,49466,2802.05,1
2028-04-13,08:04:00,Burger King,-25.63,Winter Park FL,32789,4763.21,0
2028-04-14,07:29:00,Fat Joe,-586.98,New York NY,42308,4176.23,1
2028-04-14,20:39:00,Walmart,-149.12,Oviedo FL,32765,4614.09,0
2028-04-14,21:28:00,Subway,-34.68,Winter Park FL,32789,4579.41,0
2028-04-15,16:08:00,Impractical Jokers,-2493.07,Tokyo JP,38825,2086.34,1
2028-04-16,10:09:00,Movie Theater,-29.16,Orlando FL,32816,4550.25,0
2028-04-17,08:00:00,Paycheck,2000.0,Oviedo FL,32765,6550.25,0
2028-04-17,12:22:00,Amazon,-279.36,Oviedo FL,32765,6270.89,0
2028-04-18,08:05:00,CVS,-82.25,Winter Park FL,32789,6188.64,0
2028-04-18,14:49:00,Five Below,-28.13,Orlando FL,32816,6160.51,0
2028-04-18,13:46:00,Burger King,-51.4,Oviedo FL,32765,6109.11,0
2028-04-19,20:32:00,McDonald's,-35.61,Oviedo FL,32765,6073.5,0
2028-04-19,08:23:00,Publix,-186.87,Winter Park FL,32789,5886.63,0
2028-04-19,09:44:00,Burger King,-32.43,Oviedo FL,32765,5854.2,0
2028-04-20,21:03:00,Monster Energy,-2402.74,Charleston SC,29117,3451.46,1
2028-04-20,20:30:00,Burger King,-23.31,Orlando FL,32816,5830.89,0
2028-04-21,08:24:00,Shell,-26.21,Winter Park FL,32789,5804.68,0
2028-04-22,13:58:00,Starbucks,-13.15,Winter Park FL,32789,5791.53,0
2028-04-24,02:00:00,Pawn Stars,-2551.35,Mexico City MC,64716,3240.18,1
2028-04-24,09:13:00,BP,-10.58,Winter Park FL,32789,5780.95,0
2028-04-25,05:49:00,Lockheed Martin,-2785.6,New York NY,83617,2995.35,1
2028-04-25,16:04:00,Subway,-34.35,Orlando FL,32816,5746.6,0
2028-04-25,19:04:00,Paypal,-1963.29,Pittsburgh PA,31892,3783.31,1
2028-04-26,08:01:00,Best Buy,-56.78,Oviedo FL,32765,5689.82,0
2028-04-26,14:32:00,Trader Joe's,-86.96,Winter Park FL,32789,5602.86,0
2028-04-26,12:38:00,McDonald's,-31.73,Oviedo FL,32765,5571.13,0
2028-04-27,18:33:00,Amusement Park,-30.51,Winter Park FL,32789,5540.62,0
2028-04-27,14:36:00,Kroger,-83.81,Orlando FL,32816,5456.81,0
2028-04-29,13:15:00,Five Below,-34.89,Oviedo FL,32765,5421.92,0
2028-04-29,20:51:00,Starbucks,-16.14,Oviedo FL,32765,5405.78,0
2028-04-29,08:19:00,Exxon,-24.45,Oviedo FL,32765,5381.33,0
2028-05-01,08:00:00,Paycheck,2000.0,Oviedo FL,32765,7381.33,0
2028-05-01,09:00:00,Rent,-960.0,Oviedo FL,32765,6421.33,0
2028-05-01,09:00:00,Insurance,-197.46,Oviedo FL,32765,6223.87,0
2028-05-01,09:00:00,Car,-300.0,Oviedo FL,32765,5923.87,0
2028-05-01,14:22:00,Burger King,-22.75,Oviedo FL,32765,5901.12,0
2028-05-01,16:35:00,Exxon,-26.51,Orlando FL,32816,5874.61,0
2028-05-01,13:07:00,Concert Tickets,-39.86,Oviedo FL,32765,5834.75,0
2028-05-02,04:24:00,Accelerators,-274.29,New York NY,97447,5560.46,1
2028-05-02,18:39:00,Burger King,-33.05,Winter Park FL,32789,5801.7,0
2028-05-02,17:13:00,Burger King,-37.43,Orlando FL,32816,5764.27,0
2028-05-03,21:56:00,Kroger,-70.47,Orlando FL,32816,5693.8,0
2028-05-03,11:17:00,Best Buy,-20.14,Winter Park FL,32789,5673.66,0
2028-05-04,14:37:00,Publix,-46.87,Orlando FL,32816,5626.79,0
2028-05-05,07:19:00,Accelerators,-1486.85,Charleston SC,85351,4139.94,1
2028-05-05,18:20:00,Starbucks,-38.79,Winter Park FL,32789,5588.0,0
2028-05-06,13:36:00,Kroger,-54.56,Orlando FL,32816,5533.44,0
2028-05-06,19:05:00,Publix,-40.41,Oviedo FL,32765,5493.03,0
2028-05-06,11:17:00,McDonald's,-7.54,Winter Park FL,32789,5485.49,0
2028-05-07,09:00:00,Spotify,-11.99,Oviedo FL,32765,5473.5,0
2028-05-07,09:00:00,Internet,-70.89,Oviedo FL,32765,5402.61,0
2028-05-07,09:00:00,ChatGPT Plus,-20.0,Oviedo FL,32765,5382.61,0
2028-05-07,14:08:00,McDonald's,-38.46,Oviedo FL,32765,5344.15,0
2028-05-11,12:08:00,Best Buy,-44.2,Oviedo FL,32765,5299.95,0
2028-05-11,19:09:00,Five Below,-32.75,Winter Park FL,32789,5267.2,0
2028-05-12,09:32:00,Kroger,-79.96,Orlando FL,32816,5187.24,0
2028-05-12,08:23:00,Subway,-22.91,Oviedo FL,32765,5164.33,0
2028-05-14,09:19:00,Fraud,-2554.07,Tokyo JP,17260,2610.26,1
2028-05-14,21:31:00,Chevron,-27.13,Oviedo FL,32765,5137.2,0
2028-05-15,08:00:00,Paycheck,2000.0,Oviedo FL,32765,7137.2,0
2028-05-15,05:00:00,Accelerators,-1699.12,Anchorage AL,45911,5438.08,1
2028-05-15,14:13:00,Subway,-11.23,Oviedo FL,32765,7125.97,0
2028-05-16,10:45:00,McDonald's,-76.21,Oviedo FL,32765,7049.76,0
2028-05-17,13:10:00,Walmart,-110.05,Winter Park FL,32789,6939.71,0
2028-05-17,15:57:00,Walgreens,-73.57,Orlando FL,32816,6866.14,0
2028-05-18,12:16:00,Shell,-35.25,Oviedo FL,32765,6830.89,0
2028-05-18,08:22:00,Subway,-16.29,Orlando FL,32816,6814.6,0
2028-05-19,18:36:00,Trader Joe's,-160.64,Orlando FL,32816,6653.96,0
2028-05-20,10:01:00,Impractical Jokers,-1739.37,Los Angeles CA,80444,4914.59,1
2028-05-20,18:03:00,Target,-261.66,Oviedo FL,32765,6392.3,0
2028-05-20,09:15:00,AutoZone,-371.65,Orlando FL,32816,6020.65,0
2028-05-21,16:03:00,Target,-141.21,Orlando FL,32816,5879.44,0
2028-05-22,17:58:00,Kroger,-59.01,Orlando FL,32816,5820.43,0
2028-05-22,19:55:00,Starbucks,-17.84,Winter Park FL,32789,5802.59,0
2028-05-22,17:47:00,Walmart,-24.19,Oviedo FL,32765,5778.4,0
2028-05-23,11:00:00,Amazon,-13.8,Oviedo FL,32765,5764.6,0
2028-05-23,14:14:00,Whole Foods,-46.18,Oviedo FL,32765,5718.42,0
2028-05-23,09:56:00,Concert Tickets,-36.13,Oviedo FL,32765,5682.29,0
2028-05-25,17:41:00,McDonald's,-29.02,Oviedo FL,32765,5653.27,0
2028-05-25,09:24:00,Amusement Park,-42.87,Oviedo FL,32765,5610.4,0
2028-05-25,07:06:00,Fat Joe,-1187.57,Honolulu HI,80541,4422.83,1
2028-05-27,19:36:00,Burger King,-39.29,Winter Park FL,32789,5571.11,0
2028-05-27,12:42:00,Starbucks,-29.32,Winter Park FL,32789,5541.79,0
2028-05-27,13:11:00,Walgreens,-38.38,Oviedo FL,32765,5503.41,0
2028-05-28,10:45:00,Walmart,-68.24,Oviedo FL,32765,5435.17,0
2028-05-29,08:00:00,Paycheck,2000.0,Oviedo FL,32765,7435.17,0
2028-05-29,09:47:00,Amazon,-171.4,Orlando FL,32816,7263.77,0
2028-05-31,16:02:00,Impractical Jokers,-2499.5,Tokyo JP,50876,4764.27,1
2028-05-31,21:11:00,Starbucks,-58.74,Oviedo FL,32765,7205.03,0
2028-05-31,21:59:00,Fat Joe,-1385.53,Los Angeles CA,91638,5819.5,1
2028-06-01,09:00:00,Rent,-960.0,Oviedo FL,32765,6245.03,0
2028-06-01,09:00:00,Insurance,-197.46,Oviedo FL,32765,6047.57,0
2028-06-01,09:00:00,Car,-300.0,Oviedo FL,32765,5747.57,0
2028-06-03,14:54:00,Amusement Park,-50.68,Oviedo FL,32765,5696.89,0
2028-06-03,17:23:00,Netflix,-21.89,Oviedo FL,32765,5675.0,0
2028-06-03,19:14:00,Subway,-8.73,Winter Park FL,32789,5666.27,0
2028-06-04,12:17:00,Dollar Tree,-18.75,Orlando FL,32816,5647.52,0
2028-06-05,09:18:00,Starbucks,-36.47,Orlando FL,32816,5611.05,0
2028-06-05,12:32:00,Netflix,-42.86,Winter Park FL,32789,5568.19,0
2028-06-05,16:47:00,McDonald's,-14.26,Oviedo FL,32765,5553.93,0
2028-06-06,08:30:00,Walmart,-91.84,Orlando FL,32816,5462.09,0
2028-06-06,18:25:00,Midas,-123.09,Winter Park FL,32789,5339.0,0
2028-06-06,19:04:00,McDonald's,-5.33,Orlando FL,32816,5333.67,0
2028-06-07,09:00:00,Spotify,-11.99,Oviedo FL,32765,5321.68,0
2028-06-07,09:00:00,Internet,-70.89,Oviedo FL,32765,5250.79,0
2028-06-07,09:00:00,ChatGPT Plus,-20.0,Oviedo FL,32765,5230.79,0
2028-06-07,10:18:00,Chevron,-26.3,Winter Park FL,32789,5204.49,0
2028-06-07,17:34:00,Five Below,-13.86,Winter Park FL,32789,5190.63,0
2028-06-08,09:15:00,Best Buy,-93.59,Oviedo FL,32765,5097.04,0
2028-06-08,12:20:00,Publix,-73.78,Winter Park FL,32789,5023.26,0
2028-06-08,09:46:00,Pep Boys,-181.86,Winter Park FL,32789,4841.4,0
2028-06-10,15:02:00,Movie Theater,-33.93,Oviedo FL,32765,4807.47,0
2028-06-11,13:26:00,Amusement Park,-13.99,Oviedo FL,32765,4793.48,0
2028-06-11,01:22:00,Impractical Jokers,-2725.28,Honolulu HI,12050,2068.2,1
2028-06-11,21:41:00,Subway,-6.19,Oviedo FL,32765,4787.29,0
2028-06-12,08:00:00,Paycheck,2000.0,Oviedo FL,32765,6787.29,0
2028-06-12,11:32:00,Subway,-19.34,Orlando FL,32816,6767.95,0
2028-06-12,09:37:00,Magic the Gathering,-335.65,Pyongyang NK,57763,6432.3,1
2028-06-13,09:48:00,Lockheed Martin,-1575.58,Mexico City MC,19206,5192.37,1
2028-06-13,11:13:00,Subway,-75.4,Orlando FL,32816,6692.55,0
2028-06-14,09:37:00,Exxon,-21.74,Orlando FL,32816,6670.81,0
2028-06-15,17:45:00,Whole Foods,-179.43,Oviedo FL,32765,6491.38,0
2028-06-15,13:14:00,Chevron,-44.64,Oviedo FL,32765,6446.74,0
2028-06-16,15:03:00,Subway,-25.81,Orlando FL,32816,6420.93,0
2028-06-16,20:47:00,CVS,-95.29,Orlando FL,32816,6325.64,0
2028-06-16,18:45:00,Impractical Jokers,-418.63,Groton CT,16077,5907.01,1
2028-06-16,19:33:00,BP,-58.09,Winter Park FL,32789,6267.55,0
2028-06-17,11:03:00,Five Below,-69.44,Oviedo FL,32765,6198.11,0
2028-06-18,10:36:00,CVS,-38.24,Winter Park FL,32789,6159.87,0
2028-06-19,09:23:00,Burger King,-66.83,Oviedo FL,32765,6093.04,0
2028-06-19,19:45:00,Best Buy,-187.46,Orlando FL,32816,5905.58,0
2028-06-20,15:24:00,Best Buy,-57.22,Orlando FL,32816,5848.36,0
2028-06-20,21:57:00,Dollar Tree,-42.3,Winter Park FL,32789,5806.06,0
2028-06-21,13:22:00,Burger King,-30.65,Winter Park FL,32789,5775.41,0
2028-06-21,12:06:00,Starbucks,-37.87,Winter Park FL,32789,5737.54,0
2028-06-22,16:45:00,Whole Foods,-98.25,Orlando FL,32816,5639.29,0
2028-06-22,21:55:00,Pawn Stars,-2266.73,Charleston SC,57089,3372.56,1
2028-06-23,11:20:00,Trader Joe's,-87.12,Winter Park FL,32789,5552.17,0
2028-06-23,12:46:00,Subway,-26.85,Orlando FL,32816,5525.32,0
2028-06-23,11:22:00,Dollar Tree,-14.78,Oviedo FL,32765,5510.54,0
2028-06-24,13:40:00,Publix,-86.4,Orlando FL,32816,5424.14,0
2028-06-24,12:47:00,Subway,-15.58,Oviedo FL,32765,5408.56,0
2028-06-24,13:05:00,Walmart,-27.68,Orlando FL,32816,5380.88,0
2028-06-25,15:51:00,Amazon,-86.02,Oviedo FL,32765,5294.86,0
2028-06-25,12:07:00,Shell,-13.69,Orlando FL,32816,5281.17,0
2028-06-25,02:17:00,Fat Joe,-1613.38,Tokyo JP,58852,3667.79,1
2028-06-25,19:26:00,Shell,-18.66,Orlando FL,32816,5262.51,0
2028-06-26,08:00:00,Paycheck,2000.0,Oviedo FL,32765,7262.51,0
2028-06-27,15:37:00,Burger King,-76.58,Oviedo FL,32765,7185.93,0
2028-06-27,11:37:00,Subway,-20.5,Winter Park FL,32789,7165.43,0
2028-06-27,08:39:00,Concert Tickets,-75.62,Winter Park FL,32789,7089.81,0
2028-06-27,20:02:00,Lockheed Martin,-1467.6,Groton CT,19769,5622.21,1
2028-06-28,18:33:00,Walmart,-151.28,Orlando FL,32816,6938.53,0
2028-06-28,19:10:00,Movie Theater,-76.58,Orlando FL,32816,6861.95,0
2028-06-28,17:52:00,BP,-38.64,Winter Park FL,32789,6823.31,0
2028-06-29,10:42:00,Movie Theater,-77.13,Orlando FL,32816,6746.18,0
2028-06-29,11:36:00,Impractical Jokers,-769.25,Pittsburgh PA,97313,5976.93,1
2028-06-30,11:57:00,McDonald's,-44.56,Winter Park FL,32789,6701.62,0
2028-06-30,08:43:00,Paypal,-2271.03,London EN,50430,4430.59,1
2028-07-01,09:00:00,Rent,-960.0,Oviedo FL,32765,5741.62,0
2028-07-01,09:00:00,Insurance,-197.46,Oviedo FL,32765,5544.16,0
2028-07-01,09:00:00,Car,-300.0,Oviedo FL,32765,5244.16,0
2028-07-01,18:44:00,Amusement Park,-28.21,Winter Park FL,32789,5215.95,0
2028-07-03,17:26:00,Exxon,-14.39,Orlando FL,32816,5201.56,0
2028-07-03,20:36:00,Midas,-130.84,Winter Park FL,32789,5070.72,0
2028-07-04,11:52:00,Burger King,-11.33,Orlando FL,32816,5059.39,0
2028-07-04,17:23:00,McDonald's,-6.65,Orlando FL,32816,5052.74,0
2028-07-05,20:23:00,Movie Theater,-42.96,Winter Park FL,32789,5009.78,0
2028-07-05,15:43:00,Monster Energy,-2329.9,Anchorage AL,89835,2679.88,1
2028-07-05,19:17:00,McDonald's,-9.4,Oviedo FL,32765,5000.38,0
2028-07-06,14:35:00,Chevron,-26.34,Winter Park FL,32789,4974.04,0
2028-07-06,21:08:00,CVS,-16.2,Oviedo FL,32765,4957.84,0
2028-07-07,09:00:00,Spotify,-11.99,Oviedo FL,32765,4945.85,0
2028-07-07,09:00:00,Internet,-70.89,Oviedo FL,32765,4874.96,0
2028-07-07,09:00:00,ChatGPT Plus,-20.0,Oviedo FL,32765,4854.96,0
2028-07-07,18:48:00,Starbucks,-38.52,Oviedo FL,32765,4816.44,0
2028-07-08,08:11:00,Kroger,-39.03,Oviedo FL,32765,4777.41,0
2028-07-08,17:02:00,Walgreens,-30.85,Orlando FL,32816,4746.56,0
2028-07-08,16:38:00,Midas,-181.45,Winter Park FL,32789,4565.11,0
2028-07-08,15:00:00,Monster Energy,-879.91,Anchorage AL,75738,3685.2,1
2028-07-09,16:52:00,Five Below,-44.53,Winter Park FL,32789,4520.58,0
2028-07-09,19:21:00,Dollar Tree,-25.32,Oviedo FL,32765,4495.26,0
2028-07-10,08:00:00,Paycheck,2000.0,Oviedo FL,32765,6495.26,0
2028-07-10,04:46:00,Pawn Stars,-1200.09,Tokyo JP,94306,5295.17,1
2028-07-11,11:44:00,Starbucks,-35.88,Oviedo FL,32765,6459.38,0
2028-07-11,04:22:00,Magic the Gathering,-137.49,Pittsburgh PA,77786,6321.89,1
2028-07-11,12:47:00,Concert Tickets,-49.14,Winter Park FL,32789,6410.24,0
2028-07-12,14:11:00,Onlyfans,-2978.06,Mexico City MC,81829,3432.18,1
2028-07-12,13:26:00,Subway,-70.29,Oviedo FL,32765,6339.95,0
2028-07-12,17:32:00,McDonald's,-21.07,Orlando FL,32816,6318.88,0
2028-07-12,14:31:00,Fraud,-2385.29,Los Angeles CA,89701,3933.59,1
2028-07-12,21:13:00,McDonald's,-47.11,Orlando FL,32816,6271.77,0
2028-07-13,19:32:00,McDonald's,-22.25,Winter Park FL,32789,6249.52,0
2028-07-13,08:11:00,Chevron,-23.82,Oviedo FL,32765,6225.7,0
2028-07-13,16:28:00,Movie Theater,-87.52,Orlando FL,32816,6138.18,0
2028-07-13,15:36:00,Accelerators,-1022.22,Groton CT,79867,5115.96,1
2028-07-14,19:26:00,Whole Foods,-191.88,Orlando FL,32816,5946.3,0
2028-07-15,18:49:00,BP,-25.8,Oviedo FL,32765,5920.5,0
2028-07-16,18:34:00,Pawn Stars,-1430.78,Los Angeles CA,97906,4489.72,1
2028-07-17,17:01:00,Amusement Park,-29.36,Winter Park FL,32789,5891.14,0
2028-07-17,14:15:00,IBM,-1415.99,Los Angeles CA,93796,4475.15,1
2028-07-17,21:12:00,Netflix,-44.6,Winter Park FL,32789,5846.54,0
2028-07-17,19:29:00,Starbucks,-6.3,Winter Park FL,32789,5840.24,0
2028-07-18,13:18:00,Onlyfans,-2275.02,Tokyo JP,91180,3565.22,1
2028-07-18,14:03:00,McDonald's,-34.47,Orlando FL,32816,5805.77,0
2028-07-18,13:37:00,Dollar Tree,-49.96,Oviedo FL,32765,5755.81,0
2028-07-18,02:08:00,Onlyfans,-2838.73,Anchorage AL,44875,2917.08,1
2028-07-18,20:39:00,McDonald's,-22.72,Oviedo FL,32765,5733.09,0
2028-07-21,02:02:00,Pawn Stars,-274.75,New York NY,16849,5458.34,1
2028-07-21,17:18:00,Kroger,-57.27,Oviedo FL,32765,5675.82,0
2028-07-21,20:18:00,Subway,-24.77,Orlando FL,32816,5651.05,0
2028-07-21,10:51:00,Onlyfans,-2006.14,Tokyo JP,55903,3644.91,1
2028-07-22,16:41:00,Burger King,-36.42,Oviedo FL,32765,5614.63,0
2028-07-23,17:29:00,Publix,-90.31,Oviedo FL,32765,5524.32,0
2028-07-23,13:06:00,Subway,-39.66,Oviedo FL,32765,5484.66,0
2028-07-24,08:00:00,Paycheck,2000.0,Oviedo FL,32765,7484.66,0
2028-07-25,13:07:00,Target,-251.55,Oviedo FL,32765,7233.11,0
2028-07-25,16:51:00,Movie Theater,-86.46,Oviedo FL,32765,7146.65,0
2028-07-25,17:42:00,Burger King,-54.73,Winter Park FL,32789,7091.92,0
2028-07-26,19:55:00,Best Buy,-214.19,Orlando FL,32816,6877.73,0
2028-07-26,23:43:00,Servicenow,-1567.6,Los Angeles CA,99858,5310.13,1
2028-07-26,13:10:00,Starbucks,-10.31,Orlando FL,32816,6867.42,0
2028-07-27,09:56:00,Subway,-57.78,Oviedo FL,32765,6809.64,0
2028-07-28,08:29:00,Dollar Tree,-41.61,Winter Park FL,32789,6768.03,0
2028-07-28,17:33:00,Movie Theater,-114.92,Winter Park FL,32789,6653.11,0
2028-07-28,21:38:00,Target,-155.13,Winter Park FL,32789,6497.98,0
2028-07-28,09:34:00,Lockheed Martin,-1155.36,Honolulu HI,26263,5342.62,1
2028-07-29,21:02:00,Target,-168.96,Orlando FL,32816,6329.02,0
2028-07-29,19:20:00,Amusement Park,-33.05,Oviedo FL,32765,6295.97,0
2028-07-31,20:29:00,Best Buy,-160.27,Orlando FL,32816,6135.7,0
2028-07-31,11:20:00,Paypal,-2185.16,Groton CT,15125,3950.54,1
2028-08-01,09:00:00,Rent,-960.0,Oviedo FL,32765,5175.7,0
2028-08-01,09:00:00,Insurance,-197.46,Oviedo FL,32765,4978.24,0
2028-08-01,09:00:00,Car,-300.0,Oviedo FL,32765,4678.24,0
2028-08-02,14:32:00,Whole Foods,-63.35,Oviedo FL,32765,4614.89,0
2028-08-02,12:54:00,Shell,-11.51,Oviedo FL,32765,4603.38,0
2028-08-03,21:05:00,Monster Energy,-1310.52,London EN,65764,3292.86,1
2028-08-03,10:51:00,Target,-42.18,Orlando FL,32816,4561.2,0
2028-08-03,11:29:00,Kroger,-58.38,Winter Park FL,32789,4502.82,0
2028-08-03,18:58:00,Burger King,-34.83,Oviedo FL,32765,4467.99,0
2028-08-04,21:25:00,Fat Joe,-2280.26,Honolulu HI,65716,2187.73,1
2028-08-04,13:53:00,McDonald's,-14.86,Winter Park FL,32789,4453.13,0
2028-08-04,09:51:00,Kroger,-45.65,Oviedo FL,32765,4407.48,0
2028-08-05,12:00:00,Dollar Tree,-6.41,Winter Park FL,32789,4401.07,0
2028-08-07,08:00:00,Paycheck,2000.0,Oviedo FL,32765,6401.07,0
2028-08-07,09:00:00,Spotify,-11.99,Oviedo FL,32765,6389.08,0
2028-08-07,09:00:00,Internet,-70.89,Oviedo FL,32765,6318.19,0
2028-08-07,09:00:00,ChatGPT Plus,-20.0,Oviedo FL,32765,6298.19,0
2028-08-08,20:43:00,Movie Theater,-83.72,Oviedo FL,32765,6214.47,0
2028-08-09,12:47:00,Burger King,-53.49,Orlando FL,32816,6160.98,0
2028-08-09,20:39:00,Exxon,-48.33,Orlando FL,32816,6112.65,0
2028-08-09,21:54:00,Walgreens,-58.41,Orlando FL,32816,6054.24,0
2028-08-10,08:25:00,Impractical Jokers,-2809.9,Tokyo JP,86695,3244.34,1
2028-08-11,20:23:00,CVS,-85.08,Oviedo FL,32765,5969.16,0
2028-08-11,10:08:00,Best Buy,-85.41,Oviedo FL,32765,5883.75,0
2028-08-12,15:25:00,Walgreens,-36.43,Oviedo FL,32765,5847.32,0
2028-08-14,05:38:00,Fraud,-165.71,Tokyo JP,78678,5681.61,1
2028-08-14,18:29:00,Midas,-53.65,Orlando FL,32816,5793.67,0
2028-08-15,12:09:00,Walmart,-136.16,Orlando FL,32816,5657.51,0
2028-08-16,21:18:00,Walmart,-38.65,Oviedo FL,32765,5618.86,0
2028-08-17,20:54:00,Amusement Park,-33.83,Oviedo FL,32765,5585.03,0
2028-08-17,14:31:00,Pep Boys,-58.25,Orlando FL,32816,5526.78,0
2028-08-17,20:13:00,Target,-128.45,Oviedo FL,32765,5398.33,0
2028-08-18,11:32:00,Netflix,-43.17,Oviedo FL,32765,5355.16,0
2028-08-19,13:59:00,Starbucks,-23.11,Orlando FL,32816,5332.05,0
2028-08-19,18:44:00,Amazon,-83.3,Oviedo FL,32765,5248.75,0
2028-08-21,08:00:00,Paycheck,2000.0,Oviedo FL,32765,7248.75,0
2028-08-21,14:30:00,McDonald's,-31.59,Winter Park FL,32789,7217.16,0
2028-08-21,19:50:00,Shell,-28.41,Winter Park FL,32789,7188.75,0
2028-08-21,21:11:00,Whole Foods,-64.94,Winter Park FL,32789,7123.81,0
2028-08-22,16:39:00,BP,-57.91,Winter Park FL,32789,7065.9,0
2028-08-22,20:29:00,Burger King,-68.46,Orlando FL,32816,6997.44,0
2028-08-23,13:35:00,IBM,-2827.25,Charleston SC,91369,4170.19,1
2028-08-24,11:18:00,CVS,-54.73,Winter Park FL,32789,6942.71,0
2028-08-24,21:32:00,Starbucks,-10.66,Orlando FL,32816,6932.05,0
2028-08-24,14:47:00,Movie Theater,-89.29,Winter Park FL,32789,6842.76,0
2028-08-25,20:02:00,BP,-40.66,Oviedo FL,32765,6802.1,0
2028-08-25,13:32:00,Jiffy Lube,-352.47,Oviedo FL,32765,6449.63,0
2028-08-25,16:34:00,Paypal,-1235.14,Charleston SC,54291,5214.49,1
2028-08-27,21:45:00,Five Below,-62.22,Winter Park FL,32789,6387.41,0
2028-08-27,12:00:00,Exxon,-49.63,Oviedo FL,32765,6337.78,0
2028-08-27,21:07:00,Servicenow,-1880.98,Tokyo JP,32516,4456.8,1
2028-08-29,20:48:00,Exxon,-31.06,Orlando FL,32816,6306.72,0
2028-08-31,18:32:00,Amazon,-144.08,Winter Park FL,32789,6162.64,0
2028-08-31,14:12:00,Best Buy,-87.29,Orlando FL,32816,6075.35,0
2028-08-31,12:55:00,Best Buy,-90.85,Winter Park FL,32789,5984.5,0
2028-09-01,09:00:00,Rent,-960.0,Oviedo FL,32765,5024.5,0
2028-09-01,09:00:00,Insurance,-197.46,Oviedo FL,32765,4827.04,0
2028-09-01,09:00:00,Car,-300.0,Oviedo FL,32765,4527.04,0
2028-09-01,11:39:00,Whole Foods,-85.77,Winter Park FL,32789,4441.27,0
2028-09-01,15:34:00,Concert Tickets,-20.4,Winter Park FL,32789,4420.87,0
2028-09-01,00:10:00,Magic the Gathering,-702.28,Mexico City MC,48385,3718.59,1
2028-09-02,12:12:00,Best Buy,-141.36,Oviedo FL,32765,4279.51,0
2028-09-02,15:04:00,Subway,-12.34,Orlando FL,32816,4267.17,0
2028-09-02,10:09:00,Amusement Park,-48.99,Oviedo FL,32765,4218.18,0
2028-09-03,02:53:00,Monster Energy,-995.5,Groton CT,16725,3222.68,1
2028-09-03,21:16:00,Exxon,-19.18,Orlando FL,32816,4199.0,0
2028-09-04,08:00:00,Paycheck,2000.0,Oviedo FL,32765,6199.0,0
2028-09-04,16:41:00,Burger King,-61.36,Winter Park FL,32789,6137.64,0
2028-09-04,17:48:00,Accelerators,-2226.32,Tokyo JP,27415,3911.32,1
2028-09-04,13:50:00,Starbucks,-70.01,Winter Park FL,32789,6067.63,0
2028-09-05,08:53:00,Publix,-79.97,Orlando FL,32816,5987.66,0
2028-09-05,20:19:00,Paypal,-1876.57,Honolulu HI,24116,4111.09,1
2028-09-05,08:40:00,Chevron,-24.72,Orlando FL,32816,5962.94,0
2028-09-06,13:22:00,Shell,-22.81,Oviedo FL,32765,5940.13,0
2028-09-06,19:20:00,Kroger,-41.66,Orlando FL,32816,5898.47,0
2028-09-07,09:00:00,Spotify,-11.99,Oviedo FL,32765,5886.48,0
2028-09-07,09:00:00,Internet,-70.89,Oviedo FL,32765,5815.59,0
2028-09-07,09:00:00,ChatGPT Plus,-20.0,Oviedo FL,32765,5795.59,0
2028-09-09,17:14:00,Walgreens,-33.95,Oviedo FL,32765,5761.64,0
2028-09-09,15:19:00,Subway,-11.62,Winter Park FL,32789,5750.02,0
2028-09-09,11:15:00,Amazon,-77.78,Orlando FL,32816,5672.24,0
2028-09-10,09:13:00,Walgreens,-48.29,Oviedo FL,32765,5623.95,0
2028-09-11,20:46:00,Movie Theater,-51.2,Orlando FL,32816,5572.75,0
2028-09-12,21:05:00,Chevron,-23.88,Oviedo FL,32765,5548.87,0
2028-09-12,21:05:00,McDonald's,-33.12,Oviedo FL,32765,5515.75,0
2028-09-13,13:13:00,Subway,-35.79,Oviedo FL,32765,5479.96,0
2028-09-13,19:33:00,Walgreens,-7.43,Oviedo FL,32765,5472.53,0
2028-09-13,01:21:00,Accelerators,-1059.73,Charleston SC,69333,4412.8,1
2028-09-14,09:17:00,Amazon,-19.79,Oviedo FL,32765,5452.74,0
2028-09-14,10:16:00,Target,-139.77,Winter Park FL,32789,5312.97,0
2028-09-17,20:46:00,Best Buy,-71.8,Winter Park FL,32789,5241.17,0
2028-09-18,08:00:00,Paycheck,2000.0,Oviedo FL,32765,7241.17,0
2028-09-18,18:09:00,Publix,-88.86,Orlando FL,32816,7152.31,0
2028-09-18,13:02:00,Dollar Tree,-81.76,Winter Park FL,32789,7070.55,0
2028-09-18,17:49:00,Subway,-19.38,Winter Park FL,32789,7051.17,0
2028-09-19,09:07:00,Walgreens,-85.61,Orlando FL,32816,6965.56,0
2028-09-19,17:45:00,Burger King,-55.48,Winter Park FL,32789,6910.08,0
2028-09-19,21:51:00,Starbucks,-19.87,Orlando FL,32816,6890.21,0
2028-09-20,20:21:00,Amazon,-112.11,Oviedo FL,32765,6778.1,0
2028-09-20,12:04:00,Best Buy,-88.09,Oviedo FL,32765,6690.01,0
2028-09-20,12:39:00,Impractical Jokers,-1599.1,Pyongyang NK,41395,5090.91,1
2028-09-21,10:30:00,Netflix,-57.36,Oviedo FL,32765,6632.65,0
2028-09-22,11:24:00,Netflix,-79.2,Winter Park FL,32789,6553.45,0
2028-09-23,12:16:00,Concert Tickets,-46.8,Orlando FL,32816,6506.65,0
2028-09-23,14:53:00,Five Below,-61.55,Orlando FL,32816,6445.1,0
2028-09-23,09:44:00,Walmart,-217.61,Oviedo FL,32765,6227.49,0
2028-09-24,21:22:00,Trader Joe's,-151.53,Oviedo FL,32765,6075.96,0
2028-09-24,10:06:00,Burger King,-26.6,Orlando FL,32816,6049.36,0
2028-09-24,19:11:00,Starbucks,-74.2,Winter Park FL,32789,5975.16,0
2028-09-25,12:07:00,Five Below,-14.54,Orlando FL,32816,5960.62,0
2028-09-25,08:55:00,Lockheed Martin,-628.93,Tokyo JP,95423,5331.69,1
2028-09-26,11:12:00,Starbucks,-32.75,Orlando FL,32816,5927.87,0
2028-09-27,13:43:00,Burger King,-10.99,Oviedo FL,32765,5916.88,0
2028-09-27,19:41:00,Concert Tickets,-43.96,Orlando FL,32816,5872.92,0
2028-09-28,08:10:00,BP,-25.85,Orlando FL,32816,5847.07,0
2028-09-29,15:16:00,Whole Foods,-70.68,Orlando FL,32816,5776.39,0
2028-09-29,19:01:00,Starbucks,-34.89,Orlando FL,32816,5741.5,0
2028-09-29,15:44:00,Best Buy,-26.31,Orlando FL,32816,5715.19,0
2028-09-30,10:08:00,Movie Theater,-58.36,Oviedo FL,32765,5656.83,0
2028-09-30,12:18:00,Kroger,-45.05,Oviedo FL,32765,5611.78,0
2028-09-30,16:39:00,Accelerators,-2032.13,Mexico City MC,61630,3579.65,1
2028-10-01,09:00:00,Rent,-960.0,Oviedo FL,32765,4651.78,0
2028-10-01,09:00:00,Insurance,-197.46,Oviedo FL,32765,4454.32,0
2028-10-01,09:00:00,Car,-300.0,Oviedo FL,32765,4154.32,0
2028-10-01,18:46:00,Impractical Jokers,-549.0,Anchorage AL,40835,3605.32,1
2028-10-01,20:40:00,Subway,-10.47,Winter Park FL,32789,4143.85,0
2028-10-02,08:00:00,Paycheck,2000.0,Oviedo FL,32765,6143.85,0
2028-10-02,08:47:00,Burger King,-31.85,Orlando FL,32816,6112.0,0
2028-10-03,13:29:00,Exxon,-54.16,Orlando FL,32816,6057.84,0
2028-10-04,11:39:00,Netflix,-69.29,Winter Park FL,32789,5988.55,0
2028-10-04,12:20:00,Publix,-45.94,Winter Park FL,32789,5942.61,0
2028-10-04,15:07:00,Amazon,-110.63,Oviedo FL,32765,5831.98,0
2028-10-06,20:33:00,Amusement Park,-59.35,Winter Park FL,32789,5772.63,0
2028-10-06,11:52:00,Starbucks,-23.95,Oviedo FL,32765,5748.68,0
2028-10-07,09:00:00,Spotify,-11.99,Oviedo FL,32765,5736.69,0
2028-10-07,09:00:00,Internet,-70.89,Oviedo FL,32765,5665.8,0
2028-10-07,09:00:00,ChatGPT Plus,-20.0,Oviedo FL,32765,5645.8,0
2028-10-07,10:27:00,Subway,-34.33,Winter Park FL,32789,5611.47,0
2028-10-08,20:52:00,Five Below,-15.5,Orlando FL,32816,5595.97,0
2028-10-08,21:20:00,McDonald's,-35.14,Oviedo FL,32765,5560.83,0
2028-10-10,14:38:00,Target,-11.6,Orlando FL,32816,5549.23,0
2028-10-12,21:43:00,Walgreens,-44.34,Orlando FL,32816,5504.89,0
2028-10-12,15:36:00,Burger King,-18.67,Winter Park FL,32789,5486.22,0
2028-10-13,20:54:00,Trader Joe's,-89.17,Orlando FL,32816,5397.05,0
2028-10-13,08:09:00,McDonald's,-12.93,Oviedo FL,32765,5384.12,0
2028-10-13,09:44:00,BP,-11.26,Oviedo FL,32765,5372.86,0
2028-10-14,12:22:00,Exxon,-18.09,Winter Park FL,32789,5354.77,0
2028-10-14,16:22:00,Starbucks,-10.58,Winter Park FL,32789,5344.19,0
2028-10-15,16:40:00,Amazon,-90.53,Winter Park FL,32789,5253.66,0
2028-10-15,13:19:00,McDonald's,-21.17,Winter Park FL,32789,5232.49,0
2028-10-15,18:53:00,Target,-84.92,Orlando FL,32816,5147.57,0
2028-10-15,21:09:00,Servicenow,-1494.51,Tokyo JP,14305,3653.06,1
2028-10-16,08:00:00,Paycheck,2000.0,Oviedo FL,32765,7147.57,0
2028-10-16,08:05:00,Five Below,-77.9,Oviedo FL,32765,7069.67,0
2028-10-17,09:48:00,McDonald's,-48.61,Oviedo FL,32765,7021.06,0
2028-10-18,09:28:00,Best Buy,-19.73,Orlando FL,32816,7001.33,0
2028-10-18,17:30:00,Monster Energy,-259.37,Los Angeles CA,78945,6741.96,1
2028-10-18,18:05:00,Burger King,-68.42,Winter Park FL,32789,6932.91,0
2028-10-18,09:23:00,Jiffy Lube,-124.7,Oviedo FL,32765,6808.21,0
2028-10-19,13:14:00,Whole Foods,-186.04,Oviedo FL,32765,6622.17,0
2028-10-21,21:04:00,Netflix,-80.62,Orlando FL,32816,6541.55,0
2028-10-21,11:11:00,Exxon,-58.17,Oviedo FL,32765,6483.38,0
2028-10-22,19:07:00,Concert Tickets,-83.29,Winter Park FL,32789,6400.09,0
2028-10-23,08:20:00,Shell,-44.03,Orlando FL,32816,6356.06,0
2028-10-23,14:36:00,Whole Foods,-168.53,Oviedo FL,32765,6187.53,0
2028-10-23,13:07:00,Movie Theater,-73.77,Oviedo FL,32765,6113.76,0
2028-10-25,10:11:00,Whole Foods,-144.18,Orlando FL,32816,5969.58,0
2028-10-25,15:05:00,Fraud,-519.34,New York NY,28876,5450.24,1
2028-10-25,14:26:00,Walmart,-88.43,Winter Park FL,32789,5881.15,0
2028-10-25,08:44:00,Amazon,-23.16,Winter Park FL,32789,5857.99,0
2028-10-26,15:18:00,Dollar Tree,-8.18,Oviedo FL,32765,5849.81,0
2028-10-26,11:30:00,Dollar Tree,-40.09,Oviedo FL,32765,5809.72,0
2028-10-27,18:02:00,Shell,-23.06,Oviedo FL,32765,5786.66,0
2028-10-27,18:50:00,Onlyfans,-2010.69,Pyongyang NK,67116,3775.97,1
2028-10-27,10:12:00,Chevron,-12.96,Oviedo FL,32765,5773.7,0
2028-10-27,11:40:00,Publix,-70.47,Winter Park FL,32789,5703.23,0
2028-10-28,21:05:00,BP,-29.43,Orlando FL,32816,5673.8,0
2028-10-28,19:09:00,Five Below,-34.12,Oviedo FL,32765,5639.68,0
2028-10-28,12:20:00,Paypal,-879.44,Charleston SC,77894,4760.24,1
2028-10-29,20:28:00,Netflix,-32.29,Winter Park FL,32789,5607.39,0
2028-10-30,08:00:00,Paycheck,2000.0,Oviedo FL,32765,7607.39,0
2028-10-30,20:27:00,Walgreens,-44.28,Orlando FL,32816,7563.11,0
2028-10-30,10:42:00,Target,-260.83,Winter Park FL,32789,7302.28,0
2028-10-30,13:43:00,Walmart,-93.6,Orlando FL,32816,7208.68,0
2028-10-31,09:16:00,Movie Theater,-81.54,Winter Park FL,32789,7127.14,0
2028-10-31,11:56:00,Target,-149.25,Orlando FL,32816,6977.89,0
2028-10-31,10:08:00,Best Buy,-247.91,Winter Park FL,32789,6729.98,0
2028-11-01,09:00:00,Rent,-960.0,Oviedo FL,32765,5769.98,0
2028-11-01,09:00:00,Insurance,-197.46,Oviedo FL,32765,5572.52,0
2028-11-01,09:00:00,Car,-300.0,Oviedo FL,32765,5272.52,0
2028-11-02,20:04:00,Exxon,-18.04,Orlando FL,32816,5254.48,0
2028-11-02,19:47:00,Magic the Gathering,-385.96,New York NY,32384,4868.52,1
2028-11-03,09:21:00,Movie Theater,-16.92,Orlando FL,32816,5237.56,0
2028-11-04,11:23:00,Target,-87.65,Oviedo FL,32765,5149.91,0
2028-11-04,16:34:00,Dollar Tree,-6.53,Orlando FL,32816,5143.38,0
2028-11-05,12:31:00,Best Buy,-97.97,Winter Park FL,32789,5045.41,0
2028-11-05,12:43:00,Dollar Tree,-20.75,Winter Park FL,32789,5024.66,0
2028-11-06,10:35:00,Burger King,-34.03,Orlando FL,32816,4990.63,0
2028-11-06,09:21:00,Netflix,-49.92,Winter Park FL,32789,4940.71,0
2028-11-06,04:08:00,Accelerators,-422.47,Honolulu HI,48153,4518.24,1
2028-11-07,09:00:00,Spotify,-11.99,Oviedo FL,32765,4928.72,0
2028-11-07,09:00:00,Internet,-70.89,Oviedo FL,32765,4857.83,0
2028-11-07,09:00:00,ChatGPT Plus,-20.0,Oviedo FL,32765,4837.83,0
2028-11-07,09:51:00,Dollar Tree,-21.92,Orlando FL,32816,4815.91,0
2028-11-07,21:56:00,Publix,-52.1,Oviedo FL,32765,4763.81,0
2028-11-08,17:06:00,Servicenow,-665.11,London EN,33077,4098.7,1
2028-11-08,17:14:00,Target,-43.7,Winter Park FL,32789,4720.11,0
2028-11-08,09:41:00,Pep Boys,-77.42,Orlando FL,32816,4642.69,0
2028-11-09,18:10:00,McDonald's,-30.99,Orlando FL,32816,4611.7,0
2028-11-09,21:15:00,McDonald's,-29.85,Oviedo FL,32765,4581.85,0
2028-11-09,14:32:00,Exxon,-17.64,Orlando FL,32816,4564.21,0
2028-11-11,13:04:00,Starbucks,-14.76,Oviedo FL,32765,4549.45,0
2028-11-11,10:58:00,Publix,-72.07,Winter Park FL,32789,4477.38,0
2028-11-11,21:53:00,Starbucks,-25.46,Oviedo FL,32765,4451.92,0
2028-11-12,03:11:00,Pawn Stars,-931.4,Groton CT,12386,3520.52,1
2028-11-12,15:34:00,Starbucks,-17.32,Orlando FL,32816,4434.6,0
2028-11-12,10:57:00,Starbucks,-6.09,Oviedo FL,32765,4428.51,0
2028-11-12,10:59:00,Whole Foods,-80.46,Oviedo FL,32765,4348.05,0
2028-11-13,08:00:00,Paycheck,2000.0,Oviedo FL,32765,6348.05,0
2028-11-13,21:15:00,Walgreens,-46.41,Oviedo FL,32765,6301.64,0
2028-11-14,16:18:00,Subway,-26.66,Orlando FL,32816,6274.98,0
2028-11-14,14:54:00,Starbucks,-43.1,Winter Park FL,32789,6231.88,0
2028-11-14,14:42:00,Target,-128.83,Winter Park FL,32789,6103.05,0
2028-11-14,14:21:00,Pawn Stars,-1511.11,Honolulu HI,82008,4591.94,1
2028-11-15,03:23:00,Magic the Gathering,-407.7,Charleston SC,92576,5695.35,1
2028-11-15,16:08:00,Walgreens,-65.02,Oviedo FL,32765,6038.03,0
2028-11-16,20:41:00,Impractical Jokers,-2057.66,London EN,29862,3980.37,1
2028-11-16,17:59:00,Movie Theater,-29.25,Oviedo FL,32765,6008.78,0
2028-11-16,15:51:00,Amazon,-51.01,Winter Park FL,32789,5957.77,0
2028-11-16,09:22:00,Burger King,-30.35,Oviedo FL,32765,5927.42,0
2028-11-18,13:34:00,BP,-11.88,Winter Park FL,32789,5915.54,0
2028-11-18,20:08:00,Walgreens,-24.3,Orlando FL,32816,5891.24,0
2028-11-18,01:05:00,Paypal,-2382.86,Charleston SC,66076,3508.38,1
2028-11-18,11:46:00,Movie Theater,-16.13,Orlando FL,32816,5875.11,0
2028-11-19,14:02:00,Shell,-22.75,Oviedo FL,32765,5852.36,0
2028-11-19,13:54:00,Burger King,-26.01,Winter Park FL,32789,5826.35,0
2028-11-22,05:45:00,Onlyfans,-134.36,New York NY,48278,5691.99,1
2028-11-23,20:37:00,McDonald's,-5.79,Winter Park FL,32789,5820.56,0
2028-11-23,14:18:00,Walgreens,-26.21,Winter Park FL,32789,5794.35,0
2028-11-23,10:57:00,CVS,-30.93,Oviedo FL,32765,5763.42,0
2028-11-24,15:34:00,Starbucks,-31.14,Winter Park FL,32789,5732.28,0
2028-11-24,11:11:00,Amusement Park,-58.18,Winter Park FL,32789,5674.1,0
2028-11-26,20:58:00,Chevron,-15.71,Orlando FL,32816,5658.39,0
2028-11-26,21:57:00,Movie Theater,-10.26,Winter Park FL,32789,5648.13,0
2028-11-27,08:00:00,Paycheck,2000.0,Oviedo FL,32765,7648.13,0
2028-11-27,16:50:00,McDonald's,-62.64,Winter Park FL,32789,7585.49,0
2028-11-27,21:58:00,Shell,-54.24,Winter Park FL,32789,7531.25,0
2028-11-28,12:03:00,Five Below,-58.29,Orlando FL,32816,7472.96,0
2028-11-28,18:20:00,Burger King,-10.05,Oviedo FL,32765,7462.91,0
2028-11-28,14:05:00,Starbucks,-50.95,Orlando FL,32816,7411.96,0
2028-11-29,12:59:00,Netflix,-34.96,Oviedo FL,32765,7377.0,0
2028-11-29,19:03:00,Jiffy Lube,-81.21,Oviedo FL,32765,7295.79,0
2028-11-30,11:06:00,Monster Energy,-2347.82,New York NY,69720,4947.97,1
2028-12-01,09:00:00,Rent,-960.0,Oviedo FL,32765,6335.79,0
2028-12-01,09:00:00,Insurance,-197.46,Oviedo FL,32765,6138.33,0
2028-12-01,09:00:00,Car,-300.0,Oviedo FL,32765,5838.33,0
2028-12-01,18:21:00,CVS,-18.87,Orlando FL,32816,5819.46,0
2028-12-01,11:17:00,Publix,-34.31,Winter Park FL,32789,5785.15,0
2028-12-02,11:38:00,Netflix,-48.12,Oviedo FL,32765,5737.03,0
2028-12-04,16:34:00,Dollar Tree,-26.86,Winter Park FL,32789,5710.17,0
2028-12-04,20:11:00,Concert Tickets,-11.99,Oviedo FL,32765,5698.18,0
2028-12-06,20:01:00,CVS,-37.74,Winter Park FL,32789,5660.44,0
2028-12-06,08:36:00,Movie Theater,-44.23,Orlando FL,32816,5616.21,0
2028-12-06,14:42:00,Dollar Tree,-33.06,Oviedo FL,32765,5583.15,0
2028-12-07,09:00:00,Spotify,-11.99,Oviedo FL,32765,5571.16,0
2028-12-07,09:00:00,Internet,-70.89,Oviedo FL,32765,5500.27,0
2028-12-07,09:00:00,ChatGPT Plus,-20.0,Oviedo FL,32765,5480.27,0
2028-12-10,23:47:00,Paypal,-2577.88,New York NY,74306,2902.39,1
2028-12-11,08:00:00,Paycheck,2000.0,Oviedo FL,32765,7480.27,0
2028-12-11,19:25:00,IBM,-1486.0,Los Angeles CA,82361,5994.27,1
2028-12-11,11:04:00,Chevron,-34.25,Winter Park FL,32789,7446.02,0
2028-12-11,18:24:00,Amusement Park,-73.24,Winter Park FL,32789,7372.78,0
2028-12-11,21:16:00,Netflix,-104.3,Oviedo FL,32765,7268.48,0
2028-12-12,15:14:00,Trader Joe's,-188.68,Orlando FL,32816,7079.8,0
2028-12-13,21:41:00,McDonald's,-17.78,Oviedo FL,32765,7062.02,0
2028-12-14,16:57:00,McDonald's,-12.37,Orlando FL,32816,7049.65,0
2028-12-14,14:43:00,CVS,-54.45,Oviedo FL,32765,6995.2,0
2028-12-15,11:38:00,Walmart,-188.38,Orlando FL,32816,6806.82,0
2028-12-16,09:56:00,Five Below,-26.42,Winter Park FL,32789,6780.4,0
2028-12-18,16:34:00,Exxon,-41.76,Orlando FL,32816,6738.64,0
2028-12-19,18:53:00,Amusement Park,-97.57,Oviedo FL,32765,6641.07,0
2028-12-20,13:30:00,Amazon,-210.61,Oviedo FL,32765,6430.46,0
2028-12-20,10:57:00,Five Below,-92.03,Orlando FL,32816,6338.43,0
2028-12-21,10:51:00,Burger King,-59.37,Oviedo FL,32765,6279.06,0
2028-12-23,14:04:00,Kroger,-136.78,Oviedo FL,32765,6142.28,0
2028-12-23,10:45:00,Magic the Gathering,-789.88,Honolulu HI,40874,5352.4,1
2028-12-23,18:32:00,Target,-72.59,Orlando FL,32816,6069.69,0
2028-12-24,12:24:00,Starbucks,-22.52,Winter Park FL,32789,6047.17,0
2028-12-25,08:00:00,Paycheck,2000.0,Oviedo FL,32765,8047.17,0
2028-12-25,12:27:00,Walmart,-171.72,Oviedo FL,32765,7875.45,0
2028-12-25,21:23:00,Target,-138.06,Orlando FL,32816,7737.39,0
2028-12-26,11:18:00,CVS,-46.5,Orlando FL,32816,7690.89,0
2028-12-27,20:53:00,Movie Theater,-117.29,Oviedo FL,32765,7573.6,0
2028-12-27,14:17:00,Amazon,-150.59,Oviedo FL,32765,7423.01,0
2028-12-28,19:41:00,Burger King,-68.38,Oviedo FL,32765,7354.63,0
2028-12-28,19:10:00,Walmart,-196.45,Oviedo FL,32765,7158.18,0
2028-12-30,13:17:00,AutoZone,-292.9,Winter Park FL,32789,6865.28,0
2028-12-30,15:04:00,Movie Theater,-108.73,Winter Park FL,32789,6756.55,0
2028-12-30,13:53:00,Starbucks,-59.21,Winter Park FL,32789,6697.34,0
2028-12-31,00:32:00,Accelerators,-1125.71,Los Angeles CA,70469,5571.63,1
2028-12-31,08:30:00,Starbucks,-34.74,Orlando FL,32816,6662.6,0
2028-12-31,11:44:00,Starbucks,-47.86,Oviedo FL,32765,6614.74,0
2028-12-31,12:36:00,Starbucks,-44.93,Oviedo FL,32765,6569.81,0
2029-01-01,09:00:00,Rent,-960.0,Oviedo FL,32765,5609.81,0
2029-01-01,09:00:00,Insurance,-197.46,Oviedo FL,32765,5412.35,0
2029-01-01,09:00:00,Car,-300.0,Oviedo FL,32765,5112.35,0
2029-01-01,20:38:00,McDonald's,-33.09,Orlando FL,32816,5079.26,0
2029-01-01,17:08:00,Publix,-67.93,Winter Park FL,32789,5011.33,0
2029-01-02,17:53:00,Subway,-12.69,Orlando FL,32816,4998.64,0
2029-01-02,10:48:00,Starbucks,-25.76,Winter Park FL,32789,4972.88,0
2029-01-02,19:33:00,Shell,-29.98,Orlando FL,32816,4942.9,0
2029-01-03,17:05:00,Fraud,-482.08,London EN,26315,4460.82,1
2029-01-03,20:53:00,Midas,-142.62,Orlando FL,32816,4800.28,0
2029-01-03,13:30:00,Shell,-13.13,Orlando FL,32816,4787.15,0
2029-01-03,21:18:00,Subway,-10.43,Oviedo FL,32765,4776.72,0
2029-01-04,21:54:00,Midas,-90.93,Orlando FL,32816,4685.79,0
2029-01-05,15:11:00,Publix,-66.27,Oviedo FL,32765,4619.52,0
2029-01-05,21:10:00,Exxon,-28.91,Orlando FL,32816,4590.61,0
2029-01-05,12:49:00,Subway,-25.85,Oviedo FL,32765,4564.76,0
2029-01-06,23:44:00,IBM,-1253.64,Mexico City MC,95957,3311.12,1
2029-01-06,08:56:00,Starbucks,-9.12,Winter Park FL,32789,4555.64,0
2029-01-07,09:00:00,Spotify,-11.99,Oviedo FL,32765,4543.65,0
2029-01-07,09:00:00,Internet,-70.89,Oviedo FL,32765,4472.76,0
2029-01-07,09:00:00,ChatGPT Plus,-20.0,Oviedo FL,32765,4452.76,0
2029-01-07,15:26:00,Walgreens,-39.87,Orlando FL,32816,4412.89,0
2029-01-07,12:38:00,Publix,-76.26,Orlando FL,32816,4336.63,0
2029-01-08,08:00:00,Paycheck,2000.0,Oviedo FL,32765,6336.63,0
2029-01-08,14:44:00,McDonald's,-67.3,Orlando FL,32816,6269.33,0
2029-01-10,08:17:00,Best Buy,-219.56,Orlando FL,32816,6049.77,0
2029-01-10,16:01:00,Amazon,-158.7,Winter Park FL,32789,5891.07,0
2029-01-12,14:55:00,Concert Tickets,-57.86,Oviedo FL,32765,5833.21,0
2029-01-12,17:01:00,Target,-139.07,Winter Park FL,32789,5694.14,0
2029-01-12,15:46:00,Starbucks,-9.37,Winter Park FL,32789,5684.77,0
2029-01-12,19:45:00,Onlyfans,-1267.11,Tokyo JP,36636,4417.66,1
2029-01-13,21:31:00,IBM,-1098.46,Mexico City MC,22930,4586.31,1
2029-01-14,13:29:00,Starbucks,-7.04,Winter Park FL,32789,5677.73,0
2029-01-15,21:08:00,Burger King,-31.25,Winter Park FL,32789,5646.48,0
2029-01-15,17:16:00,Fraud,-2720.08,London EN,66754,2926.4,1
2029-01-15,13:50:00,BP,-15.49,Winter Park FL,32789,5630.99,0
2029-01-16,12:24:00,Amusement Park,-11.09,Orlando FL,32816,5619.9,0
2029-01-17,14:32:00,Chevron,-13.11,Winter Park FL,32789,5606.79,0
2029-01-17,10:55:00,Movie Theater,-56.62,Winter Park FL,32789,5550.17,0
2029-01-17,09:33:00,Netflix,-34.23,Oviedo FL,32765,5515.94,0
2029-01-18,16:37:00,Movie Theater,-13.53,Orlando FL,32816,5502.41,0
2029-01-18,12:11:00,Walgreens,-26.32,Orlando FL,32816,5476.09,0
2029-01-18,10:45:00,Dollar Tree,-44.72,Winter Park FL,32789,5431.37,0
2029-01-19,11:04:00,Midas,-138.46,Oviedo FL,32765,5292.91,0
2029-01-20,02:07:00,Lockheed Martin,-486.63,Groton CT,37974,4806.28,1
2029-01-20,11:16:00,Best Buy,-47.12,Orlando FL,32816,5245.79,0
2029-01-20,08:22:00,Subway,-28.74,Oviedo FL,32765,5217.05,0
2029-01-21,12:34:00,Burger King,-38.24,Orlando FL,32816,5178.81,0
2029-01-22,08:00:00,Paycheck,2000.0,Oviedo FL,32765,7178.81,0
2029-01-22,19:34:00,Starbucks,-42.81,Orlando FL,32816,7136.0,0
2029-01-22,16:39:00,Burger King,-31.83,Oviedo FL,32765,7104.17,0
2029-01-23,13:02:00,Monster Energy,-2236.27,Pittsburgh PA,25098,4867.9,1
2029-01-23,17:46:00,Dollar Tree,-26.56,Winter Park FL,32789,7077.61,0
2029-01-23,20:59:00,Best Buy,-284.83,Winter Park FL,32789,6792.78,0
2029-01-24,17:58:00,Target,-117.34,Oviedo FL,32765,6675.44,0
2029-01-25,10:52:00,Subway,-44.58,Winter Park FL,32789,6630.86,0
2029-01-25,08:37:00,Best Buy,-85.71,Winter Park FL,32789,6545.15,0
2029-01-25,13:07:00,Burger King,-23.69,Orlando FL,32816,6521.46,0
2029-01-26,19:05:00,Starbucks,-12.67,Winter Park FL,32789,6508.79,0
2029-01-26,17:55:00,Dollar Tree,-60.94,Oviedo FL,32765,6447.85,0
2029-01-26,05:42:00,Monster Energy,-336.38,Charleston SC,43700,6111.47,1
2029-01-26,20:38:00,Concert Tickets,-36.61,Oviedo FL,32765,6411.24,0
2029-01-27,18:29:00,McDonald's,-29.63,Oviedo FL,32765,6381.61,0
2029-01-27,16:20:00,Amusement Park,-77.65,Winter Park FL,32789,6303.96,0
2029-01-27,17:40:00,Netflix,-25.2,Oviedo FL,32765,6278.76,0
2029-01-29,11:24:00,Starbucks,-26.3,Winter Park FL,32789,6252.46,0
2029-01-30,17:52:00,Exxon,-35.29,Oviedo FL,32765,6217.17,0
2029-01-30,06:01:00,Accelerators,-2208.55,Tokyo JP,52252,4008.62,1
2029-01-30,16:52:00,Kroger,-70.54,Oviedo FL,32765,6146.63,0
2029-01-31,17:05:00,Kroger,-61.08,Oviedo FL,32765,6085.55,0
2029-02-01,09:00:00,Rent,-960.0,Oviedo FL,32765,5125.55,0
2029-02-01,09:00:00,Insurance,-197.46,Oviedo FL,32765,4928.09,0
2029-02-01,09:00:00,Car,-300.0,Oviedo FL,32765,4628.09,0
2029-02-02,08:53:00,Whole Foods,-49.76,Oviedo FL,32765,4578.33,0
2029-02-02,14:09:00,Pawn Stars,-2555.89,Groton CT,17305,2022.44,1
2029-02-03,11:08:00,Dollar Tree,-16.89,Winter Park FL,32789,4561.44,0
2029-02-03,18:22:00,Dollar Tree,-21.43,Oviedo FL,32765,4540.01,0
2029-02-04,15:53:00,Starbucks,-7.66,Orlando FL,32816,4532.35,0
2029-02-04,17:14:00,BP,-21.79,Orlando FL,32816,4510.56,0
2029-02-04,14:32:00,Amazon,-127.43,Oviedo FL,32765,4383.13,0
2029-02-04,01:36:00,Accelerators,-1976.66,Anchorage AL,13698,2406.47,1
2029-02-05,08:00:00,Paycheck,2000.0,Oviedo FL,32765,6383.13,0
2029-02-05,14:06:00,Servicenow,-2580.11,New York NY,62164,3803.02,1
2029-02-05,18:03:00,Best Buy,-112.88,Orlando FL,32816,6270.25,0
2029-02-05,09:00:00,Subway,-59.19,Orlando FL,32816,6211.06,0
2029-02-06,12:18:00,Concert Tickets,-44.07,Winter Park FL,32789,6166.99,0
2029-02-07,09:00:00,Spotify,-11.99,Oviedo FL,32765,6155.0,0
2029-02-07,09:00:00,Internet,-70.89,Oviedo FL,32765,6084.11,0
2029-02-07,09:00:00,ChatGPT Plus,-20.0,Oviedo FL,32765,6064.11,0
2029-02-07,12:46:00,Best Buy,-66.22,Orlando FL,32816,5997.89,0
2029-02-07,16:43:00,Concert Tickets,-38.33,Oviedo FL,32765,5959.56,0
2029-02-09,18:52:00,Walmart,-56.91,Winter Park FL,32789,5902.65,0
2029-02-09,11:15:00,McDonald's,-21.74,Winter Park FL,32789,5880.91,0
2029-02-10,15:01:00,Amazon,-124.21,Orlando FL,32816,5756.7,0
2029-02-10,13:51:00,McDonald's,-31.13,Oviedo FL,32765,5725.57,0
2029-02-10,20:21:00,Walgreens,-23.13,Orlando FL,32816,5702.44,0
2029-02-11,16:05:00,Burger King,-35.64,Orlando FL,32816,5666.8,0
2029-02-11,07:58:00,Pawn Stars,-796.9,London EN,78814,4869.9,1
2029-02-13,12:07:00,McDonald's,-19.92,Oviedo FL,32765,5646.88,0
2029-02-13,08:54:00,CVS,-36.2,Winter Park FL,32789,5610.68,0
2029-02-13,20:50:00,Concert Tickets,-36.76,Orlando FL,32816,5573.92,0
2029-02-14,17:22:00,McDonald's,-21.29,Winter Park FL,32789,5552.63,0
2029-02-15,20:47:00,Servicenow,-918.59,New York NY,82029,4634.04,1
2029-02-15,21:06:00,Kroger,-60.56,Orlando FL,32816,5492.07,0
2029-02-15,15:29:00,Whole Foods,-31.64,Winter Park FL,32789,5460.43,0
2029-02-16,13:57:00,Amazon,-84.49,Oviedo FL,32765,5375.94,0
2029-02-16,11:31:00,Subway,-33.78,Oviedo FL,32765,5342.16,0
2029-02-16,08:59:00,Amusement Park,-14.7,Oviedo FL,32765,5327.46,0
2029-02-17,15:40:00,Subway,-36.7,Winter Park FL,32789,5290.76,0
2029-02-17,08:39:00,Amazon,-65.24,Oviedo FL,32765,5225.52,0
2029-02-18,10:02:00,Starbucks,-39.61,Orlando FL,32816,5185.91,0
2029-02-19,08:00:00,Paycheck,2000.0,Oviedo FL,32765,7185.91,0
2029-02-19,18:38:00,McDonald's,-64.52,Orlando FL,32816,7121.39,0
2029-02-20,10:13:00,Target,-166.23,Oviedo FL,32765,6955.16,0
2029-02-20,10:21:00,Burger King,-60.31,Winter Park FL,32789,6894.85,0
2029-02-20,13:42:00,Target,-254.79,Oviedo FL,32765,6640.06,0
2029-02-21,17:42:00,Starbucks,-38.75,Oviedo FL,32765,6601.31,0
2029-02-22,13:12:00,Amusement Park,-116.85,Oviedo FL,32765,6484.46,0
2029-02-23,09:40:00,McDonald's,-77.94,Oviedo FL,32765,6406.52,0
2029-02-23,11:04:00,Whole Foods,-66.9,Orlando FL,32816,6339.62,0
2029-02-24,15:33:00,McDonald's,-45.09,Oviedo FL,32765,6294.53,0
2029-02-24,09:14:00,Best Buy,-85.55,Winter Park FL,32789,6208.98,0
2029-02-24,23:57:00,Servicenow,-1898.23,Pyongyang NK,20256,4310.75,1
2029-02-24,16:00:00,Starbucks,-38.62,Oviedo FL,32765,6170.36,0
2029-02-25,17:12:00,Publix,-115.77,Winter Park FL,32789,6054.59,0
2029-02-26,16:36:00,Target,-202.47,Oviedo FL,32765,5852.12,0
2029-02-26,14:00:00,Movie Theater,-53.13,Winter Park FL,32789,5798.99,0
2029-02-26,21:28:00,Concert Tickets,-53.29,Winter Park FL,32789,5745.7,0
2029-02-27,13:09:00,Walmart,-130.96,Oviedo FL,32765,5614.74,0
2029-02-28,21:15:00,Burger King,-21.99,Winter Park FL,32789,5592.75,0
2029-02-28,20:40:00,Walgreens,-20.57,Winter Park FL,32789,5572.18,0
2029-02-28,18:33:00,BP,-20.2,Oviedo FL,32765,5551.98,0
2029-03-01,09:00:00,Rent,-960.0,Oviedo FL,32765,4591.98,0
2029-03-01,09:00:00,Insurance,-197.46,Oviedo FL,32765,4394.52,0
2029-03-01,09:00:00,Car,-300.0,Oviedo FL,32765,4094.52,0
2029-03-01,19:29:00,Kroger,-55.82,Oviedo FL,32765,4038.7,0
2029-03-01,17:50:00,Trader Joe's,-97.29,Winter Park FL,32789,3941.41,0
2029-03-01,13:36:00,Target,-64.18,Winter Park FL,32789,3877.23,0
2029-03-03,08:28:00,Concert Tickets,-33.97,Winter Park FL,32789,3843.26,0
2029-03-03,18:58:00,Walgreens,-38.93,Orlando FL,32816,3804.33,0
2029-03-04,10:31:00,Starbucks,-12.82,Oviedo FL,32765,3791.51,0
2029-03-05,08:00:00,Paycheck,2000.0,Oviedo FL,32765,5791.51,0
2029-03-05,15:59:00,Burger King,-30.93,Oviedo FL,32765,5760.58,0
2029-03-05,09:42:00,Target,-72.31,Oviedo FL,32765,5688.27,0
2029-03-06,19:43:00,Starbucks,-29.92,Oviedo FL,32765,5658.35,0
2029-03-07,09:00:00,Spotify,-11.99,Oviedo FL,32765,5646.36,0
2029-03-07,09:00:00,Internet,-70.89,Oviedo FL,32765,5575.47,0
2029-03-07,09:00:00,ChatGPT Plus,-20.0,Oviedo FL,32765,5555.47,0
2029-03-07,14:40:00,Walmart,-81.47,Winter Park FL,32789,5474.0,0
2029-03-07,20:53:00,Amusement Park,-59.86,Winter Park FL,32789,5414.14,0
2029-03-08,09:46:00,Dollar Tree,-16.42,Oviedo FL,32765,5397.72,0
2029-03-08,11:01:00,Kroger,-37.72,Orlando FL,32816,5360.0,0
2029-03-08,20:21:00,Subway,-29.39,Winter Park FL,32789,5330.61,0
2029-03-09,16:26:00,Movie Theater,-57.96,Oviedo FL,32765,5272.65,0
2029-03-10,17:32:00,Shell,-29.73,Orlando FL,32816,5242.92,0
2029-03-12,09:30:00,Five Below,-12.79,Orlando FL,32816,5230.13,0
2029-03-12,11:54:00,Chevron,-24.1,Orlando FL,32816,5206.03,0
2029-03-12,20:58:00,Subway,-38.41,Winter Park FL,32789,5167.62,0
2029-03-13,11:28:00,Exxon,-25.76,Orlando FL,32816,5141.86,0
2029-03-13,20:24:00,Starbucks,-38.83,Winter Park FL,32789,5103.03,0
2029-03-14,14:44:00,Burger King,-29.78,Winter Park FL,32789,5073.25,0
2029-03-14,16:18:00,Whole Foods,-68.72,Oviedo FL,32765,5004.53,0
2029-03-14,19:00:00,Paypal,-2011.95,Honolulu HI,42786,2992.58,1
2029-03-14,20:31:00,Five Below,-12.59,Oviedo FL,32765,4991.94,0
2029-03-15,20:28:00,Chevron,-12.95,Winter Park FL,32789,4978.99,0
2029-03-15,19:47:00,Amazon,-86.61,Oviedo FL,32765,4892.38,0
2029-03-15,08:29:00,Netflix,-16.21,Oviedo FL,32765,4876.17,0
2029-03-16,08:17:00,Best Buy,-35.15,Orlando FL,32816,4841.02,0
2029-03-16,18:13:00,AutoZone,-183.84,Orlando FL,32816,4657.18,0
2029-03-18,14:15:00,McDonald's,-29.51,Oviedo FL,32765,4627.67,0
2029-03-18,18:05:00,AutoZone,-186.77,Winter Park FL,32789,4440.9,0
2029-03-19,08:00:00,Paycheck,2000.0,Oviedo FL,32765,6440.9,0
2029-03-19,20:19:00,Best Buy,-77.06,Orlando FL,32816,6363.84,0
2029-03-19,17:20:00,Walgreens,-10.01,Orlando FL,32816,6353.83,0
2029-03-20,09:51:00,BP,-51.64,Oviedo FL,32765,6302.19,0
2029-03-20,15:35:00,Amazon,-173.76,Oviedo FL,32765,6128.43,0
2029-03-21,09:52:00,Walgreens,-93.4,Oviedo FL,32765,6035.03,0
2029-03-22,14:26:00,McDonald's,-39.99,Oviedo FL,32765,5995.04,0
2029-03-22,19:25:00,Walgreens,-11.97,Oviedo FL,32765,5983.07,0
2029-03-22,10:51:00,Burger King,-5.19,Orlando FL,32816,5977.88,0
2029-03-24,14:47:00,Kroger,-89.7,Winter Park FL,32789,5888.18,0
2029-03-24,19:02:00,Lockheed Martin,-295.82,London EN,41464,5592.36,1
2029-03-24,13:44:00,Starbucks,-7.37,Winter Park FL,32789,5880.81,0
2029-03-25,08:39:00,Jiffy Lube,-145.92,Oviedo FL,32765,5734.89,0
2029-03-25,18:21:00,Five Below,-9.56,Oviedo FL,32765,5725.33,0
2029-03-26,16:44:00,Five Below,-37.21,Winter Park FL,32789,5688.12,0
2029-03-26,21:52:00,Dollar Tree,-32.73,Winter Park FL,32789,5655.39,0
2029-03-27,14:20:00,Fat Joe,-2520.99,Los Angeles CA,28456,3134.4,1
2029-03-27,08:45:00,Target,-58.83,Winter Park FL,32789,5596.56,0
2029-03-27,20:02:00,Dollar Tree,-9.47,Oviedo FL,32765,5587.09,0
2029-03-28,21:47:00,Starbucks,-16.23,Oviedo FL,32765,5570.86,0
2029-03-28,12:32:00,Trader Joe's,-89.35,Winter Park FL,32789,5481.51,0
2029-03-30,18:24:00,Dollar Tree,-9.92,Winter Park FL,32789,5471.59,0
2029-03-30,19:23:00,Target,-105.09,Winter Park FL,32789,5366.5,0
2029-03-30,11:38:00,Burger King,-34.81,Oviedo FL,32765,5331.69,0
2029-03-30,04:16:00,Magic the Gathering,-2500.51,Charleston SC,56220,2831.18,1
2029-03-31,21:51:00,Trader Joe's,-76.44,Oviedo FL,32765,5255.25,0
2029-03-31,18:23:00,Kroger,-77.08,Oviedo FL,32765,5178.17,0
2029-03-31,23:31:00,Magic the Gathering,-1208.99,Mexico City MC,19517,3969.18,1
2029-04-01,09:00:00,Rent,-960.0,Oviedo FL,32765,4218.17,0
2029-04-01,09:00:00,Insurance,-197.46,Oviedo FL,32765,4020.71,0
2029-04-01,09:00:00,Car,-300.0,Oviedo FL,32765,3720.71,0
2029-04-01,13:05:00,McDonald's,-13.42,Oviedo FL,32765,3707.29,0
2029-04-01,08:57:00,Subway,-13.39,Orlando FL,32816,3693.9,0
2029-04-01,16:42:00,Shell,-18.61,Orlando FL,32816,3675.29,0
2029-04-01,12:51:00,Lockheed Martin,-1840.32,Charleston SC,64110,1834.97,1
2029-04-02,08:00:00,Paycheck,2000.0,Oviedo FL,32765,5675.29,0
2029-04-02,14:48:00,Walmart,-58.54,Orlando FL,32816,5616.75,0
2029-04-02,12:18:00,Chevron,-20.68,Orlando FL,32816,5596.07,0
2029-04-03,00:17:00,Fat Joe,-1863.98,Los Angeles CA,48723,3732.09,1
2029-04-03,08:44:00,Publix,-84.87,Orlando FL,32816,5511.2,0
2029-04-03,12:30:00,Kroger,-52.85,Orlando FL,32816,5458.35,0
2029-04-03,08:02:00,Lockheed Martin,-1627.56,Honolulu HI,57096,3830.79,1
2029-04-04,14:30:00,Burger King,-28.54,Orlando FL,32816,5429.81,0
2029-04-04,08:42:00,McDonald's,-10.64,Oviedo FL,32765,5419.17,0
2029-04-04,09:55:00,Walmart,-11.31,Winter Park FL,32789,5407.86,0
2029-04-05,20:04:00,Dollar Tree,-43.44,Orlando FL,32816,5364.42,0
2029-04-05,15:55:00,Starbucks,-16.47,Winter Park FL,32789,5347.95,0
2029-04-07,09:00:00,Spotify,-11.99,Oviedo FL,32765,5335.96,0
2029-04-07,09:00:00,Internet,-70.89,Oviedo FL,32765,5265.07,0
2029-04-07,09:00:00,ChatGPT Plus,-20.0,Oviedo FL,32765,5245.07,0
2029-04-08,23:06:00,IBM,-2935.01,Anchorage AL,23127,2310.06,1
2029-04-09,19:15:00,Chevron,-19.12,Orlando FL,32816,5225.95,0
2029-04-09,11:54:00,Trader Joe's,-80.45,Orlando FL,32816,5145.5,0
2029-04-11,15:12:00,Lockheed Martin,-963.26,Pyongyang NK,50282,4182.24,1
2029-04-12,20:42:00,Chevron,-19.74,Orlando FL,32816,5125.76,0
2029-04-13,20:10:00,Movie Theater,-11.32,Orlando FL,32816,5114.44,0
2029-04-14,13:29:00,Burger King,-27.68,Winter Park FL,32789,5086.76,0
2029-04-14,18:28:00,Best Buy,-109.31,Orlando FL,32816,4977.45,0
2029-04-14,08:11:00,Dollar Tree,-33.71,Oviedo FL,32765,4943.74,0
2029-04-15,15:43:00,McDonald's,-28.8,Oviedo FL,32765,4914.94,0
2029-04-15,21:43:00,Starbucks,-23.43,Orlando FL,32816,4891.51,0
2029-04-16,08:00:00,Paycheck,2000.0,Oviedo FL,32765,6891.51,0
2029-04-17,12:30:00,Netflix,-112.66,Oviedo FL,32765,6778.85,0
2029-04-17,13:00:00,Pawn Stars,-1094.67,Pittsburgh PA,19392,5684.18,1
2029-04-17,08:23:00,Walgreens,-58.05,Orlando FL,32816,6720.8,0
2029-04-17,14:15:00,Fat Joe,-1211.88,Tokyo JP,18767,5508.92,1
2029-04-19,17:45:00,Walmart,-191.51,Oviedo FL,32765,6529.29,0
2029-04-20,18:35:00,Magic the Gathering,-2498.02,Mexico City MC,27457,4031.27,1
2029-04-20,14:28:00,Concert Tickets,-34.78,Oviedo FL,32765,6494.51,0
2029-04-20,16:04:00,Target,-243.95,Winter Park FL,32789,6250.56,0
2029-04-21,13:02:00,Trader Joe's,-120.41,Winter Park FL,32789,6130.15,0
2029-04-21,13:27:00,Jiffy Lube,-362.7,Orlando FL,32816,5767.45,0
2029-04-22,16:41:00,Starbucks,-26.63,Orlando FL,32816,5740.82,0
2029-04-23,20:14:00,Burger King,-35.92,Orlando FL,32816,5704.9,0
2029-04-23,14:45:00,Amazon,-123.56,Winter Park FL,32789,5581.34,0
2029-04-23,20:45:00,Chevron,-28.59,Orlando FL,32816,5552.75,0
2029-04-24,12:14:00,Best Buy,-135.44,Orlando FL,32816,5417.31,0
2029-04-24,12:19:00,McDonald's,-13.57,Winter Park FL,32789,5403.74,0
2029-04-24,08:22:00,Pep Boys,-187.54,Oviedo FL,32765,5216.2,0
2029-04-25,09:10:00,Subway,-33.17,Orlando FL,32816,5183.03,0
2029-04-25,13:31:00,Amazon,-24.15,Winter Park FL,32789,5158.88,0
2029-04-27,11:38:00,McDonald's,-17.92,Orlando FL,32816,5140.96,0
2029-04-27,20:26:00,Concert Tickets,-27.73,Winter Park FL,32789,5113.23,0
2029-04-27,18:44:00,Subway,-26.64,Oviedo FL,32765,5086.59,0
2029-04-28,01:38:00,Servicenow,-2497.47,Honolulu HI,52532,2589.12,1
2029-04-29,14:47:00,Burger King,-24.38,Oviedo FL,32765,5062.21,0
2029-04-29,18:22:00,Shell,-27.18,Oviedo FL,32765,5035.03,0
2029-04-30,08:00:00,Paycheck,2000.0,Oviedo FL,32765,7035.03,0
2029-05-01,09:00:00,Rent,-960.0,Oviedo FL,32765,6075.03,0
2029-05-01,09:00:00,Insurance,-197.46,Oviedo FL,32765,5877.57,0
2029-05-01,09:00:00,Car,-300.0,Oviedo FL,32765,5577.57,0
2029-05-02,20:40:00,Burger King,-9.08,Winter Park FL,32789,5568.49,0
2029-05-03,13:10:00,Paypal,-1299.0,London EN,75736,4269.49,1
2029-05-04,19:27:00,Subway,-38.8,Orlando FL,32816,5529.69,0
2029-05-06,20:36:00,Walmart,-80.93,Orlando FL,32816,5448.76,0
2029-05-06,08:21:00,Burger King,-7.79,Winter Park FL,32789,5440.97,0
2029-05-07,09:00:00,Spotify,-11.99,Oviedo FL,32765,5428.98,0
2029-05-07,09:00:00,Internet,-70.89,Oviedo FL,32765,5358.09,0
2029-05-07,09:00:00,ChatGPT Plus,-20.0,Oviedo FL,32765,5338.09,0
2029-05-07,09:15:00,Dollar Tree,-19.22,Oviedo FL,32765,5318.87,0
2029-05-13,00:28:00,Pawn Stars,-191.59,London EN,89269,5127.28,1
2029-05-14,08:00:00,Paycheck,2000.0,Oviedo FL,32765,7318.87,0
2029-05-14,20:50:00,McDonald's,-37.3,Winter Park FL,32789,7281.57,0
2029-05-14,18:14:00,Target,-31.91,Orlando FL,32816,7249.66,0
2029-05-14,18:29:00,Amazon,-206.34,Winter Park FL,32789,7043.32,0
2029-05-15,18:59:00,Best Buy,-222.22,Winter Park FL,32789,6821.1,0
2029-05-15,09:07:00,Amusement Park,-115.83,Oviedo FL,32765,6705.27,0
2029-05-15,13:04:00,Amazon,-253.22,Oviedo FL,32765,6452.05,0
2029-05-17,13:16:00,Subway,-21.6,Oviedo FL,32765,6430.45,0
2029-05-17,12:35:00,Trader Joe's,-129.25,Orlando FL,32816,6301.2,0
2029-05-18,19:36:00,Pawn Stars,-2188.07,London EN,11639,4113.13,1
2029-05-18,17:56:00,Walmart,-132.55,Orlando FL,32816,6168.65,0
2029-05-18,10:04:00,Best Buy,-129.72,Orlando FL,32816,6038.93,0
2029-05-18,08:46:00,Amusement Park,-79.5,Winter Park FL,32789,5959.43,0
2029-05-19,19:06:00,Trader Joe's,-59.44,Orlando FL,32816,5899.99,0
2029-05-20,19:57:00,Whole Foods,-83.83,Winter Park FL,32789,5816.16,0
2029-05-21,04:45:00,Impractical Jokers,-2345.92,Pyongyang NK,59851,3470.24,1
2029-05-22,06:11:00,Impractical Jokers,-2881.69,New York NY,70697,2934.47,1
2029-05-22,12:26:00,Amazon,-134.67,Orlando FL,32816,5681.49,0
2029-05-23,11:30:00,Shell,-23.25,Winter Park FL,32789,5658.24,0
2029-05-23,20:51:00,McDonald's,-35.86,Oviedo FL,32765,5622.38,0
2029-05-23,09:08:00,Pawn Stars,-1030.47,Groton CT,74538,4591.91,1
2029-05-24,12:15:00,IBM,-2462.67,Honolulu HI,28947,3159.71,1
2029-05-24,18:39:00,Amazon,-143.9,Oviedo FL,32765,5478.48,0
2029-05-24,20:29:00,Fraud,-871.97,London EN,76414,4606.51,1
2029-05-24,15:23:00,Best Buy,-138.43,Orlando FL,32816,5340.05,0
2029-05-24,20:16:00,Jiffy Lube,-127.96,Winter Park FL,32789,5212.09,0
2029-05-25,22:36:00,Monster Energy,-648.61,Tokyo JP,58187,4563.48,1
2029-05-25,16:41:00,Starbucks,-13.04,Winter Park FL,32789,5199.05,0
2029-05-27,17:34:00,McDonald's,-20.37,Orlando FL,32816,5178.68,0
2029-05-27,11:53:00,Burger King,-36.17,Oviedo FL,32765,5142.51,0
2029-05-28,08:00:00,Paycheck,2000.0,Oviedo FL,32765,7142.51,0
2029-05-28,19:57:00,Accelerators,-1587.95,Honolulu HI,52763,5554.56,1
2029-05-28,21:43:00,Amusement Park,-33.9,Winter Park FL,32789,7108.61,0
2029-05-28,11:33:00,Shell,-55.65,Winter Park FL,32789,7052.96,0
2029-05-28,10:35:00,Whole Foods,-103.61,Oviedo FL,32765,6949.35,0
2029-05-30,20:11:00,Movie Theater,-75.54,Oviedo FL,32765,6873.81,0
2029-05-30,16:54:00,Whole Foods,-133.3,Orlando FL,32816,6740.51,0
2029-05-30,18:38:00,Netflix,-41.74,Winter Park FL,32789,6698.77,0
2029-06-01,09:00:00,Rent,-960.0,Oviedo FL,32765,5738.77,0
2029-06-01,09:00:00,Insurance,-197.46,Oviedo FL,32765,5541.31,0
2029-06-01,09:00:00,Car,-300.0,Oviedo FL,32765,5241.31,0
2029-06-01,17:13:00,Subway,-37.27,Orlando FL,32816,5204.04,0
2029-06-01,03:35:00,Paypal,-127.74,London EN,29913,5076.3,1
2029-06-01,11:23:00,Publix,-38.1,Orlando FL,32816,5165.94,0
2029-06-01,11:14:00,Exxon,-20.86,Orlando FL,32816,5145.08,0
2029-06-02,10:41:00,Starbucks,-21.72,Orlando FL,32816,5123.36,0
2029-06-02,10:28:00,Amusement Park,-41.78,Winter Park FL,32789,5081.58,0
2029-06-02,18:08:00,Netflix,-42.36,Oviedo FL,32765,5039.22,0
2029-06-03,15:25:00,BP,-22.97,Winter Park FL,32789,5016.25,0
2029-06-03,14:00:00,AutoZone,-199.76,Oviedo FL,32765,4816.49,0
2029-06-03,09:07:00,Amusement Park,-46.19,Oviedo FL,32765,4770.3,0
2029-06-04,16:03:00,Walmart,-66.66,Winter Park FL,32789,4703.64,0
2029-06-04,08:14:00,Starbucks,-32.27,Winter Park FL,32789,4671.37,0
2029-06-04,12:38:00,Amusement Park,-35.79,Winter Park FL,32789,4635.58,0
2029-06-05,10:23:00,Servicenow,-415.18,Los Angeles CA,63120,4220.4,1
2029-06-05,14:45:00,McDonald's,-16.36,Winter Park FL,32789,4619.22,0
2029-06-05,11:42:00,Starbucks,-6.13,Winter Park FL,32789,4613.09,0
2029-06-05,16:12:00,Walmart,-123.31,Orlando FL,32816,4489.78,0
2029-06-07,09:00:00,Spotify,-11.99,Oviedo FL,32765,4477.79,0
2029-06-07,09:00:00,Internet,-70.89,Oviedo FL,32765,4406.9,0
2029-06-07,09:00:00,ChatGPT Plus,-20.0,Oviedo FL,32765,4386.9,0
2029-06-07,17:37:00,Starbucks,-38.27,Winter Park FL,32789,4348.63,0
2029-06-07,20:44:00,Starbucks,-13.15,Orlando FL,32816,4335.48,0
2029-06-07,12:31:00,McDonald's,-6.48,Oviedo FL,32765,4329.0,0
2029-06-08,14:23:00,Publix,-55.81,Oviedo FL,32765,4273.19,0
2029-06-08,15:24:00,Amazon,-70.03,Winter Park FL,32789,4203.16,0
2029-06-08,14:57:00,Publix,-94.43,Oviedo FL,32765,4108.73,0
2029-06-09,20:50:00,Walgreens,-19.91,Oviedo FL,32765,4088.82,0
2029-06-09,13:20:00,Target,-30.85,Oviedo FL,32765,4057.97,0
2029-06-10,16:37:00,McDonald's,-21.42,Oviedo FL,32765,4036.55,0
2029-06-10,23:30:00,IBM,-111.29,Pyongyang NK,47598,3925.26,1
2029-06-10,19:20:00,Subway,-7.3,Orlando FL,32816,4029.25,0
2029-06-10,18:26:00,McDonald's,-36.21,Oviedo FL,32765,3993.04,0
2029-06-11,08:00:00,Paycheck,2000.0,Oviedo FL,32765,5993.04,0
2029-06-11,15:22:00,Best Buy,-119.71,Orlando FL,32816,5873.33,0
2029-06-11,14:43:00,Starbucks,-15.45,Winter Park FL,32789,5857.88,0
2029-06-12,18:38:00,Movie Theater,-37.32,Orlando FL,32816,5820.56,0
2029-06-12,14:39:00,Five Below,-17.96,Orlando FL,32816,5802.6,0
2029-06-12,13:01:00,Dollar Tree,-22.53,Oviedo FL,32765,5780.07,0
2029-06-13,15:04:00,Best Buy,-25.24,Winter Park FL,32789,5754.83,0
2029-06-13,13:03:00,Amazon,-109.7,Oviedo FL,32765,5645.13,0
2029-06-14,06:25:00,Paypal,-1035.08,Honolulu HI,64939,4610.05,1
2029-06-16,12:24:00,AutoZone,-95.72,Winter Park FL,32789,5549.41,0
2029-06-17,01:24:00,Accelerators,-858.1,Honolulu HI,43433,4691.31,1
2029-06-17,15:22:00,Walmart,-92.81,Orlando FL,32816,5456.6,0
2029-06-17,08:41:00,Midas,-102.81,Orlando FL,32816,5353.79,0
2029-06-17,15:30:00,Burger King,-20.46,Winter Park FL,32789,5333.33,0
2029-06-18,11:24:00,Kroger,-91.02,Orlando FL,32816,5242.31,0
2029-06-19,11:42:00,Dollar Tree,-31.09,Winter Park FL,32789,5211.22,0
2029-06-19,10:54:00,Pep Boys,-54.12,Oviedo FL,32765,5157.1,0
2029-06-21,11:34:00,Shell,-28.82,Oviedo FL,32765,5128.28,0
2029-06-21,21:11:00,Starbucks,-15.73,Orlando FL,32816,5112.55,0
2029-06-21,18:12:00,BP,-24.33,Orlando FL,32816,5088.22,0
2029-06-23,17:23:00,Shell,-27.18,Winter Park FL,32789,5061.04,0
2029-06-25,08:00:00,Paycheck,2000.0,Oviedo FL,32765,7061.04,0
2029-06-25,09:37:00,Subway,-49.61,Oviedo FL,32765,7011.43,0
2029-06-26,14:29:00,Walmart,-137.74,Oviedo FL,32765,6873.69,0
2029-06-26,17:32:00,Target,-46.43,Winter Park FL,32789,6827.26,0
2029-06-26,18:32:00,Walmart,-61.83,Oviedo FL,32765,6765.43,0
2029-06-27,20:24:00,Best Buy,-194.3,Oviedo FL,32765,6571.13,0
2029-06-28,11:09:00,Subway,-43.0,Oviedo FL,32765,6528.13,0
2029-06-28,11:54:00,Best Buy,-275.45,Winter Park FL,32789,6252.68,0
2029-06-28,18:31:00,IBM,-1027.43,Pyongyang NK,33829,5225.25,1
2029-06-29,22:18:00,Impractical Jokers,-1977.39,Pittsburgh PA,65540,4275.29,1
2029-06-30,16:09:00,Netflix,-50.1,Oviedo FL,32765,6202.58,0
2029-07-01,09:00:00,Rent,-960.0,Oviedo FL,32765,5242.58,0
2029-07-01,09:00:00,Insurance,-197.46,Oviedo FL,32765,5045.12,0
2029-07-01,09:00:00,Car,-300.0,Oviedo FL,32765,4745.12,0
2029-07-01,08:14:00,Publix,-99.57,Winter Park FL,32789,4645.55,0
2029-07-01,13:19:00,Burger King,-21.4,Orlando FL,32816,4624.15,0
2029-07-01,09:55:00,Publix,-46.33,Oviedo FL,32765,4577.82,0
2029-07-02,11:19:00,Starbucks,-17.91,Winter Park FL,32789,4559.91,0
2029-07-02,08:00:00,Target,-93.69,Orlando FL,32816,4466.22,0
2029-07-03,14:03:00,Movie Theater,-50.92,Oviedo FL,32765,4415.3,0
2029-07-03,12:48:00,Starbucks,-19.4,Winter Park FL,32789,4395.9,0
2029-07-04,19:38:00,McDonald's,-17.52,Oviedo FL,32765,4378.38,0
2029-07-05,13:50:00,Magic the Gathering,-2171.47,Los Angeles CA,11989,2206.91,1
2029-07-05,19:08:00,Walgreens,-6.69,Winter Park FL,32789,4371.69,0
2029-07-05,00:45:00,Onlyfans,-1028.49,Mexico City MC,55857,3343.2,1
2029-07-06,10:00:00,Exxon,-10.23,Winter Park FL,32789,4361.46,0
2029-07-06,10:00:00,McDonald's,-37.01,Winter Park FL,32789,4324.45,0
2029-07-07,09:00:00,Spotify,-11.99,Oviedo FL,32765,4312.46,0
2029-07-07,09:00:00,Internet,-70.89,Oviedo FL,32765,4241.57,0
2029-07-07,09:00:00,ChatGPT Plus,-20.0,Oviedo FL,32765,4221.57,0
2029-07-07,02:38:00,Paypal,-2284.62,Pyongyang NK,82458,1936.95,1
2029-07-07,11:29:00,Burger King,-6.62,Orlando FL,32816,4214.95,0
2029-07-07,05:47:00,Impractical Jokers,-1339.88,Tokyo JP,64923,2875.07,1
2029-07-07,08:21:00,Burger King,-25.83,Orlando FL,32816,4189.12,0
2029-07-07,18:46:00,Burger King,-24.72,Orlando FL,32816,4164.4,0
2029-07-09,08:00:00,Paycheck,2000.0,Oviedo FL,32765,6164.4,0
2029-07-09,20:05:00,IBM,-2933.13,Mexico City MC,35064,3231.27,1
2029-07-12,10:30:00,Whole Foods,-173.39,Oviedo FL,32765,5991.01,0
2029-07-13,06:48:00,IBM,-2557.79,Mexico City MC,50937,3433.22,1
2029-07-13,18:31:00,Five Below,-47.17,Oviedo FL,32765,5943.84,0
2029-07-14,11:16:00,Amazon,-126.45,Orlando FL,32816,5817.39,0
2029-07-14,14:10:00,Starbucks,-27.69,Winter Park FL,32789,5789.7,0
2029-07-15,12:07:00,Subway,-8.88,Orlando FL,32816,5780.82,0
2029-07-15,16:59:00,Subway,-9.18,Orlando FL,32816,5771.64,0
2029-07-16,12:35:00,Netflix,-18.25,Winter Park FL,32789,5753.39,0
2029-07-17,20:55:00,Exxon,-29.05,Oviedo FL,32765,5724.34,0
2029-07-17,14:54:00,Best Buy,-20.75,Winter Park FL,32789,5703.59,0
2029-07-20,10:02:00,Starbucks,-33.81,Orlando FL,32816,5669.78,0
2029-07-20,08:49:00,Subway,-6.07,Winter Park FL,32789,5663.71,0
2029-07-21,13:55:00,Paypal,-2856.79,Los Angeles CA,67875,2806.92,1
2029-07-21,14:28:00,Best Buy,-37.86,Orlando FL,32816,5625.85,0
2029-07-21,20:39:00,Amazon,-96.16,Winter Park FL,32789,5529.69,0
2029-07-22,16:22:00,Dollar Tree,-48.76,Winter Park FL,32789,5480.93,0
2029-07-22,18:42:00,McDonald's,-36.6,Oviedo FL,32765,5444.33,0
2029-07-23,08:00:00,Paycheck,2000.0,Oviedo FL,32765,7444.33,0
2029-07-23,14:36:00,Exxon,-52.39,Oviedo FL,32765,7391.94,0
2029-07-23,18:14:00,Exxon,-36.06,Orlando FL,32816,7355.88,0
2029-07-23,17:00:00,Amazon,-182.34,Oviedo FL,32765,7173.54,0
2029-07-25,10:28:00,Onlyfans,-532.35,Groton CT,31133,6641.19,1
2029-07-26,17:00:00,CVS,-59.57,Oviedo FL,32765,7113.97,0
2029-07-26,11:21:00,Burger King,-46.8,Orlando FL,32816,7067.17,0
2029-07-27,15:23:00,Best Buy,-256.94,Orlando FL,32816,6810.23,0
2029-07-28,21:10:00,Target,-272.42,Winter Park FL,32789,6537.81,0
2029-07-28,19:53:00,Five Below,-77.78,Oviedo FL,32765,6460.03,0
2029-07-29,11:45:00,McDonald's,-34.39,Orlando FL,32816,6425.64,0
2029-07-29,15:13:00,Netflix,-78.1,Oviedo FL,32765,6347.54,0
2029-07-29,15:54:00,Concert Tickets,-57.8,Winter Park FL,32789,6289.74,0
2029-07-30,14:23:00,Amusement Park,-58.43,Oviedo FL,32765,6231.31,0
2029-07-31,13:36:00,Starbucks,-76.45,Oviedo FL,32765,6154.86,0
2029-07-31,19:14:00,CVS,-44.44,Winter Park FL,32789,6110.42,0
2029-07-31,13:28:00,Amusement Park,-72.41,Oviedo FL,32765,6038.01,0
2029-08-01,09:00:00,Rent,-960.0,Oviedo FL,32765,5078.01,0
2029-08-01,09:00:00,Insurance,-197.46,Oviedo FL,32765,4880.55,0
2029-08-01,09:00:00,Car,-300.0,Oviedo FL,32765,4580.55,0
2029-08-04,07:38:00,Monster Energy,-130.95,Mexico City MC,50828,4449.6,1
2029-08-05,06:53:00,Fraud,-154.3,Los Angeles CA,37785,4426.25,1
2029-08-05,16:09:00,Publix,-47.42,Orlando FL,32816,4533.13,0
2029-08-06,08:00:00,Paycheck,2000.0,Oviedo FL,32765,6533.13,0
2029-08-06,13:18:00,Pep Boys,-340.25,Oviedo FL,32765,6192.88,0
2029-08-07,09:00:00,Spotify,-11.99,Oviedo FL,32765,6180.89,0
2029-08-07,09:00:00,Internet,-70.89,Oviedo FL,32765,6110.0,0
2029-08-07,09:00:00,ChatGPT Plus,-20.0,Oviedo FL,32765,6090.0,0
2029-08-07,12:12:00,Movie Theater,-49.55,Oviedo FL,32765,6040.45,0
2029-08-07,18:17:00,Pawn Stars,-2898.83,Pittsburgh PA,59523,3141.62,1
2029-08-08,15:44:00,Starbucks,-63.86,Orlando FL,32816,5976.59,0
2029-08-08,16:01:00,Subway,-26.69,Oviedo FL,32765,5949.9,0
2029-08-08,15:51:00,Onlyfans,-2652.16,Los Angeles CA,79732,3297.74,1
2029-08-08,18:15:00,BP,-19.02,Winter Park FL,32789,5930.88,0
2029-08-09,09:11:00,Concert Tickets,-18.05,Orlando FL,32816,5912.83,0
2029-08-09,18:28:00,McDonald's,-7.86,Orlando FL,32816,5904.97,0
2029-08-10,21:01:00,Best Buy,-103.09,Orlando FL,32816,5801.88,0
2029-08-10,09:07:00,Amazon,-124.31,Winter Park FL,32789,5677.57,0
2029-08-12,17:46:00,Accelerators,-1172.82,Groton CT,32615,4504.75,1
2029-08-13,09:08:00,Target,-74.38,Orlando FL,32816,5603.19,0
2029-08-13,13:22:00,Accelerators,-2279.95,Charleston SC,66698,3323.24,1
2029-08-14,17:14:00,Jiffy Lube,-179.75,Oviedo FL,32765,5423.44,0
2029-08-15,16:18:00,Target,-115.35,Oviedo FL,32765,5308.09,0
2029-08-15,21:21:00,McDonald's,-13.66,Oviedo FL,32765,5294.43,0
2029-08-15,19:21:00,Subway,-28.1,Oviedo FL,32765,5266.33,0
2029-08-16,12:02:00,Shell,-18.78,Orlando FL,32816,5247.55,0
2029-08-17,17:22:00,Shell,-20.97,Orlando FL,32816,5226.58,0
2029-08-17,15:38:00,Subway,-13.56,Winter Park FL,32789,5213.02,0
2029-08-18,20:30:00,Concert Tickets,-55.02,Orlando FL,32816,5158.0,0
2029-08-18,12:25:00,Dollar Tree,-16.55,Orlando FL,32816,5141.45,0
2029-08-18,17:31:00,Onlyfans,-1833.73,Groton CT,81402,3307.72,1
2029-08-18,15:11:00,McDonald's,-33.63,Winter Park FL,32789,5107.82,0
2029-08-19,16:04:00,Starbucks,-7.33,Orlando FL,32816,5100.49,0
2029-08-20,08:00:00,Paycheck,2000.0,Oviedo FL,32765,7100.49,0
2029-08-20,13:32:00,Starbucks,-65.96,Orlando FL,32816,7034.53,0
2029-08-21,20:48:00,Amazon,-126.41,Orlando FL,32816,6908.12,0
2029-08-25,21:31:00,Dollar Tree,-28.52,Orlando FL,32816,6879.6,0
2029-08-25,08:29:00,Starbucks,-74.73,Winter Park FL,32789,6804.87,0
2029-08-25,15:50:00,Accelerators,-415.66,New York NY,16787,6389.21,1
2029-08-27,11:11:00,Netflix,-106.88,Winter Park FL,32789,6697.99,0
2029-08-27,21:43:00,Best Buy,-245.04,Oviedo FL,32765,6452.95,0
2029-08-28,14:24:00,Walgreens,-39.01,Winter Park FL,32789,6413.94,0
2029-08-29,17:36:00,Onlyfans,-929.7,Los Angeles CA,98280,5484.24,1
2029-08-29,17:36:00,McDonald's,-19.48,Orlando FL,32816,6394.46,0
2029-08-29,12:06:00,Fraud,-2787.41,London EN,75542,3607.05,1
2029-08-29,16:47:00,Five Below,-54.2,Orlando FL,32816,6340.26,0
2029-08-30,10:18:00,Whole Foods,-115.48,Winter Park FL,32789,6224.78,0
2029-08-31,11:15:00,Kroger,-96.79,Winter Park FL,32789,6127.99,0
2029-08-31,15:03:00,Subway,-69.46,Orlando FL,32816,6058.53,0
2029-08-31,19:24:00,Target,-51.74,Orlando FL,32816,6006.79,0
2029-09-01,09:00:00,Rent,-960.0,Oviedo FL,32765,5046.79,0
2029-09-01,09:00:00,Insurance,-197.46,Oviedo FL,32765,4849.33,0
2029-09-01,09:00:00,Car,-300.0,Oviedo FL,32765,4549.33,0
2029-09-01,20:12:00,Pawn Stars,-2718.03,Mexico City MC,30865,1831.3,1
2029-09-01,11:01:00,Starbucks,-27.53,Winter Park FL,32789,4521.8,0
2029-09-01,20:25:00,Target,-43.93,Oviedo FL,32765,4477.87,0
2029-09-02,09:56:00,Exxon,-24.82,Oviedo FL,32765,4453.05,0
2029-09-02,11:01:00,Chevron,-19.47,Orlando FL,32816,4433.58,0
2029-09-03,08:00:00,Paycheck,2000.0,Oviedo FL,32765,6433.58,0
2029-09-03,08:42:00,McDonald's,-18.85,Oviedo FL,32765,6414.73,0
2029-09-03,14:48:00,Kroger,-167.9,Winter Park FL,32789,6246.83,0
2029-09-04,12:04:00,Monster Energy,-2126.48,Mexico City MC,95335,4120.35,1
2029-09-04,09:21:00,Walgreens,-17.65,Oviedo FL,32765,6229.18,0
2029-09-04,18:58:00,IBM,-1232.74,New York NY,32689,4996.44,1
2029-09-04,10:08:00,Exxon,-45.11,Orlando FL,32816,6184.07,0
2029-09-05,08:52:00,Starbucks,-46.49,Orlando FL,32816,6137.58,0
2029-09-06,12:41:00,Starbucks,-11.0,Orlando FL,32816,6126.58,0
2029-09-06,21:54:00,Amazon,-123.46,Winter Park FL,32789,6003.12,0
2029-09-07,09:00:00,Spotify,-11.99,Oviedo FL,32765,5991.13,0
2029-09-07,09:00:00,Internet,-70.89,Oviedo FL,32765,5920.24,0
2029-09-07,09:00:00,ChatGPT Plus,-20.0,Oviedo FL,32765,5900.24,0
2029-09-07,20:37:00,Trader Joe's,-76.78,Oviedo FL,32765,5823.46,0
2029-09-07,12:18:00,Amusement Park,-35.86,Winter Park FL,32789,5787.6,0
2029-09-08,20:48:00,Subway,-22.43,Winter Park FL,32789,5765.17,0
2029-09-08,16:33:00,Midas,-153.01,Winter Park FL,32789,5612.16,0
2029-09-10,21:21:00,Whole Foods,-76.21,Winter Park FL,32789,5535.95,0
2029-09-10,10:09:00,Target,-49.62,Oviedo FL,32765,5486.33,0
2029-09-10,10:04:00,Starbucks,-8.6,Winter Park FL,32789,5477.73,0
2029-09-11,11:45:00,McDonald's,-8.1,Oviedo FL,32765,5469.63,0
2029-09-11,10:13:00,Walgreens,-19.83,Winter Park FL,32789,5449.8,0
2029-09-11,14:02:00,Subway,-18.38,Winter Park FL,32789,5431.42,0
2029-09-12,17:16:00,Target,-101.04,Orlando FL,32816,5330.38,0
2029-09-12,00:35:00,Fraud,-508.75,London EN,24618,4821.63,1
2029-09-13,21:07:00,BP,-27.43,Oviedo FL,32765,5302.95,0
2029-09-14,18:48:00,Five Below,-7.52,Winter Park FL,32789,5295.43,0
2029-09-14,19:00:00,Target,-140.84,Orlando FL,32816,5154.59,0
2029-09-14,18:18:00,Burger King,-16.72,Oviedo FL,32765,5137.87,0
2029-09-14,09:13:00,Accelerators,-2801.63,Los Angeles CA,38143,2336.24,1
2029-09-15,21:17:00,Amusement Park,-45.77,Orlando FL,32816,5092.1,0
2029-09-15,14:48:00,Walgreens,-46.32,Orlando FL,32816,5045.78,0
2029-09-15,16:50:00,McDonald's,-9.19,Winter Park FL,32789,5036.59,0
2029-09-17,08:00:00,Paycheck,2000.0,Oviedo FL,32765,7036.59,0
2029-09-18,13:00:00,BP,-29.63,Winter Park FL,32789,7006.96,0
2029-09-18,14:43:00,Exxon,-51.17,Winter Park FL,32789,6955.79,0
2029-09-20,18:36:00,Burger King,-48.53,Winter Park FL,32789,6907.26,0
2029-09-20,20:27:00,Chevron,-42.39,Winter Park FL,32789,6864.87,0
2029-09-20,12:20:00,Shell,-35.35,Oviedo FL,32765,6829.52,0
2029-09-21,10:38:00,Target,-159.66,Oviedo FL,32765,6669.86,0
2029-09-21,15:55:00,Monster Energy,-2693.2,Pyongyang NK,73697,3976.66,1
2029-09-22,12:31:00,Burger King,-69.42,Oviedo FL,32765,6600.44,0
2029-09-22,18:49:00,Fraud,-1828.8,Pittsburgh PA,22270,4771.64,1
2029-09-23,14:25:00,Trader Joe's,-140.34,Winter Park FL,32789,6460.1,0
2029-09-23,08:14:00,Amusement Park,-73.87,Orlando FL,32816,6386.23,0
2029-09-24,02:46:00,Onlyfans,-2727.11,London EN,98412,3659.12,1
2029-09-24,18:04:00,McDonald's,-62.12,Winter Park FL,32789,6324.11,0
2029-09-24,20:06:00,Exxon,-35.04,Orlando FL,32816,6289.07,0
2029-09-24,14:07:00,Movie Theater,-97.81,Winter Park FL,32789,6191.26,0
2029-09-25,07:55:00,Onlyfans,-2896.54,Pittsburgh PA,47044,3294.72,1
2029-09-25,17:56:00,Netflix,-58.33,Orlando FL,32816,6132.93,0
2029-09-25,07:59:00,Accelerators,-378.52,New York NY,57375,5754.41,1
2029-09-25,12:58:00,Kroger,-158.2,Winter Park FL,32789,5974.73,0
2029-09-25,19:08:00,Walgreens,-33.8,Oviedo FL,32765,5940.93,0
2029-09-26,20:07:00,Concert Tickets,-35.38,Winter Park FL,32789,5905.55,0
2029-09-27,16:17:00,McDonald's,-13.06,Winter Park FL,32789,5892.49,0
2029-09-27,16:16:00,Subway,-16.23,Winter Park FL,32789,5876.26,0
2029-09-27,11:55:00,Pawn Stars,-1305.91,Pyongyang NK,12986,4570.35,1
2029-09-27,11:04:00,Concert Tickets,-29.67,Oviedo FL,32765,5846.59,0
2029-09-29,12:28:00,Subway,-32.9,Oviedo FL,32765,5813.69,0
2029-09-29,18:55:00,Burger King,-23.52,Oviedo FL,32765,5790.17,0
2029-09-30,19:07:00,Chevron,-22.79,Winter Park FL,32789,5767.38,0
2029-09-30,17:53:00,Starbucks,-20.17,Orlando FL,32816,5747.21,0
2029-09-30,08:06:00,Best Buy,-148.5,Orlando FL,32816,5598.71,0
2029-10-01,08:00:00,Paycheck,2000.0,Oviedo FL,32765,7598.71,0
2029-10-01,09:00:00,Rent,-960.0,Oviedo FL,32765,6638.71,0
2029-10-01,09:00:00,Insurance,-197.46,Oviedo FL,32765,6441.25,0
2029-10-01,09:00:00,Car,-300.0,Oviedo FL,32765,6141.25,0
2029-10-01,09:27:00,Subway,-59.08,Oviedo FL,32765,6082.17,0
2029-10-03,13:11:00,Shell,-33.27,Orlando FL,32816,6048.9,0
2029-10-03,14:11:00,Walgreens,-30.3,Oviedo FL,32765,6018.6,0
2029-10-03,13:41:00,Five Below,-86.18,Oviedo FL,32765,5932.42,0
2029-10-04,19:12:00,Publix,-77.2,Winter Park FL,32789,5855.22,0
2029-10-04,16:26:00,Concert Tickets,-18.31,Oviedo FL,32765,5836.91,0
2029-10-04,12:01:00,Fraud,-2465.08,New York NY,60469,3371.83,1
2029-10-05,16:50:00,Exxon,-27.18,Oviedo FL,32765,5809.73,0
2029-10-06,18:03:00,Subway,-23.96,Winter Park FL,32789,5785.77,0
2029-10-07,09:00:00,Spotify,-11.99,Oviedo FL,32765,5773.78,0
2029-10-07,09:00:00,Internet,-70.89,Oviedo FL,32765,5702.89,0
2029-10-07,09:00:00,ChatGPT Plus,-20.0,Oviedo FL,32765,5682.89,0
2029-10-07,12:58:00,Netflix,-14.16,Oviedo FL,32765,5668.73,0
2029-10-07,18:06:00,McDonald's,-27.6,Orlando FL,32816,5641.13,0
2029-10-07,10:18:00,McDonald's,-36.91,Oviedo FL,32765,5604.22,0
2029-10-08,12:56:00,Best Buy,-126.4,Oviedo FL,32765,5477.82,0
2029-10-08,19:11:00,Best Buy,-142.2,Winter Park FL,32789,5335.62,0
2029-10-08,13:34:00,CVS,-28.92,Orlando FL,32816,5306.7,0
2029-10-09,08:48:00,Burger King,-36.62,Oviedo FL,32765,5270.08,0
2029-10-09,00:30:00,Impractical Jokers,-1205.17,Tokyo JP,23180,4064.91,1
2029-10-09,08:04:00,Subway,-12.87,Winter Park FL,32789,5257.21,0
2029-10-09,03:25:00,Impractical Jokers,-1943.76,London EN,60595,3313.45,1
2029-10-11,15:53:00,Shell,-26.17,Winter Park FL,32789,5231.04,0
2029-10-11,21:00:00,IBM,-634.88,Los Angeles CA,38699,4596.16,1
2029-10-12,09:27:00,McDonald's,-16.3,Oviedo FL,32765,5214.74,0
2029-10-12,10:18:00,Walmart,-107.65,Winter Park FL,32789,5107.09,0
2029-10-13,20:12:00,Subway,-30.76,Oviedo FL,32765,5076.33,0
2029-10-13,20:05:00,Target,-149.26,Oviedo FL,32765,4927.07,0
2029-10-15,08:00:00,Paycheck,2000.0,Oviedo FL,32765,6927.07,0
2029-10-15,22:12:00,Lockheed Martin,-2073.24,Pyongyang NK,98600,4853.83,1
2029-10-15,14:37:00,Burger King,-30.79,Orlando FL,32816,6896.28,0
2029-10-15,12:28:00,Chevron,-49.57,Oviedo FL,32765,6846.71,0
2029-10-15,09:16:00,Chevron,-45.15,Orlando FL,32816,6801.56,0
2029-10-16,08:58:00,Burger King,-34.64,Winter Park FL,32789,6766.92,0
2029-10-17,14:07:00,Dollar Tree,-25.16,Oviedo FL,32765,6741.76,0
2029-10-17,13:00:00,Amazon,-151.57,Oviedo FL,32765,6590.19,0
2029-10-17,17:53:00,Exxon,-22.43,Winter Park FL,32789,6567.76,0
2029-10-19,09:19:00,Target,-236.71,Orlando FL,32816,6331.05,0
2029-10-19,10:43:00,Midas,-363.23,Orlando FL,32816,5967.82,0
2029-10-20,16:22:00,McDonald's,-35.71,Winter Park FL,32789,5932.11,0
2029-10-20,15:01:00,Lockheed Martin,-1323.96,Charleston SC,23468,4608.15,1
2029-10-20,09:38:00,Exxon,-26.86,Winter Park FL,32789,5905.25,0
2029-10-20,20:12:00,Movie Theater,-40.53,Oviedo FL,32765,5864.72,0
2029-10-21,00:06:00,Fat Joe,-1936.91,Pyongyang NK,23302,3927.81,1
2029-10-21,21:17:00,Dollar Tree,-28.08,Winter Park FL,32789,5836.64,0
2029-10-21,20:34:00,Subway,-28.57,Winter Park FL,32789,5808.07,0
2029-10-22,13:50:00,Starbucks,-17.6,Winter Park FL,32789,5790.47,0
2029-10-22,11:31:00,Whole Foods,-67.78,Oviedo FL,32765,5722.69,0
2029-10-22,15:48:00,Walmart,-101.26,Oviedo FL,32765,5621.43,0
2029-10-23,13:20:00,Amazon,-55.44,Oviedo FL,32765,5565.99,0
2029-10-23,13:21:00,Concert Tickets,-48.96,Winter Park FL,32789,5517.03,0
2029-10-24,09:25:00,Target,-110.19,Oviedo FL,32765,5406.84,0
2029-10-25,08:39:00,AutoZone,-50.42,Oviedo FL,32765,5356.42,0
2029-10-25,17:47:00,Shell,-22.46,Orlando FL,32816,5333.96,0
2029-10-25,11:09:00,Trader Joe's,-51.31,Winter Park FL,32789,5282.65,0
2029-10-27,13:05:00,McDonald's,-29.58,Orlando FL,32816,5253.07,0
2029-10-28,09:33:00,Netflix,-54.34,Winter Park FL,32789,5198.73,0
2029-10-29,08:00:00,Paycheck,2000.0,Oviedo FL,32765,7198.73,0
2029-10-29,20:07:00,CVS,-40.27,Winter Park FL,32789,7158.46,0
2029-10-29,12:42:00,Target,-260.52,Orlando FL,32816,6897.94,0
2029-10-29,23:16:00,Accelerators,-1220.65,London EN,96648,5677.29,1
2029-10-30,20:39:00,Subway,-41.1,Winter Park FL,32789,6856.84,0
2029-10-30,08:27:00,Starbucks,-15.05,Winter Park FL,32789,6841.79,0
2029-11-01,09:00:00,Rent,-960.0,Oviedo FL,32765,5881.79,0
2029-11-01,09:00:00,Insurance,-197.46,Oviedo FL,32765,5684.33,0
2029-11-01,09:00:00,Car,-300.0,Oviedo FL,32765,5384.33,0
2029-11-01,14:59:00,Target,-103.98,Orlando FL,32816,5280.35,0
2029-11-01,16:13:00,Walmart,-10.55,Oviedo FL,32765,5269.8,0
2029-11-02,08:28:00,Lockheed Martin,-882.04,Anchorage AL,19634,4387.76,1
2029-11-04,20:30:00,Burger King,-19.36,Oviedo FL,32765,5250.44,0
2029-11-05,10:57:00,Walgreens,-33.8,Orlando FL,32816,5216.64,0
2029-11-05,19:03:00,Jiffy Lube,-104.35,Oviedo FL,32765,5112.29,0
2029-11-06,09:19:00,Subway,-9.8,Winter Park FL,32789,5102.49,0
2029-11-06,14:18:00,Subway,-34.37,Orlando FL,32816,5068.12,0
2029-11-06,18:22:00,Burger King,-37.03,Orlando FL,32816,5031.09,0
2029-11-07,09:00:00,Spotify,-11.99,Oviedo FL,32765,5019.1,0
2029-11-07,09:00:00,Internet,-70.89,Oviedo FL,32765,4948.21,0
2029-11-07,09:00:00,ChatGPT Plus,-20.0,Oviedo FL,32765,4928.21,0
2029-11-09,16:29:00,Starbucks,-11.03,Orlando FL,32816,4917.18,0
2029-11-09,08:43:00,McDonald's,-29.56,Orlando FL,32816,4887.62,0
2029-11-09,19:47:00,Starbucks,-27.28,Orlando FL,32816,4860.34,0
2029-11-10,20:57:00,Burger King,-21.84,Winter Park FL,32789,4838.5,0
2029-11-10,21:09:00,Chevron,-19.55,Winter Park FL,32789,4818.95,0
2029-11-11,11:24:00,Burger King,-7.3,Oviedo FL,32765,4811.65,0
2029-11-11,00:13:00,Paypal,-2049.71,Los Angeles CA,39020,2761.94,1
2029-11-11,12:48:00,Five Below,-18.07,Oviedo FL,32765,4793.58,0
2029-11-12,08:00:00,Paycheck,2000.0,Oviedo FL,32765,6793.58,0
2029-11-13,09:42:00,Subway,-13.67,Winter Park FL,32789,6779.91,0
2029-11-13,20:39:00,Magic the Gathering,-2012.84,Tokyo JP,54731,4767.07,1
2029-11-13,13:53:00,BP,-51.52,Winter Park FL,32789,6728.39,0
2029-11-13,20:13:00,Amusement Park,-73.63,Winter Park FL,32789,6654.76,0
2029-11-14,15:16:00,Chevron,-31.75,Oviedo FL,32765,6623.01,0
2029-11-15,08:09:00,BP,-59.0,Oviedo FL,32765,6564.01,0
2029-11-16,11:12:00,Subway,-17.43,Winter Park FL,32789,6546.58,0
2029-11-16,21:31:00,Publix,-165.68,Winter Park FL,32789,6380.9,0
2029-11-18,11:09:00,Walmart,-245.33,Oviedo FL,32765,6135.57,0
2029-11-19,19:09:00,Starbucks,-49.75,Orlando FL,32816,6085.82,0
2029-11-19,09:19:00,McDonald's,-51.03,Winter Park FL,32789,6034.79,0
2029-11-19,18:45:00,Exxon,-33.52,Oviedo FL,32765,6001.27,0
2029-11-21,18:47:00,Accelerators,-2101.87,Mexico City MC,28368,3899.4,1
2029-11-21,20:43:00,Burger King,-35.02,Oviedo FL,32765,5966.25,0
2029-11-22,20:59:00,Target,-59.36,Orlando FL,32816,5906.89,0
2029-11-22,16:34:00,Concert Tickets,-59.24,Winter Park FL,32789,5847.65,0
2029-11-22,13:01:00,Best Buy,-84.98,Orlando FL,32816,5762.67,0
2029-11-23,09:42:00,Best Buy,-124.95,Oviedo FL,32765,5637.72,0
2029-11-23,09:20:00,Burger King,-38.49,Winter Park FL,32789,5599.23,0
2029-11-23,01:06:00,Magic the Gathering,-2841.47,Pittsburgh PA,40213,2757.76,1
2029-11-24,19:27:00,Best Buy,-142.76,Orlando FL,32816,5456.47,0
2029-11-24,11:48:00,Exxon,-17.24,Orlando FL,32816,5439.23,0
2029-11-25,17:28:00,Starbucks,-23.38,Oviedo FL,32765,5415.85,0
2029-11-25,15:30:00,Amusement Park,-23.3,Oviedo FL,32765,5392.55,0
2029-11-25,11:54:00,Starbucks,-39.74,Oviedo FL,32765,5352.81,0
2029-11-26,08:00:00,Paycheck,2000.0,Oviedo FL,32765,7352.81,0
2029-11-26,15:18:00,Starbucks,-31.48,Oviedo FL,32765,7321.33,0
2029-11-26,14:16:00,Servicenow,-417.83,London EN,75378,6903.5,1
2029-11-29,09:44:00,Subway,-52.33,Orlando FL,32816,7269.0,0
2029-11-29,03:46:00,Onlyfans,-2651.62,New York NY,61160,4617.38,1
2029-11-29,21:50:00,Walmart,-109.24,Winter Park FL,32789,7159.76,0
2029-11-30,21:47:00,Kroger,-189.58,Oviedo FL,32765,6970.18,0
2029-12-01,09:00:00,Rent,-960.0,Oviedo FL,32765,6010.18,0
2029-12-01,09:00:00,Insurance,-197.46,Oviedo FL,32765,5812.72,0
2029-12-01,09:00:00,Car,-300.0,Oviedo FL,32765,5512.72,0
2029-12-01,18:24:00,Subway,-32.91,Orlando FL,32816,5479.81,0
2029-12-01,11:25:00,BP,-24.33,Orlando FL,32816,5455.48,0
2029-12-01,16:55:00,Five Below,-31.49,Orlando FL,32816,5423.99,0
2029-12-02,13:45:00,Amazon,-65.23,Winter Park FL,32789,5358.76,0
2029-12-03,10:21:00,Burger King,-35.74,Winter Park FL,32789,5323.02,0
2029-12-04,21:13:00,Amusement Park,-10.78,Orlando FL,32816,5312.24,0
2029-12-05,14:32:00,Whole Foods,-75.97,Winter Park FL,32789,5236.27,0
2029-12-06,21:46:00,Trader Joe's,-81.48,Oviedo FL,32765,5154.79,0
2029-12-06,19:31:00,Five Below,-41.82,Oviedo FL,32765,5112.97,0
2029-12-06,17:30:00,Subway,-30.1,Orlando FL,32816,5082.87,0
2029-12-07,09:00:00,Spotify,-11.99,Oviedo FL,32765,5070.88,0
2029-12-07,09:00:00,Internet,-70.89,Oviedo FL,32765,4999.99,0
2029-12-07,09:00:00,ChatGPT Plus,-20.0,Oviedo FL,32765,4979.99,0
2029-12-08,10:13:00,Walgreens,-14.48,Winter Park FL,32789,4965.51,0
2029-12-08,15:06:00,Starbucks,-11.48,Winter Park FL,32789,4954.03,0
2029-12-08,01:12:00,Magic the Gathering,-2998.03,New York NY,97873,1956.0,1
2029-12-09,12:21:00,Amusement Park,-23.69,Winter Park FL,32789,4930.34,0
2029-12-09,08:18:00,BP,-23.39,Oviedo FL,32765,4906.95,0
2029-12-09,08:57:00,Shell,-19.73,Oviedo FL,32765,4887.22,0
2029-12-10,08:00:00,Paycheck,2000.0,Oviedo FL,32765,6887.22,0
2029-12-10,14:01:00,Jiffy Lube,-167.35,Orlando FL,32816,6719.87,0
2029-12-11,20:17:00,Shell,-28.88,Winter Park FL,32789,6690.99,0
2029-12-13,08:29:00,Trader Joe's,-144.24,Winter Park FL,32789,6546.75,0
2029-12-13,18:32:00,Whole Foods,-186.61,Orlando FL,32816,6360.14,0
2029-12-14,21:14:00,Starbucks,-74.52,Winter Park FL,32789,6285.62,0
2029-12-14,11:36:00,Fraud,-442.68,New York NY,46341,5842.94,1
2029-12-14,09:19:00,Amusement Park,-56.24,Orlando FL,32816,6229.38,0
2029-12-14,12:13:00,Burger King,-65.94,Oviedo FL,32765,6163.44,0
2029-12-15,09:52:00,Trader Joe's,-130.82,Orlando FL,32816,6032.62,0
2029-12-16,12:45:00,Walmart,-171.46,Orlando FL,32816,5861.16,0
2029-12-16,14:38:00,Walmart,-26.58,Winter Park FL,32789,5834.58,0
2029-12-16,17:56:00,Exxon,-29.11,Orlando FL,32816,5805.47,0
2029-12-17,08:40:00,Best Buy,-41.61,Orlando FL,32816,5763.86,0
2029-12-19,17:27:00,Amusement Park,-23.19,Oviedo FL,32765,5740.67,0
2029-12-19,12:45:00,Subway,-36.5,Winter Park FL,32789,5704.17,0
2029-12-20,11:43:00,Publix,-64.11,Oviedo FL,32765,5640.06,0
2029-12-23,11:15:00,Whole Foods,-54.51,Winter Park FL,32789,5585.55,0
2029-12-23,20:53:00,Concert Tickets,-41.9,Orlando FL,32816,5543.65,0
2029-12-24,08:00:00,Paycheck,2000.0,Oviedo FL,32765,7543.65,0
2029-12-24,20:51:00,Target,-99.13,Orlando FL,32816,7444.52,0
2029-12-25,10:32:00,CVS,-84.47,Oviedo FL,32765,7360.05,0
2029-12-25,08:16:00,Amazon,-108.45,Winter Park FL,32789,7251.6,0
2029-12-25,11:42:00,Burger King,-62.07,Winter Park FL,32789,7189.53,0
2029-12-28,09:37:00,Starbucks,-43.87,Winter Park FL,32789,7145.66,0
2029-12-28,20:43:00,Walmart,-94.68,Orlando FL,32816,7050.98,0
2029-12-28,21:26:00,Concert Tickets,-45.7,Orlando FL,32816,7005.28,0
2029-12-28,22:52:00,Onlyfans,-1133.0,Pittsburgh PA,23247,5872.28,1
2029-12-29,13:17:00,Subway,-45.01,Oviedo FL,32765,6960.27,0
2029-12-29,12:27:00,Fraud,-677.02,New York NY,75227,6283.25,1
2029-12-29,20:38:00,Target,-271.24,Orlando FL,32816,6689.03,0
2029-12-30,16:58:00,Target,-59.47,Orlando FL,32816,6629.56,0
2029-12-30,09:06:00,Starbucks,-44.05,Winter Park FL,32789,6585.51,0
2029-12-31,08:35:00,Netflix,-44.7,Winter Park FL,32789,6540.81,0
2030-01-01,09:00:00,Rent,-960.0,Oviedo FL,32765,5580.81,0
2030-01-01,09:00:00,Insurance,-197.46,Oviedo FL,32765,5383.35,0
2030-01-01,09:00:00,Car,-300.0,Oviedo FL,32765,5083.35,0
2030-01-01,13:44:00,Best Buy,-43.59,Orlando FL,32816,5039.76,0
2030-01-01,21:00:00,Subway,-18.51,Orlando FL,32816,5021.25,0
2030-01-02,08:03:00,McDonald's,-22.53,Winter Park FL,32789,4998.72,0
2030-01-02,08:55:00,Target,-15.15,Orlando FL,32816,4983.57,0
2030-01-02,11:17:00,BP,-25.59,Oviedo FL,32765,4957.98,0
2030-01-03,07:37:00,Magic the Gathering,-1072.89,Groton CT,42803,3885.09,1
2030-01-03,19:39:00,McDonald's,-17.15,Winter Park FL,32789,4940.83,0
2030-01-03,17:12:00,Netflix,-49.19,Orlando FL,32816,4891.64,0
2030-01-03,09:09:00,Chevron,-15.7,Orlando FL,32816,4875.94,0
2030-01-04,14:56:00,Kroger,-67.82,Winter Park FL,32789,4808.12,0
2030-01-04,12:35:00,McDonald's,-27.21,Oviedo FL,32765,4780.91,0
2030-01-04,19:50:00,Subway,-32.17,Winter Park FL,32789,4748.74,0
2030-01-05,10:09:00,CVS,-10.66,Orlando FL,32816,4738.08,0
2030-01-05,02:52:00,Fat Joe,-2708.52,Tokyo JP,74147,2029.56,1
2030-01-05,15:52:00,Burger King,-27.56,Oviedo FL,32765,4710.52,0
2030-01-05,04:11:00,IBM,-935.52,Charleston SC,42401,3775.0,1
2030-01-06,11:57:00,Trader Joe's,-99.89,Oviedo FL,32765,4610.63,0
2030-01-06,10:04:00,Walmart,-21.58,Orlando FL,32816,4589.05,0
2030-01-07,08:00:00,Paycheck,2000.0,Oviedo FL,32765,6589.05,0
2030-01-07,09:00:00,Spotify,-11.99,Oviedo FL,32765,6577.06,0
2030-01-07,09:00:00,Internet,-70.89,Oviedo FL,32765,6506.17,0
2030-01-07,09:00:00,ChatGPT Plus,-20.0,Oviedo FL,32765,6486.17,0
2030-01-07,21:30:00,Kroger,-121.71,Oviedo FL,32765,6364.46,0
2030-01-07,18:44:00,Walmart,-234.02,Orlando FL,32816,6130.44,0
2030-01-09,08:42:00,Monster Energy,-466.26,Honolulu HI,76439,5664.18,1
2030-01-09,20:58:00,Walmart,-243.05,Orlando FL,32816,5887.39,0
2030-01-09,09:02:00,Publix,-66.37,Oviedo FL,32765,5821.02,0
2030-01-09,15:28:00,Whole Foods,-72.59,Oviedo FL,32765,5748.43,0
2030-01-10,16:33:00,Amazon,-110.04,Orlando FL,32816,5638.39,0
2030-01-11,19:34:00,Subway,-29.42,Oviedo FL,32765,5608.97,0
2030-01-11,14:30:00,Walgreens,-49.37,Oviedo FL,32765,5559.6,0
2030-01-11,08:37:00,Shell,-15.62,Orlando FL,32816,5543.98,0
2030-01-12,15:57:00,Burger King,-10.53,Winter Park FL,32789,5533.45,0
2030-01-12,16:01:00,Midas,-56.83,Oviedo FL,32765,5476.62,0
2030-01-12,19:06:00,Fraud,-547.73,Pittsburgh PA,32868,4928.89,1
2030-01-12,10:46:00,Starbucks,-10.63,Orlando FL,32816,5465.99,0
2030-01-14,17:18:00,Subway,-25.71,Winter Park FL,32789,5440.28,0
2030-01-14,10:39:00,Walgreens,-21.14,Oviedo FL,32765,5419.14,0
2030-01-14,12:14:00,Concert Tickets,-37.38,Oviedo FL,32765,5381.76,0
2030-01-15,21:31:00,Whole Foods,-68.58,Orlando FL,32816,5313.18,0
2030-01-15,01:58:00,Pawn Stars,-492.48,Anchorage AL,99881,4820.7,1
2030-01-17,09:28:00,Target,-45.05,Oviedo FL,32765,5268.13,0
2030-01-17,15:30:00,Five Below,-46.44,Orlando FL,32816,5221.69,0
2030-01-17,19:25:00,Lockheed Martin,-1483.91,Anchorage AL,57010,3737.78,1
2030-01-17,11:57:00,Exxon,-21.83,Orlando FL,32816,5199.86,0
2030-01-20,08:16:00,CVS,-36.69,Oviedo FL,32765,5163.17,0
2030-01-21,08:00:00,Paycheck,2000.0,Oviedo FL,32765,7163.17,0
2030-01-21,15:31:00,Starbucks,-68.09,Orlando FL,32816,7095.08,0
2030-01-21,13:02:00,Subway,-22.86,Winter Park FL,32789,7072.22,0
2030-01-22,14:24:00,Chevron,-53.15,Orlando FL,32816,7019.07,0
2030-01-23,12:19:00,Subway,-58.62,Winter Park FL,32789,6960.45,0
2030-01-24,18:15:00,Walgreens,-81.64,Oviedo FL,32765,6878.81,0
2030-01-24,08:42:00,Shell,-32.26,Winter Park FL,32789,6846.55,0
2030-01-24,07:08:00,Lockheed Martin,-1264.19,Mexico City MC,77431,5582.36,1
2030-01-24,11:42:00,Walmart,-274.37,Orlando FL,32816,6572.18,0
2030-01-25,18:58:00,Burger King,-58.15,Winter Park FL,32789,6514.03,0
2030-01-25,12:14:00,McDonald's,-37.44,Winter Park FL,32789,6476.59,0
2030-01-25,08:37:00,Subway,-37.42,Orlando FL,32816,6439.17,0
2030-01-26,17:51:00,Chevron,-48.59,Oviedo FL,32765,6390.58,0
2030-01-26,15:59:00,Amazon,-239.59,Oviedo FL,32765,6150.99,0
2030-01-26,21:57:00,Shell,-44.05,Oviedo FL,32765,6106.94,0
2030-01-28,09:19:00,Publix,-65.33,Orlando FL,32816,6041.61,0
2030-01-28,17:53:00,Netflix,-87.27,Orlando FL,32816,5954.34,0
2030-01-28,06:05:00,Paypal,-907.33,Anchorage AL,31583,5047.01,1
2030-01-28,13:22:00,Jiffy Lube,-59.89,Orlando FL,32816,5894.45,0
2030-01-28,01:14:00,Fat Joe,-888.02,Tokyo JP,54351,5006.43,1
2030-01-30,15:11:00,Chevron,-26.99,Orlando FL,32816,5867.46,0
2030-01-30,09:17:00,Trader Joe's,-36.74,Oviedo FL,32765,5830.72,0
2030-01-31,20:10:00,Amusement Park,-11.33,Oviedo FL,32765,5819.39,0
2030-02-01,09:00:00,Rent,-960.0,Oviedo FL,32765,4859.39,0
2030-02-01,09:00:00,Insurance,-197.46,Oviedo FL,32765,4661.93,0
2030-02-01,09:00:00,Car,-300.0,Oviedo FL,32765,4361.93,0
2030-02-01,15:39:00,Best Buy,-117.01,Winter Park FL,32789,4244.92,0
2030-02-01,12:39:00,Starbucks,-26.07,Orlando FL,32816,4218.85,0
2030-02-01,17:10:00,Subway,-19.3,Orlando FL,32816,4199.55,0
2030-02-02,17:33:00,Best Buy,-148.45,Orlando FL,32816,4051.1,0
2030-02-02,13:37:00,Movie Theater,-46.61,Winter Park FL,32789,4004.49,0
2030-02-03,11:12:00,Starbucks,-14.96,Oviedo FL,32765,3989.53,0
2030-02-04,08:00:00,Paycheck,2000.0,Oviedo FL,32765,5989.53,0
2030-02-04,08:06:00,Shell,-22.35,Orlando FL,32816,5967.18,0
2030-02-04,12:01:00,Walgreens,-9.76,Orlando FL,32816,5957.42,0
2030-02-05,11:19:00,Subway,-6.33,Oviedo FL,32765,5951.09,0
2030-02-05,19:21:00,McDonald's,-39.13,Orlando FL,32816,5911.96,0
2030-02-05,17:03:00,Exxon,-22.32,Orlando FL,32816,5889.64,0
2030-02-06,18:23:00,Whole Foods,-81.65,Winter Park FL,32789,5807.99,0
2030-02-06,15:15:00,Starbucks,-19.69,Winter Park FL,32789,5788.3,0
2030-02-07,09:00:00,Spotify,-11.99,Oviedo FL,32765,5776.31,0
2030-02-07,09:00:00,Internet,-70.89,Oviedo FL,32765,5705.42,0
2030-02-07,09:00:00,ChatGPT Plus,-20.0,Oviedo FL,32765,5685.42,0
2030-02-08,17:34:00,Pawn Stars,-1093.86,Pittsburgh PA,68340,4591.56,1
2030-02-11,19:18:00,McDonald's,-22.58,Orlando FL,32816,5662.84,0
2030-02-12,07:44:00,Servicenow,-691.49,London EN,98285,4971.35,1
2030-02-12,14:11:00,Walgreens,-38.04,Winter Park FL,32789,5624.8,0
2030-02-13,09:30:00,Amusement Park,-32.32,Oviedo FL,32765,5592.48,0
2030-02-13,16:41:00,Subway,-8.85,Orlando FL,32816,5583.63,0
2030-02-13,12:28:00,Whole Foods,-86.09,Oviedo FL,32765,5497.54,0
2030-02-13,16:52:00,Paypal,-2715.62,London EN,61580,2781.92,1
2030-02-16,12:10:00,Subway,-20.52,Orlando FL,32816,5477.02,0
2030-02-18,08:00:00,Paycheck,2000.0,Oviedo FL,32765,7477.02,0
2030-02-18,13:22:00,Kroger,-147.03,Orlando FL,32816,7329.99,0
2030-02-18,08:09:00,McDonald's,-48.0,Orlando FL,32816,7281.99,0
2030-02-18,16:35:00,McDonald's,-11.0,Winter Park FL,32789,7270.99,0
2030-02-19,17:49:00,Publix,-69.44,Winter Park FL,32789,7201.55,0
2030-02-20,21:58:00,Amazon,-183.19,Orlando FL,32816,7018.36,0
2030-02-20,00:46:00,Impractical Jokers,-2858.76,London EN,99248,4159.6,1
2030-02-20,13:32:00,Starbucks,-29.94,Winter Park FL,32789,6988.42,0
2030-02-21,22:53:00,Onlyfans,-1737.19,Charleston SC,28057,5251.23,1
2030-02-21,20:24:00,Burger King,-54.18,Orlando FL,32816,6934.24,0
2030-02-21,09:36:00,Five Below,-70.43,Orlando FL,32816,6863.81,0
2030-02-21,17:15:00,Netflix,-21.62,Winter Park FL,32789,6842.19,0
2030-02-22,10:00:00,Amusement Park,-81.03,Winter Park FL,32789,6761.16,0
2030-02-22,19:21:00,Five Below,-40.62,Oviedo FL,32765,6720.54,0
2030-02-22,20:55:00,McDonald's,-77.08,Winter Park FL,32789,6643.46,0
2030-02-23,16:13:00,Starbucks,-70.03,Winter Park FL,32789,6573.43,0
2030-02-23,17:12:00,Exxon,-36.2,Winter Park FL,32789,6537.23,0
2030-02-24,15:19:00,Kroger,-126.26,Oviedo FL,32765,6410.97,0
2030-02-24,10:46:00,Exxon,-34.6,Winter Park FL,32789,6376.37,0
2030-02-24,16:45:00,Amazon,-245.96,Winter Park FL,32789,6130.41,0
2030-02-25,21:32:00,McDonald's,-59.65,Orlando FL,32816,6070.76,0
2030-02-25,12:21:00,Dollar Tree,-80.58,Winter Park FL,32789,5990.18,0
2030-02-25,10:41:00,McDonald's,-20.33,Winter Park FL,32789,5969.85,0
2030-02-26,21:10:00,Concert Tickets,-47.35,Winter Park FL,32789,5922.5,0
2030-02-26,09:28:00,Concert Tickets,-44.48,Orlando FL,32816,5878.02,0
2030-02-27,13:43:00,Starbucks,-39.79,Oviedo FL,32765,5838.23,0
2030-02-27,08:28:00,Amusement Park,-58.14,Oviedo FL,32765,5780.09,0
2030-02-27,14:52:00,BP,-21.41,Winter Park FL,32789,5758.68,0
2030-03-01,09:00:00,Rent,-960.0,Oviedo FL,32765,4798.68,0
2030-03-01,09:00:00,Insurance,-197.46,Oviedo FL,32765,4601.22,0
2030-03-01,09:00:00,Car,-300.0,Oviedo FL,32765,4301.22,0
2030-03-01,08:49:00,Burger King,-17.87,Orlando FL,32816,4283.35,0
2030-03-01,10:14:00,Subway,-30.58,Oviedo FL,32765,4252.77,0
2030-03-02,11:13:00,Amusement Park,-38.98,Oviedo FL,32765,4213.79,0
2030-03-02,00:33:00,Onlyfans,-644.03,New York NY,18061,3569.76,1
2030-03-02,12:13:00,Starbucks,-14.69,Winter Park FL,32789,4199.1,0
2030-03-02,10:17:00,McDonald's,-27.77,Oviedo FL,32765,4171.33,0
2030-03-03,11:21:00,Midas,-154.55,Orlando FL,32816,4016.78,0
2030-03-03,15:41:00,Chevron,-14.5,Winter Park FL,32789,4002.28,0
2030-03-04,08:00:00,Paycheck,2000.0,Oviedo FL,32765,6002.28,0
2030-03-04,11:31:00,Starbucks,-16.09,Winter Park FL,32789,5986.19,0
2030-03-04,10:27:00,Concert Tickets,-57.47,Oviedo FL,32765,5928.72,0
2030-03-06,18:06:00,Whole Foods,-97.44,Winter Park FL,32789,5831.28,0
2030-03-06,12:57:00,Trader Joe's,-78.61,Oviedo FL,32765,5752.67,0
2030-03-06,20:33:00,Best Buy,-68.01,Orlando FL,32816,5684.66,0
2030-03-07,09:00:00,Spotify,-11.99,Oviedo FL,32765,5672.67,0
2030-03-07,09:00:00,Internet,-70.89,Oviedo FL,32765,5601.78,0
2030-03-07,09:00:00,ChatGPT Plus,-20.0,Oviedo FL,32765,5581.78,0
2030-03-08,19:57:00,Best Buy,-35.37,Orlando FL,32816,5546.41,0
2030-03-08,16:47:00,Netflix,-49.51,Orlando FL,32816,5496.9,0
2030-03-09,19:03:00,Impractical Jokers,-2944.18,Pyongyang NK,73990,2552.72,1
2030-03-09,18:23:00,Dollar Tree,-44.89,Oviedo FL,32765,5452.01,0
2030-03-10,09:51:00,Burger King,-19.89,Winter Park FL,32789,5432.12,0
2030-03-11,13:22:00,Movie Theater,-16.76,Winter Park FL,32789,5415.36,0
2030-03-11,19:59:00,BP,-24.72,Winter Park FL,32789,5390.64,0
2030-03-12,20:16:00,Dollar Tree,-44.66,Orlando FL,32816,5345.98,0
2030-03-12,19:40:00,Publix,-87.55,Oviedo FL,32765,5258.43,0
2030-03-13,20:39:00,Lockheed Martin,-1509.73,Tokyo JP,97671,3748.7,1
2030-03-13,08:46:00,Chevron,-18.13,Orlando FL,32816,5240.3,0
2030-03-13,10:58:00,Starbucks,-36.91,Orlando FL,32816,5203.39,0
2030-03-13,17:42:00,Subway,-5.07,Orlando FL,32816,5198.32,0
2030-03-13,07:55:00,Pawn Stars,-468.87,Groton CT,47544,4729.45,1
2030-03-14,22:11:00,Pawn Stars,-1352.95,Anchorage AL,53969,3845.37,1
2030-03-14,09:51:00,McDonald's,-22.41,Oviedo FL,32765,5175.91,0
2030-03-14,18:12:00,Concert Tickets,-15.9,Orlando FL,32816,5160.01,0
2030-03-14,15:24:00,Target,-68.46,Oviedo FL,32765,5091.55,0
2030-03-15,14:11:00,Netflix,-12.68,Oviedo FL,32765,5078.87,0
2030-03-15,14:39:00,Subway,-27.09,Winter Park FL,32789,5051.78,0
2030-03-17,08:13:00,Netflix,-25.81,Winter Park FL,32789,5025.97,0
2030-03-17,15:00:00,Netflix,-36.76,Winter Park FL,32789,4989.21,0
2030-03-18,08:00:00,Paycheck,2000.0,Oviedo FL,32765,6989.21,0
2030-03-18,10:38:00,McDonald's,-38.38,Oviedo FL,32765,6950.83,0
2030-03-18,12:35:00,Whole Foods,-196.66,Winter Park FL,32789,6754.17,0
2030-03-19,09:13:00,Starbucks,-48.14,Winter Park FL,32789,6706.03,0
2030-03-19,11:45:00,Burger King,-24.43,Winter Park FL,32789,6681.6,0
2030-03-19,16:18:00,Dollar Tree,-33.07,Orlando FL,32816,6648.53,0
2030-03-20,18:16:00,Best Buy,-67.16,Oviedo FL,32765,6581.37,0
2030-03-20,17:16:00,AutoZone,-352.62,Orlando FL,32816,6228.75,0
2030-03-20,11:57:00,Burger King,-55.85,Orlando FL,32816,6172.9,0
2030-03-21,15:31:00,Jiffy Lube,-165.42,Orlando FL,32816,6007.48,0
2030-03-21,17:15:00,Walgreens,-71.55,Winter Park FL,32789,5935.93,0
2030-03-22,09:08:00,Chevron,-25.54,Winter Park FL,32789,5910.39,0
2030-03-23,14:15:00,Trader Joe's,-39.71,Orlando FL,32816,5870.68,0
2030-03-23,18:06:00,Concert Tickets,-11.02,Oviedo FL,32765,5859.66,0
2030-03-24,11:02:00,Fat Joe,-384.6,Tokyo JP,85461,5475.06,1
2030-03-24,12:39:00,Burger King,-28.29,Winter Park FL,32789,5831.37,0
2030-03-24,16:17:00,Kroger,-94.37,Oviedo FL,32765,5737.0,0
2030-03-24,14:29:00,Exxon,-21.67,Winter Park FL,32789,5715.33,0
2030-03-24,06:47:00,Accelerators,-1385.08,New York NY,23985,4330.25,1
2030-03-25,19:17:00,Publix,-89.72,Winter Park FL,32789,5625.61,0
2030-03-25,19:58:00,Subway,-24.91,Orlando FL,32816,5600.7,0
2030-03-25,16:36:00,McDonald's,-38.15,Oviedo FL,32765,5562.55,0
2030-03-27,11:36:00,Best Buy,-115.38,Winter Park FL,32789,5447.17,0
2030-03-28,10:39:00,Dollar Tree,-39.25,Orlando FL,32816,5407.92,0
2030-03-29,13:49:00,Burger King,-19.84,Oviedo FL,32765,5388.08,0
2030-03-29,16:41:00,Target,-59.13,Oviedo FL,32765,5328.95,0
2030-03-31,15:34:00,IBM,-555.44,Tokyo JP,58774,4773.51,1
2030-03-31,21:39:00,Whole Foods,-67.41,Orlando FL,32816,5261.54,0
2030-04-01,08:00:00,Paycheck,2000.0,Oviedo FL,32765,7261.54,0
2030-04-01,09:00:00,Rent,-960.0,Oviedo FL,32765,6301.54,0
2030-04-01,09:00:00,Insurance,-197.46,Oviedo FL,32765,6104.08,0
2030-04-01,09:00:00,Car,-300.0,Oviedo FL,32765,5804.08,0
2030-04-01,23:07:00,Monster Energy,-969.47,Groton CT,45134,4834.61,1
2030-04-01,16:53:00,Netflix,-51.84,Oviedo FL,32765,5752.24,0
2030-04-02,17:01:00,Amazon,-64.45,Oviedo FL,32765,5687.79,0
2030-04-02,10:50:00,Best Buy,-119.12,Winter Park FL,32789,5568.67,0
2030-04-02,11:24:00,Burger King,-31.49,Winter Park FL,32789,5537.18,0
2030-04-03,10:50:00,Concert Tickets,-22.39,Orlando FL,32816,5514.79,0
2030-04-03,18:49:00,Concert Tickets,-37.18,Orlando FL,32816,5477.61,0
2030-04-03,13:15:00,Dollar Tree,-42.97,Orlando FL,32816,5434.64,0
2030-04-04,12:38:00,Target,-56.99,Orlando FL,32816,5377.65,0
2030-04-05,04:45:00,Paypal,-2423.44,New York NY,51872,2954.21,1
2030-04-05,14:32:00,Kroger,-64.43,Oviedo FL,32765,5313.22,0
2030-04-06,19:50:00,Subway,-29.32,Winter Park FL,32789,5283.9,0
2030-04-07,09:00:00,Spotify,-11.99,Oviedo FL,32765,5271.91,0
2030-04-07,09:00:00,Internet,-70.89,Oviedo FL,32765,5201.02,0
2030-04-07,09:00:00,ChatGPT Plus,-20.0,Oviedo FL,32765,5181.02,0
2030-04-07,17:04:00,Movie Theater,-16.22,Oviedo FL,32765,5164.8,0
2030-04-07,18:18:00,Target,-82.21,Oviedo FL,32765,5082.59,0
2030-04-10,20:21:00,Burger King,-20.42,Oviedo FL,32765,5062.17,0
2030-04-10,21:51:00,Starbucks,-16.81,Orlando FL,32816,5045.36,0
2030-04-11,17:53:00,Jiffy Lube,-135.75,Winter Park FL,32789,4909.61,0
2030-04-11,17:38:00,Kroger,-53.11,Orlando FL,32816,4856.5,0
2030-04-12,19:39:00,McDonald's,-21.21,Orlando FL,32816,4835.29,0
2030-04-12,13:06:00,Movie Theater,-10.14,Orlando FL,32816,4825.15,0
2030-04-12,12:28:00,Whole Foods,-89.15,Orlando FL,32816,4736.0,0
2030-04-13,20:50:00,McDonald's,-14.38,Orlando FL,32816,4721.62,0
2030-04-14,18:24:00,Dollar Tree,-8.03,Oviedo FL,32765,4713.59,0
2030-04-14,20:35:00,Publix,-90.76,Oviedo FL,32765,4622.83,0
2030-04-14,15:46:00,Burger King,-34.68,Winter Park FL,32789,4588.15,0
2030-04-15,08:00:00,Paycheck,2000.0,Oviedo FL,32765,6588.15,0
2030-04-15,12:37:00,Subway,-61.57,Orlando FL,32816,6526.58,0
2030-04-15,09:58:00,Starbucks,-39.13,Winter Park FL,32789,6487.45,0
2030-04-15,10:50:00,Impractical Jokers,-2367.67,Anchorage AL,31376,4119.78,1
2030-04-16,11:53:00,Best Buy,-235.55,Orlando FL,32816,6251.9,0
2030-04-16,17:55:00,Pep Boys,-129.42,Oviedo FL,32765,6122.48,0
2030-04-17,14:29:00,Starbucks,-63.6,Winter Park FL,32789,6058.88,0
2030-04-17,08:10:00,Target,-70.23,Oviedo FL,32765,5988.65,0
2030-04-19,12:28:00,Netflix,-57.91,Orlando FL,32816,5930.74,0
2030-04-19,11:15:00,Trader Joe's,-80.26,Orlando FL,32816,5850.48,0
2030-04-19,14:19:00,Shell,-10.65,Orlando FL,32816,5839.83,0
2030-04-20,14:49:00,Burger King,-21.02,Oviedo FL,32765,5818.81,0
2030-04-20,15:58:00,Movie Theater,-42.81,Orlando FL,32816,5776.0,0
2030-04-21,09:01:00,Chevron,-13.74,Oviedo FL,32765,5762.26,0
2030-04-23,09:45:00,BP,-23.43,Winter Park FL,32789,5738.83,0
2030-04-24,13:23:00,BP,-19.97,Orlando FL,32816,5718.86,0
2030-04-24,21:19:00,McDonald's,-27.92,Oviedo FL,32765,5690.94,0
2030-04-24,18:23:00,Paypal,-2845.32,Charleston SC,24748,2845.62,1
2030-04-25,11:18:00,Target,-70.1,Winter Park FL,32789,5620.84,0
2030-04-25,18:30:00,Amazon,-87.5,Orlando FL,32816,5533.34,0
2030-04-25,19:20:00,Amazon,-74.48,Orlando FL,32816,5458.86,0
2030-04-26,14:01:00,Dollar Tree,-30.48,Oviedo FL,32765,5428.38,0
2030-04-26,22:26:00,Accelerators,-2300.33,Pyongyang NK,20705,3128.05,1
2030-04-26,19:47:00,Starbucks,-10.37,Orlando FL,32816,5418.01,0
2030-04-29,08:00:00,Paycheck,2000.0,Oviedo FL,32765,7418.01,0
2030-05-01,09:00:00,Rent,-960.0,Oviedo FL,32765,6458.01,0
2030-05-01,09:00:00,Insurance,-197.46,Oviedo FL,32765,6260.55,0
2030-05-01,09:00:00,Car,-300.0,Oviedo FL,32765,5960.55,0
2030-05-01,21:43:00,Starbucks,-11.09,Winter Park FL,32789,5949.46,0
2030-05-02,11:05:00,Dollar Tree,-25.2,Oviedo FL,32765,5924.26,0
2030-05-03,15:39:00,Trader Joe's,-79.48,Oviedo FL,32765,5844.78,0
2030-05-03,13:28:00,Target,-113.0,Orlando FL,32816,5731.78,0
2030-05-04,15:48:00,Target,-95.12,Winter Park FL,32789,5636.66,0
2030-05-04,10:19:00,Subway,-5.02,Oviedo FL,32765,5631.64,0
2030-05-05,08:38:00,Starbucks,-30.02,Orlando FL,32816,5601.62,0
2030-05-05,13:02:00,Subway,-29.89,Oviedo FL,32765,5571.73,0
2030-05-05,15:51:00,Movie Theater,-59.64,Orlando FL,32816,5512.09,0
2030-05-05,04:58:00,Servicenow,-1045.19,Honolulu HI,74512,4466.9,1
2030-05-06,15:54:00,Burger King,-19.97,Oviedo FL,32765,5492.12,0
2030-05-07,09:00:00,Spotify,-11.99,Oviedo FL,32765,5480.13,0
2030-05-07,09:00:00,Internet,-70.89,Oviedo FL,32765,5409.24,0
2030-05-07,09:00:00,ChatGPT Plus,-20.0,Oviedo FL,32765,5389.24,0
2030-05-08,14:45:00,Burger King,-27.41,Orlando FL,32816,5361.83,0
2030-05-08,16:50:00,Movie Theater,-45.85,Orlando FL,32816,5315.98,0
2030-05-12,18:36:00,Amusement Park,-37.08,Winter Park FL,32789,5278.9,0
2030-05-13,08:00:00,Paycheck,2000.0,Oviedo FL,32765,7278.9,0
2030-05-13,10:35:00,Shell,-30.98,Winter Park FL,32789,7247.92,0
2030-05-13,12:32:00,McDonald's,-39.32,Winter Park FL,32789,7208.6,0
2030-05-14,11:50:00,Onlyfans,-1801.2,London EN,56445,5407.4,1
2030-05-14,19:24:00,Chevron,-39.3,Orlando FL,32816,7169.3,0
2030-05-14,09:44:00,Trader Joe's,-112.21,Orlando FL,32816,7057.09,0
2030-05-16,18:12:00,Netflix,-27.84,Oviedo FL,32765,7029.25,0
2030-05-16,11:15:00,Shell,-26.1,Winter Park FL,32789,7003.15,0
2030-05-17,14:56:00,McDonald's,-73.53,Winter Park FL,32789,6929.62,0
2030-05-17,10:26:00,Midas,-103.65,Winter Park FL,32789,6825.97,0
2030-05-17,18:13:00,Whole Foods,-158.5,Orlando FL,32816,6667.47,0
2030-05-18,16:56:00,Subway,-23.41,Winter Park FL,32789,6644.06,0
2030-05-18,18:21:00,Chevron,-51.48,Oviedo FL,32765,6592.58,0
2030-05-20,19:30:00,Accelerators,-919.3,London EN,41790,5673.28,1
2030-05-20,14:58:00,McDonald's,-68.44,Oviedo FL,32765,6524.14,0
2030-05-20,03:31:00,Lockheed Martin,-2920.55,Anchorage AL,32967,3603.59,1
2030-05-20,13:22:00,Kroger,-194.75,Orlando FL,32816,6329.39,0
2030-05-21,20:29:00,Subway,-17.23,Winter Park FL,32789,6312.16,0
2030-05-21,11:43:00,Burger King,-56.5,Winter Park FL,32789,6255.66,0
2030-05-21,11:10:00,Walgreens,-59.27,Oviedo FL,32765,6196.39,0
2030-05-22,21:37:00,Walmart,-129.38,Orlando FL,32816,6067.01,0
2030-05-22,09:56:00,Magic the Gathering,-2854.94,Anchorage AL,84830,3212.07,1
2030-05-22,12:37:00,Best Buy,-152.07,Winter Park FL,32789,5914.94,0
2030-05-23,14:43:00,Chevron,-29.45,Oviedo FL,32765,5885.49,0
2030-05-23,19:43:00,Starbucks,-37.96,Orlando FL,32816,5847.53,0
2030-05-26,19:55:00,Netflix,-36.12,Orlando FL,32816,5811.41,0
2030-05-26,08:17:00,Burger King,-35.56,Winter Park FL,32789,5775.85,0
2030-05-26,05:08:00,Impractical Jokers,-358.44,Charleston SC,75727,5417.41,1
2030-05-26,21:02:00,Five Below,-11.83,Oviedo FL,32765,5764.02,0
2030-05-27,08:00:00,Paycheck,2000.0,Oviedo FL,32765,7764.02,0
2030-05-27,21:30:00,Whole Foods,-60.35,Winter Park FL,32789,7703.67,0
2030-05-28,03:54:00,Monster Energy,-1076.47,New York NY,27621,6627.2,1
2030-05-30,15:07:00,McDonald's,-54.47,Winter Park FL,32789,7649.2,0
2030-05-30,13:41:00,Amazon,-208.15,Winter Park FL,32789,7441.05,0
2030-05-30,10:35:00,Starbucks,-20.87,Winter Park FL,32789,7420.18,0
2030-06-01,09:00:00,Rent,-960.0,Oviedo FL,32765,6460.18,0
2030-06-01,09:00:00,Insurance,-197.46,Oviedo FL,32765,6262.72,0
2030-06-01,09:00:00,Car,-300.0,Oviedo FL,32765,5962.72,0
2030-06-01,11:32:00,McDonald's,-10.39,Winter Park FL,32789,5952.33,0
2030-06-01,10:11:00,Burger King,-17.44,Oviedo FL,32765,5934.89,0
2030-06-01,15:19:00,Servicenow,-1495.29,Mexico City MC,45692,4439.6,1
2030-06-01,14:40:00,Shell,-21.19,Orlando FL,32816,5913.7,0
2030-06-02,13:43:00,Subway,-33.97,Winter Park FL,32789,5879.73,0
2030-06-02,10:45:00,Fraud,-1272.83,Charleston SC,17104,4606.9,1
2030-06-02,12:35:00,Walgreens,-38.55,Oviedo FL,32765,5841.18,0
2030-06-02,11:11:00,Amazon,-65.97,Orlando FL,32816,5775.21,0
2030-06-02,12:22:00,Impractical Jokers,-2298.5,Tokyo JP,48919,3476.71,1
2030-06-03,19:12:00,McDonald's,-24.62,Oviedo FL,32765,5750.59,0
2030-06-03,03:54:00,Onlyfans,-1869.85,Anchorage AL,66533,3880.74,1
2030-06-03,20:24:00,Target,-21.07,Orlando FL,32816,5729.52,0
2030-06-06,09:53:00,Amazon,-120.02,Winter Park FL,32789,5609.5,0
2030-06-06,20:43:00,Netflix,-30.69,Winter Park FL,32789,5578.81,0
2030-06-07,09:00:00,Spotify,-11.99,Oviedo FL,32765,5566.82,0
2030-06-07,09:00:00,Internet,-70.89,Oviedo FL,32765,5495.93,0
2030-06-07,09:00:00,ChatGPT Plus,-20.0,Oviedo FL,32765,5475.93,0
2030-06-07,02:54:00,Impractical Jokers,-1957.22,New York NY,51996,3518.71,1
2030-06-07,14:40:00,Exxon,-27.4,Winter Park FL,32789,5448.53,0
2030-06-08,13:08:00,McDonald's,-6.77,Oviedo FL,32765,5441.76,0
2030-06-08,10:54:00,BP,-19.84,Orlando FL,32816,5421.92,0
2030-06-09,12:37:00,Burger King,-22.13,Winter Park FL,32789,5399.79,0
2030-06-09,15:42:00,Burger King,-11.93,Orlando FL,32816,5387.86,0
2030-06-09,19:14:00,Kroger,-99.38,Winter Park FL,32789,5288.48,0
2030-06-10,08:00:00,Paycheck,2000.0,Oviedo FL,32765,7288.48,0
2030-06-10,12:25:00,McDonald's,-15.3,Orlando FL,32816,7273.18,0
2030-06-10,11:23:00,Burger King,-57.17,Winter Park FL,32789,7216.01,0
2030-06-12,15:28:00,Burger King,-34.17,Orlando FL,32816,7181.84,0
2030-06-12,18:05:00,Burger King,-77.57,Winter Park FL,32789,7104.27,0
2030-06-12,12:05:00,Monster Energy,-283.34,Pittsburgh PA,68544,6820.93,1
2030-06-13,21:08:00,Exxon,-40.6,Orlando FL,32816,7063.67,0
2030-06-13,15:27:00,BP,-58.98,Orlando FL,32816,7004.69,0
2030-06-14,10:52:00,Starbucks,-49.87,Orlando FL,32816,6954.82,0
2030-06-14,23:57:00,Pawn Stars,-1954.0,New York NY,97092,5000.82,1
2030-06-14,15:04:00,Target,-64.47,Orlando FL,32816,6890.35,0
2030-06-14,20:55:00,Target,-244.8,Orlando FL,32816,6645.55,0
2030-06-15,08:18:00,BP,-25.89,Orlando FL,32816,6619.66,0
2030-06-16,21:41:00,Pep Boys,-176.46,Oviedo FL,32765,6443.2,0
2030-06-16,09:05:00,Fraud,-347.34,Pittsburgh PA,44795,6095.86,1
2030-06-17,14:14:00,Pep Boys,-123.3,Orlando FL,32816,6319.9,0
2030-06-17,13:30:00,McDonald's,-38.5,Oviedo FL,32765,6281.4,0
2030-06-18,00:14:00,Monster Energy,-838.27,Mexico City MC,86729,5443.13,1
2030-06-18,16:03:00,Burger King,-57.7,Orlando FL,32816,6223.7,0
2030-06-18,10:00:00,Dollar Tree,-49.95,Orlando FL,32816,6173.75,0
2030-06-19,16:30:00,Jiffy Lube,-350.97,Winter Park FL,32789,5822.78,0
2030-06-19,20:48:00,McDonald's,-10.92,Orlando FL,32816,5811.86,0
2030-06-19,17:29:00,Amazon,-68.08,Oviedo FL,32765,5743.78,0
2030-06-20,01:21:00,Accelerators,-624.1,Charleston SC,51494,5119.68,1
2030-06-20,10:57:00,Subway,-14.88,Orlando FL,32816,5728.9,0
2030-06-21,12:53:00,Amusement Park,-57.86,Orlando FL,32816,5671.04,0
2030-06-21,14:53:00,Burger King,-22.07,Winter Park FL,32789,5648.97,0
2030-06-21,19:22:00,Pawn Stars,-168.15,Honolulu HI,52742,5480.82,1
2030-06-22,15:01:00,Walmart,-111.74,Oviedo FL,32765,5537.23,0
2030-06-22,15:14:00,Exxon,-21.55,Oviedo FL,32765,5515.68,0
2030-06-22,17:20:00,Five Below,-47.51,Orlando FL,32816,5468.17,0
2030-06-23,21:38:00,Subway,-9.45,Oviedo FL,32765,5458.72,0
2030-06-23,06:28:00,Paypal,-1143.87,Groton CT,34208,4314.85,1
2030-06-24,08:00:00,Paycheck,2000.0,Oviedo FL,32765,7458.72,0
2030-06-24,14:29:00,Exxon,-27.3,Orlando FL,32816,7431.42,0
2030-06-25,10:03:00,Starbucks,-62.03,Orlando FL,32816,7369.39,0
2030-06-25,16:30:00,Exxon,-21.64,Oviedo FL,32765,7347.75,0
2030-06-25,01:14:00,Fraud,-839.27,New York NY,33264,6508.48,1
2030-06-25,18:07:00,CVS,-98.05,Orlando FL,32816,7249.7,0
2030-06-27,16:49:00,Chevron,-54.26,Orlando FL,32816,7195.44,0
2030-06-27,16:54:00,Dollar Tree,-43.42,Orlando FL,32816,7152.02,0
2030-06-28,16:28:00,Trader Joe's,-89.74,Oviedo FL,32765,7062.28,0
2030-06-28,12:21:00,Chevron,-33.09,Winter Park FL,32789,7029.19,0
2030-06-28,10:55:00,Starbucks,-11.53,Orlando FL,32816,7017.66,0
2030-07-01,09:00:00,Rent,-960.0,Oviedo FL,32765,6057.66,0
2030-07-01,09:00:00,Insurance,-197.46,Oviedo FL,32765,5860.2,0
2030-07-01,09:00:00,Car,-300.0,Oviedo FL,32765,5560.2,0
2030-07-01,10:08:00,Starbucks,-18.17,Orlando FL,32816,5542.03,0
2030-07-01,15:17:00,CVS,-6.83,Oviedo FL,32765,5535.2,0
2030-07-01,19:51:00,AutoZone,-160.02,Orlando FL,32816,5375.18,0
2030-07-02,17:49:00,Shell,-27.31,Oviedo FL,32765,5347.87,0
2030-07-04,19:41:00,Chevron,-28.38,Orlando FL,32816,5319.49,0
2030-07-04,21:37:00,Starbucks,-33.27,Orlando FL,32816,5286.22,0
2030-07-04,19:04:00,McDonald's,-7.21,Winter Park FL,32789,5279.01,0
2030-07-06,10:44:00,Starbucks,-33.89,Orlando FL,32816,5245.12,0
2030-07-06,18:11:00,IBM,-1713.45,Anchorage AL,57822,3531.67,1
2030-07-06,16:13:00,Movie Theater,-13.24,Orlando FL,32816,5231.88,0
2030-07-07,09:00:00,Spotify,-11.99,Oviedo FL,32765,5219.89,0
2030-07-07,09:00:00,Internet,-70.89,Oviedo FL,32765,5149.0,0
2030-07-07,09:00:00,ChatGPT Plus,-20.0,Oviedo FL,32765,5129.0,0
2030-07-08,08:00:00,Paycheck,2000.0,Oviedo FL,32765,7129.0,0
2030-07-08,16:22:00,Exxon,-39.7,Oviedo FL,32765,7089.3,0
2030-07-08,15:34:00,Onlyfans,-2366.91,Anchorage AL,43929,4722.39,1
2030-07-08,16:28:00,Shell,-33.07,Winter Park FL,32789,7056.23,0
2030-07-08,10:44:00,Burger King,-32.71,Orlando FL,32816,7023.52,0
2030-07-09,08:21:00,Pawn Stars,-1786.59,Groton CT,91494,5236.93,1
2030-07-09,19:20:00,Starbucks,-68.62,Oviedo FL,32765,6954.9,0
2030-07-11,08:01:00,Best Buy,-80.14,Orlando FL,32816,6874.76,0
2030-07-12,10:43:00,Starbucks,-18.87,Orlando FL,32816,6855.89,0
2030-07-12,15:58:00,Best Buy,-25.81,Oviedo FL,32765,6830.08,0
2030-07-12,09:10:00,Netflix,-67.48,Winter Park FL,32789,6762.6,0
2030-07-13,21:26:00,McDonald's,-49.99,Orlando FL,32816,6712.61,0
2030-07-13,06:36:00,Servicenow,-479.64,Mexico City MC,64442,6232.97,1
2030-07-13,15:04:00,Netflix,-108.89,Oviedo FL,32765,6603.72,0
2030-07-14,12:32:00,Monster Energy,-2209.65,Anchorage AL,41059,4394.07,1
2030-07-14,12:18:00,Starbucks,-39.6,Winter Park FL,32789,6564.12,0
2030-07-14,18:22:00,Trader Joe's,-131.31,Winter Park FL,32789,6432.81,0
2030-07-14,01:24:00,Impractical Jokers,-1234.56,Groton CT,71162,5198.25,1
2030-07-16,16:58:00,Dollar Tree,-25.0,Oviedo FL,32765,6407.81,0
2030-07-16,10:23:00,Burger King,-35.02,Oviedo FL,32765,6372.79,0
2030-07-17,19:37:00,Dollar Tree,-16.19,Orlando FL,32816,6356.6,0
2030-07-17,13:02:00,Target,-50.5,Orlando FL,32816,6306.1,0
2030-07-17,07:10:00,Lockheed Martin,-752.75,Charleston SC,48549,5553.35,1
2030-07-17,16:15:00,Kroger,-114.79,Orlando FL,32816,6191.31,0
2030-07-18,21:40:00,McDonald's,-57.34,Oviedo FL,32765,6133.97,0
2030-07-18,20:04:00,Walgreens,-12.75,Oviedo FL,32765,6121.22,0
2030-07-19,13:26:00,Netflix,-69.21,Winter Park FL,32789,6052.01,0
2030-07-19,15:04:00,CVS,-29.69,Orlando FL,32816,6022.32,0
2030-07-19,09:15:00,McDonald's,-70.84,Orlando FL,32816,5951.48,0
2030-07-20,20:39:00,Publix,-36.97,Oviedo FL,32765,5914.51,0
2030-07-21,13:51:00,Target,-140.69,Orlando FL,32816,5773.82,0
2030-07-22,08:00:00,Paycheck,2000.0,Oviedo FL,32765,7773.82,0
2030-07-22,20:50:00,BP,-28.8,Orlando FL,32816,7745.02,0
2030-07-22,13:14:00,Starbucks,-27.29,Winter Park FL,32789,7717.73,0
2030-07-22,15:08:00,Chevron,-38.26,Winter Park FL,32789,7679.47,0
2030-07-23,16:26:00,Burger King,-70.23,Orlando FL,32816,7609.24,0
2030-07-23,08:59:00,Kroger,-188.32,Winter Park FL,32789,7420.92,0
2030-07-23,15:37:00,Amazon,-162.22,Winter Park FL,32789,7258.7,0
2030-07-26,19:32:00,Jiffy Lube,-197.82,Orlando FL,32816,7060.88,0
2030-07-26,09:34:00,Best Buy,-239.7,Orlando FL,32816,6821.18,0
2030-07-26,05:43:00,Magic the Gathering,-194.6,Pyongyang NK,82446,6626.58,1
2030-07-26,09:41:00,McDonald's,-21.25,Oviedo FL,32765,6799.93,0
2030-07-28,17:51:00,Burger King,-23.69,Winter Park FL,32789,6776.24,0
2030-07-28,21:24:00,Burger King,-33.46,Orlando FL,32816,6742.78,0
2030-07-29,13:31:00,Walmart,-76.03,Winter Park FL,32789,6666.75,0
2030-07-29,10:29:00,Starbucks,-33.5,Winter Park FL,32789,6633.25,0
2030-07-30,08:10:00,Starbucks,-20.44,Winter Park FL,32789,6612.81,0
2030-07-30,09:32:00,Concert Tickets,-93.88,Winter Park FL,32789,6518.93,0
2030-07-30,12:29:00,McDonald's,-39.8,Winter Park FL,32789,6479.13,0
2030-07-31,09:04:00,Trader Joe's,-150.83,Orlando FL,32816,6328.3,0
2030-07-31,02:51:00,Fat Joe,-1011.73,Mexico City MC,23109,5316.57,1
2030-08-01,09:00:00,Rent,-960.0,Oviedo FL,32765,5368.3,0
2030-08-01,09:00:00,Insurance,-197.46,Oviedo FL,32765,5170.84,0
2030-08-01,09:00:00,Car,-300.0,Oviedo FL,32765,4870.84,0
2030-08-02,19:34:00,Burger King,-8.34,Winter Park FL,32789,4862.5,0
2030-08-04,15:17:00,Kroger,-57.8,Winter Park FL,32789,4804.7,0
2030-08-04,14:50:00,Whole Foods,-43.57,Orlando FL,32816,4761.13,0
2030-08-05,08:00:00,Paycheck,2000.0,Oviedo FL,32765,6761.13,0
2030-08-05,19:06:00,McDonald's,-21.29,Winter Park FL,32789,6739.84,0
2030-08-05,22:46:00,Magic the Gathering,-289.22,Anchorage AL,38262,6450.62,1
2030-08-06,19:26:00,Amusement Park,-59.39,Orlando FL,32816,6680.45,0
2030-08-06,08:01:00,McDonald's,-45.74,Winter Park FL,32789,6634.71,0
2030-08-07,09:00:00,Spotify,-11.99,Oviedo FL,32765,6622.72,0
2030-08-07,09:00:00,Internet,-70.89,Oviedo FL,32765,6551.83,0
2030-08-07,09:00:00,ChatGPT Plus,-20.0,Oviedo FL,32765,6531.83,0
2030-08-07,19:43:00,Concert Tickets,-76.84,Winter Park FL,32789,6454.99,0
2030-08-07,18:22:00,Concert Tickets,-74.95,Winter Park FL,32789,6380.04,0
2030-08-09,05:28:00,Accelerators,-1272.98,Mexico City MC,76986,5107.06,1
2030-08-09,18:31:00,McDonald's,-38.32,Orlando FL,32816,6341.72,0
2030-08-09,09:46:00,Burger King,-52.74,Winter Park FL,32789,6288.98,0
2030-08-10,16:19:00,Pawn Stars,-1512.57,Pyongyang NK,33726,4776.41,1
2030-08-10,13:37:00,Walgreens,-58.72,Oviedo FL,32765,6230.26,0
2030-08-10,06:32:00,Lockheed Martin,-801.3,Charleston SC,38179,5428.96,1
2030-08-10,20:18:00,Netflix,-117.56,Orlando FL,32816,6112.7,0
2030-08-12,15:55:00,Subway,-39.34,Oviedo FL,32765,6073.36,0
2030-08-16,16:34:00,Chevron,-58.25,Orlando FL,32816,6015.11,0
2030-08-17,10:15:00,Dollar Tree,-86.09,Orlando FL,32816,5929.02,0
2030-08-18,20:45:00,Walmart,-108.41,Orlando FL,32816,5820.61,0
2030-08-18,17:48:00,Starbucks,-30.17,Winter Park FL,32789,5790.44,0
2030-08-19,08:00:00,Paycheck,2000.0,Oviedo FL,32765,7790.44,0
2030-08-19,17:16:00,Amazon,-159.86,Orlando FL,32816,7630.58,0
2030-08-19,17:31:00,Exxon,-33.05,Winter Park FL,32789,7597.53,0
2030-08-20,17:28:00,Midas,-309.54,Oviedo FL,32765,7287.99,0
2030-08-20,19:21:00,Five Below,-12.94,Winter Park FL,32789,7275.05,0
2030-08-22,21:02:00,Subway,-51.58,Winter Park FL,32789,7223.47,0
2030-08-22,13:34:00,McDonald's,-77.35,Oviedo FL,32765,7146.12,0
2030-08-22,15:50:00,McDonald's,-72.55,Orlando FL,32816,7073.57,0
2030-08-23,20:11:00,Publix,-64.07,Orlando FL,32816,7009.5,0
2030-08-23,10:49:00,Burger King,-27.86,Oviedo FL,32765,6981.64,0
2030-08-24,12:04:00,Target,-266.79,Orlando FL,32816,6714.85,0
2030-08-25,13:05:00,Movie Theater,-61.99,Winter Park FL,32789,6652.86,0
2030-08-25,03:16:00,Fraud,-675.67,Los Angeles CA,16493,5977.19,1
2030-08-25,17:32:00,Burger King,-63.95,Oviedo FL,32765,6588.91,0
2030-08-25,06:37:00,Impractical Jokers,-2976.54,London EN,41720,3612.37,1
2030-08-26,14:57:00,Best Buy,-37.28,Winter Park FL,32789,6551.63,0
2030-08-26,04:07:00,Impractical Jokers,-1186.18,Mexico City MC,92317,5365.45,1
2030-08-26,17:57:00,McDonald's,-18.69,Winter Park FL,32789,6532.94,0
2030-08-26,08:40:00,Starbucks,-18.08,Oviedo FL,32765,6514.86,0
2030-08-27,20:30:00,McDonald's,-47.51,Orlando FL,32816,6467.35,0
2030-08-28,13:12:00,Burger King,-17.86,Winter Park FL,32789,6449.49,0
2030-08-28,11:54:00,Trader Joe's,-186.79,Winter Park FL,32789,6262.7,0
2030-08-28,00:23:00,Servicenow,-1907.3,Honolulu HI,64465,4355.4,1
2030-08-30,18:28:00,McDonald's,-69.3,Orlando FL,32816,6193.4,0
2030-08-30,10:58:00,Movie Theater,-41.08,Orlando FL,32816,6152.32,0
2030-08-30,14:59:00,Amusement Park,-31.34,Winter Park FL,32789,6120.98,0
2030-08-31,09:08:00,Starbucks,-50.18,Orlando FL,32816,6070.8,0
2030-09-01,09:00:00,Rent,-960.0,Oviedo FL,32765,5110.8,0
2030-09-01,09:00:00,Insurance,-197.46,Oviedo FL,32765,4913.34,0
2030-09-01,09:00:00,Car,-300.0,Oviedo FL,32765,4613.34,0
2030-09-01,14:28:00,Starbucks,-10.28,Orlando FL,32816,4603.06,0
2030-09-01,16:48:00,Starbucks,-18.3,Winter Park FL,32789,4584.76,0
2030-09-01,11:43:00,Subway,-12.23,Winter Park FL,32789,4572.53,0
2030-09-02,08:00:00,Paycheck,2000.0,Oviedo FL,32765,6572.53,0
2030-09-02,09:43:00,Servicenow,-2062.06,Anchorage AL,61036,4510.47,1
2030-09-02,14:38:00,McDonald's,-22.31,Winter Park FL,32789,6550.22,0
2030-09-02,19:04:00,Walmart,-270.55,Winter Park FL,32789,6279.67,0
2030-09-03,18:49:00,Walmart,-165.8,Oviedo FL,32765,6113.87,0
2030-09-03,12:06:00,Subway,-12.59,Orlando FL,32816,6101.28,0
2030-09-03,20:55:00,Publix,-105.91,Oviedo FL,32765,5995.37,0
2030-09-04,10:54:00,Pep Boys,-185.75,Oviedo FL,32765,5809.62,0
2030-09-05,19:03:00,Best Buy,-56.62,Orlando FL,32816,5753.0,0
2030-09-07,09:00:00,Spotify,-11.99,Oviedo FL,32765,5741.01,0
2030-09-07,09:00:00,Internet,-70.89,Oviedo FL,32765,5670.12,0
2030-09-07,09:00:00,ChatGPT Plus,-20.0,Oviedo FL,32765,5650.12,0
2030-09-07,16:17:00,Walgreens,-49.46,Winter Park FL,32789,5600.66,0
2030-09-09,20:58:00,Pep Boys,-84.13,Oviedo FL,32765,5516.53,0
2030-09-10,21:20:00,Dollar Tree,-35.51,Oviedo FL,32765,5481.02,0
2030-09-10,15:20:00,Burger King,-25.72,Oviedo FL,32765,5455.3,0
2030-09-11,16:18:00,Trader Joe's,-86.41,Oviedo FL,32765,5368.89,0
2030-09-11,20:24:00,Chevron,-16.5,Orlando FL,32816,5352.39,0
2030-09-11,08:55:00,Amazon,-62.95,Oviedo FL,32765,5289.44,0
2030-09-12,15:18:00,CVS,-47.32,Winter Park FL,32789,5242.12,0
2030-09-13,02:11:00,Servicenow,-329.23,Pyongyang NK,79946,4912.89,1
2030-09-13,09:30:00,McDonald's,-6.22,Winter Park FL,32789,5235.9,0
2030-09-13,14:03:00,Burger King,-6.06,Orlando FL,32816,5229.84,0
2030-09-14,08:31:00,Servicenow,-410.95,Mexico City MC,68213,4818.89,1
2030-09-14,11:30:00,Amusement Park,-57.04,Winter Park FL,32789,5172.8,0
2030-09-14,19:09:00,Five Below,-47.82,Orlando FL,32816,5124.98,0
2030-09-14,14:16:00,Subway,-24.17,Orlando FL,32816,5100.81,0
2030-09-15,20:43:00,Burger King,-35.23,Orlando FL,32816,5065.58,0
2030-09-15,20:40:00,CVS,-30.65,Oviedo FL,32765,5034.93,0
2030-09-16,08:00:00,Paycheck,2000.0,Oviedo FL,32765,7034.93,0
2030-09-17,09:26:00,Magic the Gathering,-623.73,Honolulu HI,79706,6411.2,1
2030-09-18,14:22:00,Best Buy,-21.78,Oviedo FL,32765,7013.15,0
2030-09-18,20:20:00,Target,-210.92,Oviedo FL,32765,6802.23,0
2030-09-18,12:27:00,Movie Theater,-67.81,Orlando FL,32816,6734.42,0
2030-09-20,08:52:00,Netflix,-23.47,Orlando FL,32816,6710.95,0
2030-09-20,20:08:00,Concert Tickets,-27.74,Orlando FL,32816,6683.21,0
2030-09-20,19:06:00,Five Below,-81.7,Winter Park FL,32789,6601.51,0
2030-09-23,21:16:00,Pep Boys,-341.11,Orlando FL,32816,6260.4,0
2030-09-23,08:19:00,Concert Tickets,-35.55,Oviedo FL,32765,6224.85,0
2030-09-23,00:38:00,Impractical Jokers,-2176.23,Groton CT,18134,4048.62,1
2030-09-24,10:33:00,Kroger,-66.53,Oviedo FL,32765,6158.32,0
2030-09-24,21:08:00,Dollar Tree,-52.01,Oviedo FL,32765,6106.31,0
2030-09-24,17:43:00,Best Buy,-186.57,Orlando FL,32816,5919.74,0
2030-09-25,14:17:00,Walmart,-91.75,Winter Park FL,32789,5827.99,0
2030-09-26,15:30:00,Dollar Tree,-46.33,Winter Park FL,32789,5781.66,0
2030-09-26,17:49:00,IBM,-1346.37,Groton CT,69093,4435.29,1
2030-09-26,15:27:00,Walmart,-127.22,Oviedo FL,32765,5654.44,0
2030-09-26,12:27:00,Fat Joe,-165.73,Los Angeles CA,45758,5488.71,1
2030-09-26,10:27:00,Walgreens,-36.28,Oviedo FL,32765,5618.16,0
2030-09-28,19:50:00,McDonald's,-32.51,Oviedo FL,32765,5585.65,0
2030-09-28,12:01:00,Lockheed Martin,-585.1,London EN,77508,5000.55,1
2030-09-28,13:28:00,CVS,-29.99,Winter Park FL,32789,5555.66,0
2030-09-28,15:34:00,Starbucks,-5.65,Oviedo FL,32765,5550.01,0
2030-09-29,01:09:00,IBM,-391.57,Tokyo JP,94622,5158.44,1
2030-09-29,08:15:00,Burger King,-25.32,Oviedo FL,32765,5524.69,0
2030-09-29,10:13:00,Netflix,-50.45,Oviedo FL,32765,5474.24,0
2030-09-29,17:51:00,Dollar Tree,-9.36,Orlando FL,32816,5464.88,0
2030-09-30,08:00:00,Paycheck,2000.0,Oviedo FL,32765,7464.88,0
2030-09-30,16:21:00,Shell,-44.64,Oviedo FL,32765,7420.24,0
2030-09-30,12:11:00,Magic the Gathering,-2760.57,Mexico City MC,73111,4659.67,1
2030-09-30,20:34:00,Movie Theater,-26.5,Orlando FL,32816,7393.74,0
2030-09-30,19:09:00,Amazon,-188.46,Oviedo FL,32765,7205.28,0
2030-10-01,09:00:00,Rent,-960.0,Oviedo FL,32765,6245.28,0
2030-10-01,09:00:00,Insurance,-197.46,Oviedo FL,32765,6047.82,0
2030-10-01,09:00:00,Car,-300.0,Oviedo FL,32765,5747.82,0
2030-10-02,20:57:00,Subway,-16.2,Winter Park FL,32789,5731.62,0
2030-10-03,11:10:00,Target,-70.36,Winter Park FL,32789,5661.26,0
2030-10-03,21:27:00,Amusement Park,-37.68,Orlando FL,32816,5623.58,0
2030-10-04,16:10:00,Shell,-22.18,Winter Park FL,32789,5601.4,0
2030-10-04,17:54:00,AutoZone,-70.47,Orlando FL,32816,5530.93,0
2030-10-04,11:22:00,Subway,-20.68,Winter Park FL,32789,5510.25,0
2030-10-05,20:17:00,Kroger,-93.56,Winter Park FL,32789,5416.69,0
2030-10-05,09:49:00,Starbucks,-35.22,Winter Park FL,32789,5381.47,0
2030-10-05,18:36:00,Walgreens,-11.01,Orlando FL,32816,5370.46,0
2030-10-06,09:10:00,Starbucks,-29.53,Oviedo FL,32765,5340.93,0
2030-10-06,11:41:00,Netflix,-13.65,Orlando FL,32816,5327.28,0
2030-10-06,16:09:00,Exxon,-27.63,Oviedo FL,32765,5299.65,0
2030-10-07,09:00:00,Spotify,-11.99,Oviedo FL,32765,5287.66,0
2030-10-07,09:00:00,Internet,-70.89,Oviedo FL,32765,5216.77,0
2030-10-07,09:00:00,ChatGPT Plus,-20.0,Oviedo FL,32765,5196.77,0
2030-10-07,21:38:00,Target,-21.23,Winter Park FL,32789,5175.54,0
2030-10-07,12:11:00,Starbucks,-34.37,Orlando FL,32816,5141.17,0
2030-10-08,14:17:00,McDonald's,-19.42,Orlando FL,32816,5121.75,0
2030-10-09,13:36:00,Onlyfans,-2743.61,Groton CT,95104,2378.14,1
2030-10-09,08:16:00,Amusement Park,-10.48,Orlando FL,32816,5111.27,0
2030-10-09,19:08:00,Concert Tickets,-31.8,Oviedo FL,32765,5079.47,0
2030-10-10,21:15:00,Publix,-84.75,Orlando FL,32816,4994.72,0
2030-10-10,15:28:00,Movie Theater,-10.43,Oviedo FL,32765,4984.29,0
2030-10-12,05:11:00,Magic the Gathering,-1801.67,Charleston SC,81391,3182.62,1
2030-10-12,10:43:00,Target,-141.32,Orlando FL,32816,4842.97,0
2030-10-12,21:50:00,Pep Boys,-199.8,Orlando FL,32816,4643.17,0
2030-10-14,08:00:00,Paycheck,2000.0,Oviedo FL,32765,6643.17,0
2030-10-14,14:14:00,Magic the Gathering,-2609.29,Honolulu HI,86997,4033.88,1
2030-10-14,16:26:00,Walmart,-79.22,Winter Park FL,32789,6563.95,0
2030-10-14,21:19:00,BP,-28.6,Orlando FL,32816,6535.35,0
2030-10-14,22:33:00,Onlyfans,-2852.33,Honolulu HI,84511,3683.02,1
2030-10-14,16:37:00,McDonald's,-60.69,Orlando FL,32816,6474.66,0
2030-10-15,20:22:00,Monster Energy,-1315.34,Pyongyang NK,27013,5159.32,1
2030-10-15,16:26:00,BP,-51.38,Orlando FL,32816,6423.28,0
2030-10-15,10:47:00,Subway,-11.41,Oviedo FL,32765,6411.87,0
2030-10-15,18:54:00,McDonald's,-12.47,Orlando FL,32816,6399.4,0
2030-10-16,14:41:00,Subway,-63.34,Orlando FL,32816,6336.06,0
2030-10-16,14:49:00,Target,-107.9,Oviedo FL,32765,6228.16,0
2030-10-16,14:11:00,Best Buy,-150.61,Winter Park FL,32789,6077.55,0
2030-10-17,19:13:00,McDonald's,-50.03,Winter Park FL,32789,6027.52,0
2030-10-19,20:19:00,Subway,-37.83,Winter Park FL,32789,5989.69,0
2030-10-19,17:24:00,Concert Tickets,-49.66,Oviedo FL,32765,5940.03,0
2030-10-19,14:21:00,Chevron,-24.44,Orlando FL,32816,5915.59,0
2030-10-19,03:18:00,Monster Energy,-1363.06,London EN,35042,4552.53,1
2030-10-20,12:03:00,McDonald's,-23.06,Winter Park FL,32789,5892.53,0
2030-10-20,22:43:00,Paypal,-2705.58,London EN,39202,3186.95,1
2030-10-20,16:22:00,CVS,-12.17,Oviedo FL,32765,5880.36,0
2030-10-20,01:18:00,Accelerators,-949.29,Los Angeles CA,35744,4931.07,1
2030-10-20,17:52:00,Best Buy,-93.16,Orlando FL,32816,5787.2,0
2030-10-21,08:43:00,Walmart,-123.52,Oviedo FL,32765,5663.68,0
2030-10-21,22:26:00,Monster Energy,-1468.25,Mexico City MC,94405,4195.43,1
2030-10-21,12:01:00,Whole Foods,-37.45,Winter Park FL,32789,5626.23,0
2030-10-22,15:11:00,McDonald's,-37.06,Winter Park FL,32789,5589.17,0
2030-10-23,16:35:00,Starbucks,-11.74,Oviedo FL,32765,5577.43,0
2030-10-23,21:12:00,Starbucks,-34.72,Oviedo FL,32765,5542.71,0
2030-10-23,10:06:00,Exxon,-17.3,Winter Park FL,32789,5525.41,0
2030-10-24,10:04:00,Burger King,-19.42,Winter Park FL,32789,5505.99,0
2030-10-24,15:55:00,Amusement Park,-56.7,Orlando FL,32816,5449.29,0
2030-10-24,14:29:00,Starbucks,-38.86,Orlando FL,32816,5410.43,0
2030-10-25,16:07:00,Walmart,-143.02,Oviedo FL,32765,5267.41,0
2030-10-25,17:51:00,Subway,-35.57,Winter Park FL,32789,5231.84,0
2030-10-25,16:00:00,Burger King,-22.71,Winter Park FL,32789,5209.13,0
2030-10-26,21:45:00,Target,-87.83,Winter Park FL,32789,5121.3,0
2030-10-26,08:06:00,BP,-27.9,Orlando FL,32816,5093.4,0
2030-10-28,08:00:00,Paycheck,2000.0,Oviedo FL,32765,7093.4,0
2030-10-28,06:08:00,Onlyfans,-2091.3,Groton CT,37115,5002.1,1
2030-10-28,09:09:00,Amazon,-200.38,Winter Park FL,32789,6893.02,0
2030-10-28,11:02:00,Midas,-302.5,Orlando FL,32816,6590.52,0
2030-10-28,12:40:00,Onlyfans,-2546.12,New York NY,27593,4044.4,1
2030-10-28,15:06:00,Exxon,-54.33,Winter Park FL,32789,6536.19,0
2030-10-29,13:09:00,Subway,-47.43,Orlando FL,32816,6488.76,0
2030-10-29,14:07:00,Subway,-40.47,Winter Park FL,32789,6448.29,0
2030-10-30,08:56:00,Amazon,-23.88,Oviedo FL,32765,6424.41,0
2030-10-31,18:51:00,CVS,-67.87,Oviedo FL,32765,6356.54,0
2030-10-31,08:42:00,Starbucks,-38.7,Oviedo FL,32765,6317.84,0
2030-11-01,09:00:00,Rent,-960.0,Oviedo FL,32765,5357.84,0
2030-11-01,09:00:00,Insurance,-197.46,Oviedo FL,32765,5160.38,0
2030-11-01,09:00:00,Car,-300.0,Oviedo FL,32765,4860.38,0
2030-11-01,14:35:00,Subway,-31.96,Winter Park FL,32789,4828.42,0
2030-11-01,19:35:00,Burger King,-25.73,Winter Park FL,32789,4802.69,0
2030-11-01,10:54:00,Exxon,-19.33,Orlando FL,32816,4783.36,0
2030-11-02,09:38:00,CVS,-34.05,Orlando FL,32816,4749.31,0
2030-11-02,19:27:00,Whole Foods,-82.11,Oviedo FL,32765,4667.2,0
2030-11-02,14:11:00,Kroger,-62.55,Orlando FL,32816,4604.65,0
2030-11-03,09:44:00,Subway,-26.82,Winter Park FL,32789,4577.83,0
2030-11-03,10:34:00,Amazon,-41.78,Oviedo FL,32765,4536.05,0
2030-11-03,07:39:00,Accelerators,-1963.46,Pittsburgh PA,44116,2572.59,1
2030-11-03,15:07:00,Walmart,-40.38,Oviedo FL,32765,4495.67,0
2030-11-06,18:50:00,Movie Theater,-43.39,Orlando FL,32816,4452.28,0
2030-11-07,09:00:00,Spotify,-11.99,Oviedo FL,32765,4440.29,0
2030-11-07,09:00:00,Internet,-70.89,Oviedo FL,32765,4369.4,0
2030-11-07,09:00:00,ChatGPT Plus,-20.0,Oviedo FL,32765,4349.4,0
2030-11-07,15:51:00,Best Buy,-21.83,Orlando FL,32816,4327.57,0
2030-11-07,13:08:00,Jiffy Lube,-70.31,Winter Park FL,32789,4257.26,0
2030-11-07,19:34:00,Walmart,-140.88,Winter Park FL,32789,4116.38,0
2030-11-08,21:00:00,Kroger,-68.42,Winter Park FL,32789,4047.96,0
2030-11-08,12:33:00,Chevron,-23.24,Oviedo FL,32765,4024.72,0
2030-11-08,17:49:00,Dollar Tree,-36.17,Orlando FL,32816,3988.55,0
2030-11-09,12:51:00,Jiffy Lube,-106.86,Winter Park FL,32789,3881.69,0
2030-11-10,10:07:00,Chevron,-18.56,Winter Park FL,32789,3863.13,0
2030-11-10,15:46:00,Pep Boys,-138.07,Oviedo FL,32765,3725.06,0
2030-11-10,12:29:00,Accelerators,-2565.64,Groton CT,91913,1159.42,1
2030-11-10,21:12:00,Target,-23.9,Orlando FL,32816,3701.16,0
2030-11-11,08:00:00,Paycheck,2000.0,Oviedo FL,32765,5701.16,0
2030-11-11,08:27:00,Walmart,-47.52,Orlando FL,32816,5653.64,0
2030-11-11,10:58:00,McDonald's,-16.18,Orlando FL,32816,5637.46,0
2030-11-11,21:47:00,McDonald's,-15.09,Orlando FL,32816,5622.37,0
2030-11-12,02:12:00,Fat Joe,-2528.89,Anchorage AL,21668,3093.48,1
2030-11-12,13:31:00,Five Below,-41.59,Orlando FL,32816,5580.78,0
2030-11-12,20:27:00,Subway,-6.82,Orlando FL,32816,5573.96,0
2030-11-12,18:42:00,Amazon,-138.66,Orlando FL,32816,5435.3,0
2030-11-13,15:19:00,McDonald's,-26.68,Winter Park FL,32789,5408.62,0
2030-11-13,08:53:00,Amazon,-76.48,Winter Park FL,32789,5332.14,0
2030-11-13,09:46:00,Magic the Gathering,-1759.42,Groton CT,71618,3572.72,1
2030-11-14,03:01:00,Fat Joe,-2791.29,London EN,22034,2540.85,1
2030-11-14,15:26:00,Exxon,-19.9,Oviedo FL,32765,5312.24,0
2030-11-14,21:57:00,Trader Joe's,-46.32,Orlando FL,32816,5265.92,0
2030-11-14,15:19:00,AutoZone,-169.05,Oviedo FL,32765,5096.87,0
2030-11-15,15:15:00,Best Buy,-123.98,Oviedo FL,32765,4972.89,0
2030-11-15,18:37:00,Exxon,-18.05,Winter Park FL,32789,4954.84,0
2030-11-15,11:22:00,Target,-23.05,Orlando FL,32816,4931.79,0
2030-11-15,14:47:00,Fraud,-269.8,London EN,70234,4661.99,1
2030-11-18,10:12:00,Best Buy,-138.71,Oviedo FL,32765,4793.08,0
2030-11-18,18:44:00,Lockheed Martin,-2897.45,Mexico City MC,58357,1895.63,1
2030-11-18,21:09:00,McDonald's,-5.73,Oviedo FL,32765,4787.35,0
2030-11-18,05:25:00,Servicenow,-1352.52,Groton CT,96447,3434.83,1
2030-11-20,09:59:00,Starbucks,-5.72,Oviedo FL,32765,4781.63,0
2030-11-20,13:01:00,Burger King,-31.15,Winter Park FL,32789,4750.48,0
2030-11-20,08:02:00,Kroger,-30.71,Orlando FL,32816,4719.77,0
2030-11-22,18:44:00,Onlyfans,-2394.58,Pyongyang NK,99468,2325.19,1
2030-11-22,21:53:00,Walmart,-138.57,Orlando FL,32816,4581.2,0
2030-11-22,09:31:00,Best Buy,-73.51,Orlando FL,32816,4507.69,0
2030-11-23,10:40:00,Burger King,-15.45,Orlando FL,32816,4492.24,0
2030-11-23,20:43:00,Impractical Jokers,-1880.22,Charleston SC,18396,2612.02,1
2030-11-25,08:00:00,Paycheck,2000.0,Oviedo FL,32765,6492.24,0
2030-11-25,09:16:00,Walmart,-25.0,Orlando FL,32816,6467.24,0
2030-11-25,11:43:00,Pep Boys,-297.25,Orlando FL,32816,6169.99,0
2030-11-25,09:33:00,Burger King,-46.49,Oviedo FL,32765,6123.5,0
2030-11-26,14:35:00,Kroger,-144.45,Winter Park FL,32789,5979.05,0
2030-11-26,20:27:00,Paypal,-2498.56,Honolulu HI,14576,3480.49,1
2030-11-26,12:05:00,Starbucks,-34.04,Oviedo FL,32765,5945.01,0
2030-11-27,20:19:00,Subway,-33.23,Oviedo FL,32765,5911.78,0
2030-11-27,16:47:00,Walmart,-43.56,Oviedo FL,32765,5868.22,0
2030-11-28,15:19:00,Starbucks,-33.4,Orlando FL,32816,5834.82,0
2030-11-28,14:39:00,Walgreens,-8.55,Winter Park FL,32789,5826.27,0
2030-11-29,20:57:00,Whole Foods,-33.03,Winter Park FL,32789,5793.24,0
2030-11-29,15:19:00,Servicenow,-1590.38,New York NY,85728,4202.86,1
2030-11-29,15:10:00,Starbucks,-5.99,Winter Park FL,32789,5787.25,0
2030-11-29,12:43:00,Target,-126.25,Winter Park FL,32789,5661.0,0
2030-12-01,09:00:00,Rent,-960.0,Oviedo FL,32765,4701.0,0
2030-12-01,09:00:00,Insurance,-197.46,Oviedo FL,32765,4503.54,0
2030-12-01,09:00:00,Car,-300.0,Oviedo FL,32765,4203.54,0
2030-12-01,10:21:00,McDonald's,-10.91,Orlando FL,32816,4192.63,0
2030-12-01,17:26:00,CVS,-6.93,Oviedo FL,32765,4185.7,0
2030-12-01,12:36:00,Walmart,-89.37,Oviedo FL,32765,4096.33,0
2030-12-01,05:54:00,Onlyfans,-2310.35,Pittsburgh PA,43821,1785.98,1
2030-12-02,11:54:00,CVS,-15.85,Winter Park FL,32789,4080.48,0
2030-12-03,13:58:00,Shell,-19.57,Oviedo FL,32765,4060.91,0
2030-12-03,10:19:00,BP,-17.52,Winter Park FL,32789,4043.39,0
2030-12-05,08:42:00,Walmart,-111.81,Orlando FL,32816,3931.58,0
2030-12-06,21:02:00,Subway,-7.63,Orlando FL,32816,3923.95,0
2030-12-06,08:35:00,Burger King,-35.79,Orlando FL,32816,3888.16,0
2030-12-06,11:37:00,Concert Tickets,-45.75,Oviedo FL,32765,3842.41,0
2030-12-06,08:04:00,Magic the Gathering,-2225.4,Honolulu HI,72123,1617.01,1
2030-12-07,09:00:00,Spotify,-11.99,Oviedo FL,32765,3830.42,0
2030-12-07,09:00:00,Internet,-70.89,Oviedo FL,32765,3759.53,0
2030-12-07,09:00:00,ChatGPT Plus,-20.0,Oviedo FL,32765,3739.53,0
2030-12-07,18:14:00,Jiffy Lube,-117.21,Winter Park FL,32789,3622.32,0
2030-12-08,20:26:00,Pawn Stars,-1622.37,Pyongyang NK,85128,1999.95,1
2030-12-08,20:16:00,Chevron,-19.65,Orlando FL,32816,3602.67,0
2030-12-08,11:51:00,Whole Foods,-70.0,Winter Park FL,32789,3532.67,0
2030-12-08,19:40:00,Burger King,-36.26,Winter Park FL,32789,3496.41,0
2030-12-09,08:00:00,Paycheck,2000.0,Oviedo FL,32765,5496.41,0
2030-12-09,12:12:00,Movie Theater,-55.71,Orlando FL,32816,5440.7,0
2030-12-09,11:24:00,Pep Boys,-83.64,Winter Park FL,32789,5357.06,0
2030-12-09,21:52:00,Kroger,-43.12,Winter Park FL,32789,5313.94,0
2030-12-10,12:45:00,Chevron,-25.38,Winter Park FL,32789,5288.56,0
2030-12-10,09:06:00,Concert Tickets,-31.87,Orlando FL,32816,5256.69,0
2030-12-10,10:25:00,Netflix,-10.92,Winter Park FL,32789,5245.77,0
2030-12-11,19:53:00,Five Below,-21.59,Orlando FL,32816,5224.18,0
2030-12-12,23:21:00,Magic the Gathering,-975.0,Charleston SC,11380,4249.18,1
2030-12-12,11:27:00,Chevron,-15.79,Orlando FL,32816,5208.39,0
2030-12-13,20:26:00,Publix,-79.08,Winter Park FL,32789,5129.31,0
2030-12-13,09:52:00,Starbucks,-32.99,Oviedo FL,32765,5096.32,0
2030-12-14,13:12:00,Dollar Tree,-6.09,Orlando FL,32816,5090.23,0
2030-12-14,15:50:00,Servicenow,-1856.72,Pittsburgh PA,69180,3233.51,1
2030-12-14,10:52:00,Starbucks,-10.54,Orlando FL,32816,5079.69,0
2030-12-15,12:41:00,Fraud,-1366.5,Mexico City MC,59699,3713.19,1
2030-12-15,21:54:00,Publix,-71.94,Oviedo FL,32765,5007.75,0
2030-12-15,12:30:00,Fat Joe,-2437.76,Charleston SC,18949,2569.99,1
2030-12-15,15:05:00,Burger King,-19.48,Winter Park FL,32789,4988.27,0
2030-12-16,16:03:00,Five Below,-16.71,Oviedo FL,32765,4971.56,0
2030-12-16,11:51:00,Walmart,-58.92,Winter Park FL,32789,4912.64,0
2030-12-16,13:19:00,Netflix,-11.63,Oviedo FL,32765,4901.01,0
2030-12-17,17:26:00,Whole Foods,-85.04,Oviedo FL,32765,4815.97,0
2030-12-17,19:07:00,Accelerators,-2551.82,New York NY,16554,2264.15,1
2030-12-18,09:57:00,Burger King,-25.18,Orlando FL,32816,4790.79,0
2030-12-18,13:57:00,Walmart,-81.88,Winter Park FL,32789,4708.91,0
2030-12-18,21:36:00,Servicenow,-736.46,Groton CT,52211,3972.45,1
2030-12-19,09:21:00,Onlyfans,-1441.22,Los Angeles CA,48566,3267.69,1
2030-12-19,10:06:00,Starbucks,-20.23,Winter Park FL,32789,4688.68,0
2030-12-20,11:51:00,Burger King,-13.25,Oviedo FL,32765,4675.43,0
2030-12-20,06:13:00,Servicenow,-1950.07,Pittsburgh PA,30023,2725.36,1
2030-12-20,11:41:00,McDonald's,-24.92,Winter Park FL,32789,4650.51,0
2030-12-20,14:32:00,Jiffy Lube,-146.84,Orlando FL,32816,4503.67,0
2030-12-21,11:10:00,Subway,-6.18,Oviedo FL,32765,4497.49,0
2030-12-23,08:00:00,Paycheck,2000.0,Oviedo FL,32765,6497.49,0
2030-12-23,12:37:00,Walgreens,-59.45,Oviedo FL,32765,6438.04,0
2030-12-26,18:01:00,Five Below,-62.66,Oviedo FL,32765,6375.38,0
2030-12-26,11:20:00,Walgreens,-65.1,Winter Park FL,32789,6310.28,0
2030-12-27,10:11:00,Walmart,-118.86,Oviedo FL,32765,6191.42,0
2030-12-28,05:15:00,Magic the Gathering,-156.75,Pyongyang NK,87911,6034.67,1
2030-12-28,13:34:00,Amazon,-66.61,Winter Park FL,32789,6124.81,0
2030-12-28,08:20:00,Amazon,-240.0,Oviedo FL,32765,5884.81,0
2030-12-28,15:34:00,Shell,-20.33,Oviedo FL,32765,5864.48,0
2030-12-30,19:39:00,Monster Energy,-602.76,Mexico City MC,15828,5261.72,1
2030-12-30,18:45:00,McDonald's,-18.09,Oviedo FL,32765,5846.39,0
2030-12-30,19:13:00,Walgreens,-28.16,Orlando FL,32816,5818.23,0
2030-12-30,11:34:00,Movie Theater,-21.57,Winter Park FL,32789,5796.66,0
2030-12-31,21:17:00,McDonald's,-6.24,Orlando FL,32816,5790.42,0
2030-12-31,16:08:00,Starbucks,-37.14,Oviedo FL,32765,5753.28,0
2030-12-31,08:00:00,Shell,-17.27,Oviedo FL,32765,5736.01,0
2031-01-01,09:00:00,Rent,-960.0,Oviedo FL,32765,4776.01,0
2031-01-01,09:00:00,Insurance,-197.46,Oviedo FL,32765,4578.55,0
2031-01-01,09:00:00,Car,-300.0,Oviedo FL,32765,4278.55,0
2031-01-02,14:33:00,Whole Foods,-31.29,Winter Park FL,32789,4247.26,0
2031-01-02,14:39:00,Publix,-44.9,Oviedo FL,32765,4202.36,0
2031-01-03,20:33:00,Dollar Tree,-34.59,Orlando FL,32816,4167.77,0
2031-01-03,13:06:00,Amusement Park,-36.86,Orlando FL,32816,4130.91,0
2031-01-04,17:51:00,Publix,-45.35,Winter Park FL,32789,4085.56,0
2031-01-05,12:33:00,Pawn Stars,-2789.07,London EN,96791,1296.49,1
2031-01-06,08:00:00,Paycheck,2000.0,Oviedo FL,32765,6085.56,0
2031-01-06,17:37:00,Starbucks,-33.66,Orlando FL,32816,6051.9,0
2031-01-07,09:00:00,Spotify,-11.99,Oviedo FL,32765,6039.91,0
2031-01-07,09:00:00,Internet,-70.89,Oviedo FL,32765,5969.02,0
2031-01-07,09:00:00,ChatGPT Plus,-20.0,Oviedo FL,32765,5949.02,0
2031-01-07,19:08:00,Whole Foods,-67.62,Winter Park FL,32789,5881.4,0
2031-01-07,02:16:00,Magic the Gathering,-1510.88,Charleston SC,33982,4370.52,1
2031-01-07,08:49:00,Whole Foods,-51.54,Winter Park FL,32789,5829.86,0
2031-01-07,21:42:00,Pep Boys,-155.08,Orlando FL,32816,5674.78,0
2031-01-08,18:24:00,Burger King,-10.07,Winter Park FL,32789,5664.71,0
2031-01-09,21:57:00,Burger King,-28.56,Oviedo FL,32765,5636.15,0
2031-01-09,21:51:00,Best Buy,-13.07,Orlando FL,32816,5623.08,0
2031-01-10,08:16:00,BP,-25.38,Oviedo FL,32765,5597.7,0
2031-01-10,13:09:00,Concert Tickets,-48.63,Orlando FL,32816,5549.07,0
2031-01-11,08:55:00,Jiffy Lube,-113.58,Oviedo FL,32765,5435.49,0
2031-01-11,15:05:00,Burger King,-22.75,Oviedo FL,32765,5412.74,0
2031-01-11,12:57:00,Lockheed Martin,-695.5,Charleston SC,96652,4717.24,1
2031-01-11,09:49:00,Subway,-13.62,Oviedo FL,32765,5399.12,0
2031-01-12,15:44:00,Exxon,-25.56,Winter Park FL,32789,5373.56,0
2031-01-12,08:26:00,Amazon,-20.14,Orlando FL,32816,5353.42,0
2031-01-12,17:01:00,Starbucks,-18.99,Winter Park FL,32789,5334.43,0
2031-01-13,18:19:00,Subway,-35.69,Orlando FL,32816,5298.74,0
2031-01-13,16:08:00,Fraud,-2274.45,Anchorage AL,76675,3024.29,1
2031-01-15,21:33:00,Exxon,-23.25,Oviedo FL,32765,5275.49,0
2031-01-15,19:58:00,Burger King,-8.79,Orlando FL,32816,5266.7,0
2031-01-15,09:10:00,Exxon,-17.5,Orlando FL,32816,5249.2,0
2031-01-16,09:26:00,Walmart,-93.93,Orlando FL,32816,5155.27,0
2031-01-16,22:39:00,Fat Joe,-877.98,New York NY,91047,4277.29,1
2031-01-16,13:44:00,Starbucks,-34.38,Winter Park FL,32789,5120.89,0
2031-01-16,08:05:00,Amazon,-33.9,Orlando FL,32816,5086.99,0
2031-01-18,21:39:00,Burger King,-20.37,Orlando FL,32816,5066.62,0
2031-01-19,15:55:00,Starbucks,-11.93,Oviedo FL,32765,5054.69,0
2031-01-19,13:21:00,Walmart,-118.89,Orlando FL,32816,4935.8,0
2031-01-19,12:11:00,Whole Foods,-34.63,Winter Park FL,32789,4901.17,0
2031-01-20,08:00:00,Paycheck,2000.0,Oviedo FL,32765,6901.17,0
2031-01-20,21:14:00,Jiffy Lube,-134.44,Orlando FL,32816,6766.73,0
2031-01-20,18:33:00,Concert Tickets,-38.81,Orlando FL,32816,6727.92,0
2031-01-22,17:57:00,Starbucks,-16.09,Orlando FL,32816,6711.83,0
2031-01-23,09:25:00,Walmart,-76.56,Orlando FL,32816,6635.27,0
2031-01-23,15:51:00,McDonald's,-57.8,Winter Park FL,32789,6577.47,0
2031-01-24,10:21:00,Walmart,-249.32,Winter Park FL,32789,6328.15,0
2031-01-25,17:24:00,Five Below,-40.13,Oviedo FL,32765,6288.02,0
2031-01-25,19:44:00,McDonald's,-51.58,Oviedo FL,32765,6236.44,0
2031-01-25,19:39:00,Exxon,-45.13,Oviedo FL,32765,6191.31,0
2031-01-27,09:20:00,Starbucks,-14.18,Orlando FL,32816,6177.13,0
2031-01-27,15:25:00,Amazon,-160.01,Orlando FL,32816,6017.12,0
2031-01-27,10:52:00,Kroger,-129.91,Oviedo FL,32765,5887.21,0
2031-01-28,20:40:00,Starbucks,-9.96,Oviedo FL,32765,5877.25,0
2031-01-28,11:41:00,McDonald's,-30.76,Orlando FL,32816,5846.49,0
2031-01-28,00:08:00,Pawn Stars,-178.97,Charleston SC,19015,5667.52,1
2031-01-28,10:06:00,Walmart,-11.13,Oviedo FL,32765,5835.36,0
2031-01-29,18:14:00,Starbucks,-39.64,Orlando FL,32816,5795.72,0
2031-01-29,14:40:00,Accelerators,-868.11,New York NY,61308,4927.61,1
2031-01-29,11:04:00,Dollar Tree,-22.77,Winter Park FL,32789,5772.95,0
2031-01-30,14:34:00,Chevron,-29.6,Orlando FL,32816,5743.35,0
2031-01-30,21:19:00,Burger King,-16.51,Winter Park FL,32789,5726.84,0
2031-01-31,18:33:00,McDonald's,-35.0,Oviedo FL,32765,5691.84,0
2031-02-01,09:00:00,Rent,-960.0,Oviedo FL,32765,4731.84,0
2031-02-01,09:00:00,Insurance,-197.46,Oviedo FL,32765,4534.38,0
2031-02-01,09:00:00,Car,-300.0,Oviedo FL,32765,4234.38,0
2031-02-01,13:21:00,Subway,-26.93,Orlando FL,32816,4207.45,0
2031-02-01,21:09:00,Five Below,-8.91,Oviedo FL,32765,4198.54,0
2031-02-03,08:00:00,Paycheck,2000.0,Oviedo FL,32765,6198.54,0
2031-02-03,11:17:00,McDonald's,-35.55,Oviedo FL,32765,6162.99,0
2031-02-03,11:12:00,Onlyfans,-137.5,Tokyo JP,50930,6025.49,1
2031-02-03,15:04:00,Publix,-166.11,Oviedo FL,32765,5996.88,0
2031-02-05,17:45:00,Subway,-23.92,Winter Park FL,32789,5972.96,0
2031-02-05,14:10:00,Amusement Park,-22.78,Oviedo FL,32765,5950.18,0
2031-02-05,18:38:00,McDonald's,-12.56,Oviedo FL,32765,5937.62,0
2031-02-07,09:00:00,Spotify,-11.99,Oviedo FL,32765,5925.63,0
2031-02-07,09:00:00,Internet,-70.89,Oviedo FL,32765,5854.74,0
2031-02-07,09:00:00,ChatGPT Plus,-20.0,Oviedo FL,32765,5834.74,0
2031-02-07,18:34:00,Kroger,-96.07,Orlando FL,32816,5738.67,0
2031-02-07,15:25:00,Starbucks,-39.52,Orlando FL,32816,5699.15,0
2031-02-07,08:44:00,Burger King,-22.63,Oviedo FL,32765,5676.52,0
2031-02-08,13:15:00,Paypal,-2509.51,Los Angeles CA,93679,3167.01,1
2031-02-08,20:22:00,Five Below,-36.49,Orlando FL,32816,5640.03,0
2031-02-09,13:47:00,Netflix,-21.36,Oviedo FL,32765,5618.67,0
2031-02-09,08:42:00,Dollar Tree,-46.81,Orlando FL,32816,5571.86,0
2031-02-09,15:04:00,Target,-76.82,Winter Park FL,32789,5495.04,0
2031-02-10,15:26:00,Subway,-7.06,Oviedo FL,32765,5487.98,0
2031-02-10,18:08:00,Accelerators,-482.39,Pyongyang NK,98492,5005.59,1
2031-02-11,09:42:00,Subway,-32.46,Orlando FL,32816,5455.52,0
2031-02-11,16:15:00,CVS,-41.25,Winter Park FL,32789,5414.27,0
2031-02-12,14:29:00,Kroger,-45.02,Winter Park FL,32789,5369.25,0
2031-02-12,17:49:00,McDonald's,-19.17,Oviedo FL,32765,5350.08,0
2031-02-12,13:31:00,IBM,-2360.13,Honolulu HI,23112,2989.95,1
2031-02-13,10:26:00,Publix,-71.27,Winter Park FL,32789,5278.81,0
2031-02-14,15:19:00,Target,-41.66,Orlando FL,32816,5237.15,0
2031-02-15,20:24:00,Subway,-13.32,Orlando FL,32816,5223.83,0
2031-02-15,15:29:00,Impractical Jokers,-1110.42,Pittsburgh PA,26920,4113.41,1
2031-02-16,18:17:00,Burger King,-9.77,Oviedo FL,32765,5214.06,0
2031-02-16,21:18:00,Five Below,-40.22,Oviedo FL,32765,5173.84,0
2031-02-17,08:00:00,Paycheck,2000.0,Oviedo FL,32765,7173.84,0
2031-02-17,18:12:00,Amazon,-278.91,Oviedo FL,32765,6894.93,0
2031-02-17,15:59:00,Paypal,-2511.45,London EN,66160,4383.48,1
2031-02-18,18:40:00,Concert Tickets,-44.26,Winter Park FL,32789,6850.67,0
2031-02-18,09:03:00,Amazon,-209.19,Orlando FL,32816,6641.48,0
2031-02-19,20:32:00,Amazon,-79.14,Orlando FL,32816,6562.34,0
2031-02-19,17:26:00,Burger King,-32.66,Orlando FL,32816,6529.68,0
2031-02-19,08:19:00,Burger King,-51.07,Winter Park FL,32789,6478.61,0
2031-02-19,11:15:00,Monster Energy,-1398.05,Anchorage AL,61651,5080.56,1
2031-02-20,10:17:00,McDonald's,-54.92,Oviedo FL,32765,6423.69,0
2031-02-20,15:56:00,Best Buy,-123.48,Orlando FL,32816,6300.21,0
2031-02-20,08:08:00,Exxon,-54.92,Winter Park FL,32789,6245.29,0
2031-02-21,18:01:00,Starbucks,-45.95,Orlando FL,32816,6199.34,0
2031-02-22,08:52:00,Chevron,-29.43,Orlando FL,32816,6169.91,0
2031-02-22,17:07:00,Netflix,-36.08,Orlando FL,32816,6133.83,0
2031-02-22,14:13:00,McDonald's,-30.59,Winter Park FL,32789,6103.24,0
2031-02-22,00:40:00,Fraud,-1389.35,Tokyo JP,96039,4713.89,1
2031-02-23,13:38:00,Onlyfans,-1216.1,Pittsburgh PA,95578,4887.14,1
2031-02-23,16:44:00,Movie Theater,-103.87,Oviedo FL,32765,5999.37,0
2031-02-24,20:45:00,Five Below,-11.87,Orlando FL,32816,5987.5,0
2031-02-24,09:19:00,Target,-138.56,Orlando FL,32816,5848.94,0
2031-02-25,08:33:00,Publix,-33.86,Winter Park FL,32789,5815.08,0
2031-02-25,20:46:00,Walgreens,-6.49,Winter Park FL,32789,5808.59,0
2031-02-26,11:58:00,Walmart,-84.95,Orlando FL,32816,5723.64,0
2031-02-26,15:26:00,Kroger,-62.24,Winter Park FL,32789,5661.4,0
2031-02-28,10:17:00,Publix,-70.58,Oviedo FL,32765,5590.82,0
2031-02-28,09:05:00,Starbucks,-20.07,Orlando FL,32816,5570.75,0
2031-03-01,09:00:00,Rent,-960.0,Oviedo FL,32765,4610.75,0
2031-03-01,09:00:00,Insurance,-197.46,Oviedo FL,32765,4413.29,0
2031-03-01,09:00:00,Car,-300.0,Oviedo FL,32765,4113.29,0
2031-03-02,14:19:00,Exxon,-18.84,Winter Park FL,32789,4094.45,0
2031-03-02,14:36:00,Fraud,-668.91,Mexico City MC,64240,3425.54,1
2031-03-02,13:57:00,Jiffy Lube,-51.96,Orlando FL,32816,4042.49,0
2031-03-02,10:29:00,Target,-11.29,Orlando FL,32816,4031.2,0
2031-03-02,02:29:00,Monster Energy,-572.6,Groton CT,54005,3458.6,1
2031-03-03,08:00:00,Paycheck,2000.0,Oviedo FL,32765,6031.2,0
2031-03-03,11:44:00,BP,-29.72,Winter Park FL,32789,6001.48,0
2031-03-03,21:55:00,Best Buy,-268.39,Orlando FL,32816,5733.09,0
2031-03-04,22:01:00,Paypal,-2569.78,Pyongyang NK,68133,3163.31,1
2031-03-05,17:01:00,Burger King,-33.46,Orlando FL,32816,5699.63,0
2031-03-06,17:25:00,Amazon,-71.39,Orlando FL,32816,5628.24,0
2031-03-06,14:29:00,Burger King,-39.32,Oviedo FL,32765,5588.92,0
2031-03-06,21:13:00,Movie Theater,-24.11,Winter Park FL,32789,5564.81,0
2031-03-07,09:00:00,Spotify,-11.99,Oviedo FL,32765,5552.82,0
2031-03-07,09:00:00,Internet,-70.89,Oviedo FL,32765,5481.93,0
2031-03-07,09:00:00,ChatGPT Plus,-20.0,Oviedo FL,32765,5461.93,0
2031-03-07,16:39:00,Burger King,-32.65,Orlando FL,32816,5429.28,0
2031-03-07,14:10:00,Burger King,-6.89,Winter Park FL,32789,5422.39,0
2031-03-07,05:58:00,IBM,-775.18,Pittsburgh PA,22166,4647.21,1
2031-03-07,11:41:00,Amusement Park,-39.93,Orlando FL,32816,5382.46,0
2031-03-07,19:46:00,Monster Energy,-293.76,Mexico City MC,88410,5088.7,1
2031-03-08,20:07:00,Kroger,-54.2,Oviedo FL,32765,5328.26,0
2031-03-08,21:43:00,Subway,-10.33,Orlando FL,32816,5317.93,0
2031-03-09,00:09:00,Fat Joe,-2502.46,Groton CT,53397,2815.47,1
2031-03-09,11:12:00,Chevron,-28.17,Winter Park FL,32789,5289.76,0
2031-03-09,09:52:00,Chevron,-20.98,Oviedo FL,32765,5268.78,0
2031-03-10,17:26:00,Fraud,-2463.66,Tokyo JP,40937,2805.12,1
2031-03-10,17:18:00,Amusement Park,-11.52,Winter Park FL,32789,5257.26,0
2031-03-10,17:18:00,Best Buy,-84.35,Orlando FL,32816,5172.91,0
2031-03-10,15:13:00,Fraud,-2179.2,Charleston SC,20298,2993.71,1
2031-03-12,14:48:00,Trader Joe's,-83.8,Oviedo FL,32765,5089.11,0
2031-03-12,21:45:00,Subway,-39.41,Oviedo FL,32765,5049.7,0
2031-03-14,08:58:00,Servicenow,-1854.73,Honolulu HI,23874,3194.97,1
2031-03-14,09:41:00,McDonald's,-26.21,Orlando FL,32816,5023.49,0
2031-03-15,20:52:00,BP,-23.36,Orlando FL,32816,5000.13,0
2031-03-15,12:14:00,Exxon,-24.61,Orlando FL,32816,4975.52,0
2031-03-15,08:14:00,Burger King,-39.54,Oviedo FL,32765,4935.98,0
2031-03-16,14:41:00,Kroger,-43.41,Orlando FL,32816,4892.57,0
2031-03-17,08:00:00,Paycheck,2000.0,Oviedo FL,32765,6892.57,0
2031-03-17,14:25:00,Walgreens,-13.63,Orlando FL,32816,6878.94,0
2031-03-18,11:22:00,Publix,-172.19,Orlando FL,32816,6706.75,0
2031-03-19,12:32:00,Walmart,-233.63,Orlando FL,32816,6473.12,0
2031-03-20,18:30:00,Dollar Tree,-36.59,Winter Park FL,32789,6436.53,0
2031-03-20,14:57:00,McDonald's,-10.35,Winter Park FL,32789,6426.18,0
2031-03-21,17:45:00,McDonald's,-23.76,Oviedo FL,32765,6402.42,0
2031-03-22,17:42:00,BP,-20.71,Oviedo FL,32765,6381.71,0
2031-03-22,08:44:00,McDonald's,-68.97,Orlando FL,32816,6312.74,0
2031-03-22,13:09:00,McDonald's,-27.52,Oviedo FL,32765,6285.22,0
2031-03-23,16:53:00,McDonald's,-76.92,Winter Park FL,32789,6208.3,0
2031-03-23,02:03:00,Onlyfans,-1286.92,Mexico City MC,36057,4921.38,1
2031-03-23,17:11:00,CVS,-16.37,Oviedo FL,32765,6191.93,0
2031-03-23,20:10:00,Walgreens,-89.33,Winter Park FL,32789,6102.6,0
2031-03-23,02:50:00,Monster Energy,-2607.28,Tokyo JP,38766,3495.32,1
2031-03-24,21:46:00,Subway,-60.06,Oviedo FL,32765,6042.54,0
2031-03-24,20:08:00,Subway,-66.94,Winter Park FL,32789,5975.6,0
2031-03-25,19:02:00,Target,-141.75,Winter Park FL,32789,5833.85,0
2031-03-25,09:47:00,Target,-50.88,Winter Park FL,32789,5782.97,0
2031-03-25,16:41:00,BP,-27.49,Winter Park FL,32789,5755.48,0
2031-03-28,13:44:00,Servicenow,-2427.5,Anchorage AL,37228,3327.98,1
2031-03-28,19:55:00,McDonald's,-19.0,Oviedo FL,32765,5736.48,0
2031-03-28,13:11:00,McDonald's,-23.88,Winter Park FL,32789,5712.6,0
2031-03-29,17:05:00,Subway,-21.66,Orlando FL,32816,5690.94,0
2031-03-30,17:25:00,Starbucks,-17.35,Oviedo FL,32765,5673.59,0
2031-03-30,12:34:00,Chevron,-17.65,Oviedo FL,32765,5655.94,0
2031-03-31,08:00:00,Paycheck,2000.0,Oviedo FL,32765,7655.94,0
2031-03-31,18:14:00,Amazon,-270.51,Orlando FL,32816,7385.43,0
2031-04-01,09:00:00,Rent,-960.0,Oviedo FL,32765,6425.43,0
2031-04-01,09:00:00,Insurance,-197.46,Oviedo FL,32765,6227.97,0
2031-04-01,09:00:00,Car,-300.0,Oviedo FL,32765,5927.97,0
2031-04-01,12:56:00,Best Buy,-137.23,Winter Park FL,32789,5790.74,0
2031-04-02,21:00:00,Starbucks,-29.39,Winter Park FL,32789,5761.35,0
2031-04-03,17:26:00,Five Below,-39.54,Oviedo FL,32765,5721.81,0
2031-04-03,18:37:00,Burger King,-8.51,Orlando FL,32816,5713.3,0
2031-04-06,21:22:00,BP,-18.7,Orlando FL,32816,5694.6,0
2031-04-06,17:35:00,Walmart,-147.54,Winter Park FL,32789,5547.06,0
2031-04-07,09:00:00,Spotify,-11.99,Oviedo FL,32765,5535.07,0
2031-04-07,09:00:00,Internet,-70.89,Oviedo FL,32765,5464.18,0
2031-04-07,09:00:00,ChatGPT Plus,-20.0,Oviedo FL,32765,5444.18,0
2031-04-07,10:26:00,Trader Joe's,-46.84,Orlando FL,32816,5397.34,0
2031-04-07,10:18:00,Movie Theater,-23.99,Winter Park FL,32789,5373.35,0
2031-04-08,08:48:00,AutoZone,-99.99,Orlando FL,32816,5273.36,0
2031-04-08,09:42:00,Paypal,-282.63,Charleston SC,34040,4990.73,1
2031-04-08,12:53:00,Walgreens,-12.13,Orlando FL,32816,5261.23,0
2031-04-08,11:42:00,Walmart,-81.02,Winter Park FL,32789,5180.21,0
2031-04-09,15:56:00,CVS,-13.62,Orlando FL,32816,5166.59,0
2031-04-10,19:49:00,Exxon,-21.21,Orlando FL,32816,5145.38,0
2031-04-10,21:03:00,Burger King,-13.52,Winter Park FL,32789,5131.86,0
2031-04-12,21:09:00,Trader Joe's,-31.0,Oviedo FL,32765,5100.86,0
2031-04-13,18:30:00,Concert Tickets,-43.8,Winter Park FL,32789,5057.06,0
2031-04-13,20:08:00,Midas,-80.19,Oviedo FL,32765,4976.87,0
2031-04-13,21:28:00,McDonald's,-25.23,Oviedo FL,32765,4951.64,0
2031-04-14,08:00:00,Paycheck,2000.0,Oviedo FL,32765,6951.64,0
2031-04-14,11:49:00,Amazon,-35.04,Orlando FL,32816,6916.6,0
2031-04-15,11:23:00,Jiffy Lube,-367.87,Winter Park FL,32789,6548.73,0
2031-04-15,18:57:00,Magic the Gathering,-2439.23,Charleston SC,15166,4109.5,1
2031-04-16,03:34:00,IBM,-2477.99,Los Angeles CA,55739,4070.74,1
2031-04-16,08:11:00,Burger King,-46.56,Winter Park FL,32789,6502.17,0
2031-04-16,11:46:00,Amazon,-59.57,Orlando FL,32816,6442.6,0
2031-04-16,20:46:00,Burger King,-11.17,Oviedo FL,32765,6431.43,0
2031-04-17,20:35:00,Subway,-30.1,Winter Park FL,32789,6401.33,0
2031-04-17,18:15:00,Chevron,-28.56,Orlando FL,32816,6372.77,0
2031-04-18,18:22:00,Chevron,-43.93,Oviedo FL,32765,6328.84,0
2031-04-18,11:57:00,Movie Theater,-33.95,Orlando FL,32816,6294.89,0
2031-04-20,08:57:00,Trader Joe's,-65.67,Orlando FL,32816,6229.22,0
2031-04-21,16:29:00,Pep Boys,-146.34,Oviedo FL,32765,6082.88,0
2031-04-22,20:01:00,Chevron,-57.88,Oviedo FL,32765,6025.0,0
2031-04-22,17:41:00,Burger King,-30.71,Winter Park FL,32789,5994.29,0
2031-04-23,13:20:00,Subway,-21.24,Orlando FL,32816,5973.05,0
2031-04-23,18:34:00,Best Buy,-20.09,Oviedo FL,32765,5952.96,0
2031-04-23,15:54:00,Publix,-73.87,Oviedo FL,32765,5879.09,0
2031-04-23,01:47:00,Monster Energy,-2010.44,Mexico City MC,58074,3868.65,1
2031-04-24,13:34:00,Publix,-72.47,Winter Park FL,32789,5806.62,0
2031-04-24,08:50:00,Kroger,-53.37,Winter Park FL,32789,5753.25,0
2031-04-24,17:11:00,Kroger,-86.4,Oviedo FL,32765,5666.85,0
2031-04-25,19:38:00,Concert Tickets,-55.54,Orlando FL,32816,5611.31,0
2031-04-25,12:15:00,Amazon,-123.75,Oviedo FL,32765,5487.56,0
2031-04-26,08:57:00,Starbucks,-5.5,Winter Park FL,32789,5482.06,0
2031-04-26,13:44:00,Amusement Park,-48.58,Winter Park FL,32789,5433.48,0
2031-04-26,15:52:00,Starbucks,-25.72,Oviedo FL,32765,5407.76,0
2031-04-27,14:00:00,Subway,-14.42,Winter Park FL,32789,5393.34,0
2031-04-27,10:00:00,Five Below,-28.76,Winter Park FL,32789,5364.58,0
2031-04-27,20:42:00,Walmart,-147.58,Winter Park FL,32789,5217.0,0
2031-04-28,08:00:00,Paycheck,2000.0,Oviedo FL,32765,7217.0,0
2031-04-28,09:17:00,IBM,-1414.46,Mexico City MC,51196,5802.54,1
2031-04-28,13:39:00,Burger King,-46.7,Oviedo FL,32765,7170.3,0
2031-04-28,13:53:00,Amusement Park,-36.1,Oviedo FL,32765,7134.2,0
2031-04-28,20:37:00,Starbucks,-42.43,Oviedo FL,32765,7091.77,0
2031-04-29,17:10:00,Shell,-31.4,Winter Park FL,32789,7060.37,0
2031-04-29,13:28:00,Burger King,-66.06,Oviedo FL,32765,6994.31,0
2031-04-29,16:38:00,Best Buy,-137.63,Oviedo FL,32765,6856.68,0
2031-04-30,15:18:00,Starbucks,-23.65,Orlando FL,32816,6833.03,0
2031-04-30,19:36:00,Best Buy,-148.07,Oviedo FL,32765,6684.96,0
2031-05-01,09:00:00,Rent,-960.0,Oviedo FL,32765,5724.96,0
2031-05-01,09:00:00,Insurance,-197.46,Oviedo FL,32765,5527.5,0
2031-05-01,09:00:00,Car,-300.0,Oviedo FL,32765,5227.5,0
2031-05-01,21:33:00,Subway,-32.6,Winter Park FL,32789,5194.9,0
2031-05-01,15:27:00,Starbucks,-25.99,Winter Park FL,32789,5168.91,0
2031-05-01,08:23:00,Amazon,-109.83,Oviedo FL,32765,5059.08,0
2031-05-01,15:52:00,Pawn Stars,-567.17,Pyongyang NK,57623,4491.91,1
2031-05-02,11:05:00,Target,-135.84,Orlando FL,32816,4923.24,0
2031-05-02,11:18:00,Exxon,-28.39,Winter Park FL,32789,4894.85,0
2031-05-03,05:48:00,Lockheed Martin,-411.97,London EN,29440,4482.88,1
2031-05-03,09:03:00,Burger King,-14.14,Orlando FL,32816,4880.71,0
2031-05-04,16:58:00,Netflix,-40.38,Orlando FL,32816,4840.33,0
2031-05-04,21:16:00,CVS,-11.88,Orlando FL,32816,4828.45,0
2031-05-04,11:35:00,Shell,-15.7,Oviedo FL,32765,4812.75,0
2031-05-05,19:05:00,Concert Tickets,-55.09,Orlando FL,32816,4757.66,0
2031-05-06,10:41:00,McDonald's,-23.87,Winter Park FL,32789,4733.79,0
2031-05-07,09:00:00,Spotify,-11.99,Oviedo FL,32765,4721.8,0
2031-05-07,09:00:00,Internet,-70.89,Oviedo FL,32765,4650.91,0
2031-05-07,09:00:00,ChatGPT Plus,-20.0,Oviedo FL,32765,4630.91,0
2031-05-08,09:17:00,McDonald's,-26.01,Oviedo FL,32765,4604.9,0
2031-05-09,15:26:00,Five Below,-6.63,Oviedo FL,32765,4598.27,0
2031-05-09,10:53:00,Publix,-93.47,Orlando FL,32816,4504.8,0
2031-05-09,20:59:00,Movie Theater,-33.76,Orlando FL,32816,4471.04,0
2031-05-10,13:30:00,McDonald's,-5.16,Winter Park FL,32789,4465.88,0
2031-05-10,10:52:00,Pep Boys,-133.74,Oviedo FL,32765,4332.14,0
2031-05-10,23:08:00,Fraud,-1978.15,Charleston SC,95404,2353.99,1
2031-05-10,16:33:00,Whole Foods,-72.02,Orlando FL,32816,4260.12,0
2031-05-11,12:43:00,Target,-59.43,Winter Park FL,32789,4200.69,0
2031-05-11,21:49:00,McDonald's,-39.66,Winter Park FL,32789,4161.03,0
2031-05-11,08:26:00,McDonald's,-17.66,Oviedo FL,32765,4143.37,0
2031-05-11,15:37:00,Magic the Gathering,-2965.11,Tokyo JP,51513,1178.26,1
2031-05-12,08:00:00,Paycheck,2000.0,Oviedo FL,32765,6143.37,0
2031-05-12,12:32:00,Concert Tickets,-34.62,Winter Park FL,32789,6108.75,0
2031-05-13,10:34:00,Exxon,-47.37,Orlando FL,32816,6061.38,0
2031-05-13,10:03:00,Jiffy Lube,-349.24,Oviedo FL,32765,5712.14,0
2031-05-14,05:24:00,Onlyfans,-2546.86,Pyongyang NK,29667,3165.28,1
2031-05-14,21:59:00,Pep Boys,-71.48,Winter Park FL,32789,5640.66,0
2031-05-14,16:17:00,Burger King,-34.93,Oviedo FL,32765,5605.73,0
2031-05-16,20:14:00,Subway,-36.55,Winter Park FL,32789,5569.18,0
2031-05-16,09:01:00,Pawn Stars,-1333.06,Anchorage AL,44572,4236.12,1
2031-05-16,19:03:00,Netflix,-57.42,Orlando FL,32816,5511.76,0
2031-05-17,13:05:00,Impractical Jokers,-2557.63,Pyongyang NK,26860,2954.13,1
2031-05-17,11:30:00,Trader Joe's,-57.07,Orlando FL,32816,5454.69,0
2031-05-17,03:51:00,IBM,-808.3,Charleston SC,45622,4646.39,1
2031-05-18,19:23:00,Target,-62.54,Winter Park FL,32789,5392.15,0
2031-05-18,17:23:00,Starbucks,-32.4,Winter Park FL,32789,5359.75,0
2031-05-19,18:32:00,Dollar Tree,-28.24,Winter Park FL,32789,5331.51,0
2031-05-19,21:53:00,Amazon,-24.76,Winter Park FL,32789,5306.75,0
2031-05-19,11:54:00,Walgreens,-8.09,Oviedo FL,32765,5298.66,0
2031-05-20,16:33:00,Midas,-81.58,Oviedo FL,32765,5217.08,0
2031-05-20,20:52:00,Subway,-38.81,Winter Park FL,32789,5178.27,0
2031-05-20,15:19:00,Fraud,-1513.03,Charleston SC,73972,3665.24,1
2031-05-20,20:26:00,Concert Tickets,-50.6,Oviedo FL,32765,5127.67,0
2031-05-21,08:09:00,Concert Tickets,-33.84,Oviedo FL,32765,5093.83,0
2031-05-22,12:03:00,Chevron,-13.54,Winter Park FL,32789,5080.29,0
2031-05-24,14:02:00,Walmart,-11.69,Oviedo FL,32765,5068.6,0
2031-05-24,16:18:00,Burger King,-37.11,Winter Park FL,32789,5031.49,0
2031-05-24,12:02:00,Magic the Gathering,-1281.82,London EN,74149,3749.67,1
2031-05-24,19:36:00,Best Buy,-10.52,Orlando FL,32816,5020.97,0
2031-05-25,17:06:00,Amazon,-62.37,Winter Park FL,32789,4958.6,0
2031-05-25,09:36:00,Chevron,-11.99,Orlando FL,32816,4946.61,0
2031-05-25,14:14:00,Dollar Tree,-45.53,Orlando FL,32816,4901.08,0
2031-05-26,08:00:00,Paycheck,2000.0,Oviedo FL,32765,6901.08,0
2031-05-26,11:45:00,Starbucks,-46.45,Orlando FL,32816,6854.63,0
2031-05-26,17:35:00,Burger King,-36.75,Oviedo FL,32765,6817.88,0
2031-05-28,19:00:00,Dollar Tree,-85.97,Oviedo FL,32765,6731.91,0
2031-05-28,21:44:00,Amazon,-236.36,Winter Park FL,32789,6495.55,0
2031-05-28,15:54:00,Burger King,-42.73,Orlando FL,32816,6452.82,0
2031-05-28,04:53:00,Accelerators,-1124.31,Los Angeles CA,75366,5328.51,1
2031-05-29,18:29:00,Trader Joe's,-110.01,Orlando FL,32816,6342.81,0
2031-05-30,08:32:00,Netflix,-42.3,Orlando FL,32816,6300.51,0
2031-05-30,21:16:00,Starbucks,-40.21,Winter Park FL,32789,6260.3,0
2031-05-31,15:45:00,Netflix,-89.61,Oviedo FL,32765,6170.69,0
2031-06-01,09:00:00,Rent,-960.0,Oviedo FL,32765,5210.69,0
2031-06-01,09:00:00,Insurance,-197.46,Oviedo FL,32765,5013.23,0
2031-06-01,09:00:00,Car,-300.0,Oviedo FL,32765,4713.23,0
2031-06-04,20:11:00,Amusement Park,-44.01,Winter Park FL,32789,4669.22,0
2031-06-04,13:41:00,Pep Boys,-141.46,Orlando FL,32816,4527.76,0
2031-06-04,12:10:00,Jiffy Lube,-124.29,Oviedo FL,32765,4403.47,0
2031-06-05,08:54:00,Dollar Tree,-45.44,Orlando FL,32816,4358.03,0
2031-06-06,14:44:00,Movie Theater,-34.3,Oviedo FL,32765,4323.73,0
2031-06-07,09:00:00,Spotify,-11.99,Oviedo FL,32765,4311.74,0
2031-06-07,09:00:00,Internet,-70.89,Oviedo FL,32765,4240.85,0
2031-06-07,09:00:00,ChatGPT Plus,-20.0,Oviedo FL,32765,4220.85,0
2031-06-07,16:36:00,Walmart,-68.92,Orlando FL,32816,4151.93,0
2031-06-07,10:16:00,Walgreens,-37.32,Oviedo FL,32765,4114.61,0
2031-06-09,08:00:00,Paycheck,2000.0,Oviedo FL,32765,6114.61,0
2031-06-09,20:42:00,Dollar Tree,-28.76,Oviedo FL,32765,6085.85,0
2031-06-10,18:41:00,Servicenow,-865.41,Honolulu HI,11204,5220.44,1
2031-06-10,16:47:00,Best Buy,-89.61,Oviedo FL,32765,5996.24,0
2031-06-10,19:37:00,Impractical Jokers,-2036.77,Los Angeles CA,50442,3959.47,1
2031-06-12,17:01:00,Pawn Stars,-2092.72,Pyongyang NK,81981,3903.52,1
2031-06-12,19:49:00,Kroger,-64.76,Oviedo FL,32765,5931.48,0
2031-06-12,10:51:00,Best Buy,-131.78,Orlando FL,32816,5799.7,0
2031-06-12,09:07:00,Five Below,-15.71,Orlando FL,32816,5783.99,0
2031-06-13,11:01:00,Walgreens,-16.72,Oviedo FL,32765,5767.27,0
2031-06-14,13:50:00,Burger King,-15.4,Orlando FL,32816,5751.87,0
2031-06-14,15:57:00,Target,-112.37,Orlando FL,32816,5639.5,0
2031-06-14,18:52:00,McDonald's,-6.25,Winter Park FL,32789,5633.25,0
2031-06-15,19:44:00,Concert Tickets,-44.66,Oviedo FL,32765,5588.59,0
2031-06-15,19:46:00,Whole Foods,-79.76,Winter Park FL,32789,5508.83,0
2031-06-15,18:26:00,Subway,-13.55,Orlando FL,32816,5495.28,0
2031-06-17,18:22:00,Movie Theater,-35.61,Orlando FL,32816,5459.67,0
2031-06-17,10:49:00,Best Buy,-55.99,Winter Park FL,32789,5403.68,0
2031-06-18,10:52:00,Subway,-37.83,Winter Park FL,32789,5365.85,0
2031-06-18,12:04:00,CVS,-39.71,Oviedo FL,32765,5326.14,0
2031-06-19,19:12:00,Fat Joe,-2452.32,Los Angeles CA,36176,2873.82,1
2031-06-19,20:18:00,Target,-92.63,Oviedo FL,32765,5233.51,0
2031-06-21,08:02:00,Amusement Park,-27.28,Winter Park FL,32789,5206.23,0
2031-06-23,08:00:00,Paycheck,2000.0,Oviedo FL,32765,7206.23,0
2031-06-23,18:49:00,Burger King,-53.06,Winter Park FL,32789,7153.17,0
2031-06-23,17:49:00,Publix,-84.31,Orlando FL,32816,7068.86,0
2031-06-23,17:58:00,Burger King,-41.9,Winter Park FL,32789,7026.96,0
2031-06-24,08:14:00,Dollar Tree,-80.24,Orlando FL,32816,6946.72,0
2031-06-24,17:14:00,McDonald's,-37.63,Oviedo FL,32765,6909.09,0
2031-06-24,09:45:00,McDonald's,-19.42,Winter Park FL,32789,6889.67,0
2031-06-24,13:16:00,Servicenow,-1912.32,Pyongyang NK,11421,4977.35,1
2031-06-26,18:05:00,Best Buy,-246.28,Oviedo FL,32765,6643.39,0
2031-06-27,17:00:00,Monster Energy,-1870.69,Pittsburgh PA,70335,4772.7,1
2031-06-27,13:45:00,Walgreens,-33.66,Oviedo FL,32765,6609.73,0
2031-06-27,15:20:00,Shell,-21.91,Orlando FL,32816,6587.82,0
2031-06-29,18:10:00,Five Below,-77.06,Winter Park FL,32789,6510.76,0
2031-07-01,09:00:00,Rent,-960.0,Oviedo FL,32765,5550.76,0
2031-07-01,09:00:00,Insurance,-197.46,Oviedo FL,32765,5353.3,0
2031-07-01,09:00:00,Car,-300.0,Oviedo FL,32765,5053.3,0
2031-07-01,14:23:00,Burger King,-34.56,Orlando FL,32816,5018.74,0
2031-07-02,14:51:00,McDonald's,-31.43,Orlando FL,32816,4987.31,0
2031-07-02,15:18:00,McDonald's,-10.94,Oviedo FL,32765,4976.37,0
2031-07-02,16:08:00,Starbucks,-10.2,Winter Park FL,32789,4966.17,0
2031-07-03,08:41:00,Burger King,-34.94,Oviedo FL,32765,4931.23,0
2031-07-03,00:55:00,Paypal,-2675.63,New York NY,39459,2255.6,1
2031-07-03,12:37:00,Target,-134.64,Winter Park FL,32789,4796.59,0
2031-07-04,10:51:00,Burger King,-35.64,Winter Park FL,32789,4760.95,0
2031-07-04,21:11:00,McDonald's,-39.88,Orlando FL,32816,4721.07,0
2031-07-04,11:28:00,Burger King,-32.51,Oviedo FL,32765,4688.56,0
2031-07-05,09:14:00,Target,-69.99,Winter Park FL,32789,4618.57,0
2031-07-06,19:57:00,Whole Foods,-43.22,Oviedo FL,32765,4575.35,0
2031-07-06,08:17:00,Fraud,-1746.51,Honolulu HI,68325,2828.84,1
2031-07-06,08:23:00,Pep Boys,-176.76,Orlando FL,32816,4398.59,0
2031-07-07,08:00:00,Paycheck,2000.0,Oviedo FL,32765,6398.59,0
2031-07-07,09:00:00,Spotify,-11.99,Oviedo FL,32765,6386.6,0
2031-07-07,09:00:00,Internet,-70.89,Oviedo FL,32765,6315.71,0
2031-07-07,09:00:00,ChatGPT Plus,-20.0,Oviedo FL,32765,6295.71,0
2031-07-07,16:33:00,McDonald's,-67.36,Oviedo FL,32765,6228.35,0
2031-07-07,18:07:00,Midas,-351.86,Oviedo FL,32765,5876.49,0
2031-07-07,19:52:00,Fat Joe,-1135.12,Los Angeles CA,41849,4741.37,1
2031-07-07,12:34:00,Concert Tickets,-11.92,Oviedo FL,32765,5864.57,0
2031-07-07,01:40:00,Impractical Jokers,-407.19,London EN,39010,5457.38,1
2031-07-08,14:43:00,Fat Joe,-2478.08,Tokyo JP,94147,3386.49,1
2031-07-08,13:39:00,Concert Tickets,-25.94,Winter Park FL,32789,5838.63,0
2031-07-09,14:41:00,Subway,-20.63,Oviedo FL,32765,5818.0,0
2031-07-09,15:36:00,AutoZone,-169.36,Orlando FL,32816,5648.64,0
2031-07-09,00:21:00,Servicenow,-2665.79,London EN,79492,2982.85,1
2031-07-09,21:31:00,Subway,-25.36,Oviedo FL,32765,5623.28,0
2031-07-10,14:26:00,Pawn Stars,-2039.45,Pyongyang NK,44536,3583.83,1
2031-07-10,12:22:00,McDonald's,-21.25,Winter Park FL,32789,5602.03,0
2031-07-10,08:39:00,Starbucks,-39.9,Winter Park FL,32789,5562.13,0
2031-07-11,19:15:00,Magic the Gathering,-1923.16,Los Angeles CA,98488,3638.97,1
2031-07-11,09:50:00,Shell,-17.95,Oviedo FL,32765,5544.18,0
2031-07-11,22:09:00,Magic the Gathering,-1357.43,Anchorage AL,43977,4186.75,1
2031-07-11,13:10:00,Chevron,-17.73,Oviedo FL,32765,5526.45,0
2031-07-14,08:06:00,Target,-132.5,Winter Park FL,32789,5393.95,0
2031-07-14,16:59:00,Movie Theater,-32.03,Winter Park FL,32789,5361.92,0
2031-07-14,16:57:00,Chevron,-24.74,Oviedo FL,32765,5337.18,0
2031-07-14,09:52:00,Fat Joe,-1269.85,New York NY,25875,4067.33,1
2031-07-15,17:04:00,Amazon,-59.42,Oviedo FL,32765,5277.76,0
2031-07-15,20:39:00,Amazon,-44.23,Orlando FL,32816,5233.53,0
2031-07-17,11:16:00,Exxon,-17.02,Winter Park FL,32789,5216.51,0
2031-07-17,10:24:00,Jiffy Lube,-93.54,Orlando FL,32816,5122.97,0
2031-07-17,15:45:00,Five Below,-42.78,Oviedo FL,32765,5080.19,0
2031-07-18,06:53:00,Pawn Stars,-999.19,Los Angeles CA,86147,4081.0,1
2031-07-18,17:01:00,Target,-28.68,Oviedo FL,32765,5051.51,0
2031-07-18,15:40:00,IBM,-1647.7,London EN,12562,3403.81,1
2031-07-18,14:26:00,Concert Tickets,-54.59,Orlando FL,32816,4996.92,0
2031-07-18,19:09:00,Concert Tickets,-48.05,Orlando FL,32816,4948.87,0
2031-07-19,13:08:00,CVS,-13.75,Oviedo FL,32765,4935.12,0
2031-07-20,11:36:00,CVS,-32.06,Winter Park FL,32789,4903.06,0
2031-07-20,18:58:00,Chevron,-22.74,Orlando FL,32816,4880.32,0
2031-07-20,20:11:00,Paypal,-369.77,New York NY,11868,4510.55,1
2031-07-20,15:18:00,Shell,-15.76,Oviedo FL,32765,4864.56,0
2031-07-20,22:33:00,Onlyfans,-1201.45,London EN,60368,3663.11,1
2031-07-21,08:00:00,Paycheck,2000.0,Oviedo FL,32765,6864.56,0
2031-07-21,18:10:00,Target,-130.11,Oviedo FL,32765,6734.45,0
2031-07-21,14:08:00,Netflix,-99.13,Winter Park FL,32789,6635.32,0
2031-07-21,18:31:00,Subway,-17.8,Oviedo FL,32765,6617.52,0
2031-07-24,20:02:00,Onlyfans,-358.52,London EN,64570,6259.0,1
2031-07-25,21:05:00,Pawn Stars,-2340.66,Mexico City MC,77676,4276.86,1
2031-07-25,17:33:00,Amazon,-96.55,Winter Park FL,32789,6520.97,0
2031-07-26,20:05:00,McDonald's,-12.92,Oviedo FL,32765,6508.05,0
2031-07-26,17:24:00,Subway,-22.41,Winter Park FL,32789,6485.64,0
2031-07-26,20:19:00,Five Below,-51.84,Orlando FL,32816,6433.8,0
2031-07-27,15:09:00,Shell,-54.14,Winter Park FL,32789,6379.66,0
2031-07-27,16:37:00,Best Buy,-276.53,Oviedo FL,32765,6103.13,0
2031-07-27,21:36:00,Walmart,-266.6,Oviedo FL,32765,5836.53,0
2031-07-29,15:31:00,Walmart,-134.67,Orlando FL,32816,5701.86,0
2031-07-29,16:36:00,Starbucks,-21.53,Oviedo FL,32765,5680.33,0
2031-07-30,13:17:00,IBM,-846.3,London EN,65562,4834.03,1
2031-07-30,20:18:00,McDonald's,-10.82,Orlando FL,32816,5669.51,0
2031-07-31,08:58:00,Target,-94.81,Orlando FL,32816,5574.7,0
2031-07-31,17:09:00,Amusement Park,-47.34,Winter Park FL,32789,5527.36,0
2031-07-31,11:27:00,Target,-136.64,Oviedo FL,32765,5390.72,0
2031-08-01,09:00:00,Rent,-960.0,Oviedo FL,32765,4430.72,0
2031-08-01,09:00:00,Insurance,-197.46,Oviedo FL,32765,4233.26,0
2031-08-01,09:00:00,Car,-300.0,Oviedo FL,32765,3933.26,0
2031-08-01,19:31:00,CVS,-23.61,Oviedo FL,32765,3909.65,0
2031-08-03,15:28:00,Magic the Gathering,-1395.81,Anchorage AL,68933,2513.84,1
2031-08-03,18:11:00,Netflix,-50.21,Orlando FL,32816,3859.44,0
2031-08-04,08:00:00,Paycheck,2000.0,Oviedo FL,32765,5859.44,0
2031-08-04,21:11:00,Target,-109.39,Oviedo FL,32765,5750.05,0
2031-08-04,21:05:00,CVS,-25.76,Orlando FL,32816,5724.29,0
2031-08-05,14:03:00,Walmart,-32.11,Oviedo FL,32765,5692.18,0
2031-08-05,16:10:00,Dollar Tree,-13.62,Orlando FL,32816,5678.56,0
2031-08-07,09:00:00,Spotify,-11.99,Oviedo FL,32765,5666.57,0
2031-08-07,09:00:00,Internet,-70.89,Oviedo FL,32765,5595.68,0
2031-08-07,09:00:00,ChatGPT Plus,-20.0,Oviedo FL,32765,5575.68,0
2031-08-07,14:48:00,Trader Joe's,-55.49,Orlando FL,32816,5520.19,0
2031-08-07,16:29:00,Publix,-86.27,Winter Park FL,32789,5433.92,0
2031-08-07,15:24:00,BP,-13.74,Orlando FL,32816,5420.18,0
2031-08-08,09:31:00,Burger King,-20.0,Orlando FL,32816,5400.18,0
2031-08-09,21:37:00,Trader Joe's,-71.05,Oviedo FL,32765,5329.13,0
2031-08-09,08:54:00,Burger King,-32.4,Winter Park FL,32789,5296.73,0
2031-08-10,14:34:00,Chevron,-16.42,Winter Park FL,32789,5280.31,0
2031-08-10,20:28:00,Exxon,-20.96,Winter Park FL,32789,5259.35,0
2031-08-10,15:50:00,Fraud,-2196.58,New York NY,86121,3062.77,1
2031-08-10,17:36:00,BP,-21.39,Orlando FL,32816,5237.96,0
2031-08-11,15:19:00,Shell,-16.73,Orlando FL,32816,5221.23,0
2031-08-11,11:15:00,Midas,-57.8,Winter Park FL,32789,5163.43,0
2031-08-11,14:56:00,Starbucks,-19.63,Orlando FL,32816,5143.8,0
2031-08-12,15:35:00,Movie Theater,-14.18,Winter Park FL,32789,5129.62,0
2031-08-12,15:24:00,Target,-108.43,Orlando FL,32816,5021.19,0
2031-08-13,12:59:00,Starbucks,-37.42,Winter Park FL,32789,4983.77,0
2031-08-13,16:38:00,Pep Boys,-93.06,Oviedo FL,32765,4890.71,0
2031-08-13,19:00:00,Walmart,-87.43,Winter Park FL,32789,4803.28,0
2031-08-15,15:49:00,Paypal,-796.85,Charleston SC,68383,4006.43,1
2031-08-15,20:36:00,Netflix,-59.92,Winter Park FL,32789,4743.36,0
2031-08-15,13:58:00,Best Buy,-81.35,Orlando FL,32816,4662.01,0
2031-08-15,14:57:00,Trader Joe's,-60.97,Winter Park FL,32789,4601.04,0
2031-08-16,17:09:00,Dollar Tree,-43.39,Orlando FL,32816,4557.65,0
2031-08-16,09:44:00,Starbucks,-12.11,Winter Park FL,32789,4545.54,0
2031-08-16,13:58:00,Subway,-8.58,Winter Park FL,32789,4536.96,0
2031-08-18,08:00:00,Paycheck,2000.0,Oviedo FL,32765,6536.96,0
2031-08-18,16:25:00,Concert Tickets,-93.27,Orlando FL,32816,6443.69,0
2031-08-20,10:23:00,Starbucks,-61.51,Winter Park FL,32789,6382.18,0
2031-08-20,20:34:00,Movie Theater,-47.25,Oviedo FL,32765,6334.93,0
2031-08-21,20:37:00,Chevron,-52.64,Orlando FL,32816,6282.29,0
2031-08-21,11:36:00,Starbucks,-21.52,Winter Park FL,32789,6260.77,0
2031-08-21,13:38:00,Walgreens,-57.09,Orlando FL,32816,6203.68,0
2031-08-22,09:33:00,Burger King,-76.58,Orlando FL,32816,6127.1,0
2031-08-22,17:13:00,Starbucks,-23.78,Oviedo FL,32765,6103.32,0
2031-08-24,15:01:00,Chevron,-49.63,Winter Park FL,32789,6053.69,0
2031-08-24,05:59:00,Onlyfans,-1078.1,Groton CT,34165,4975.59,1
2031-08-24,18:08:00,Dollar Tree,-50.22,Orlando FL,32816,6003.47,0
2031-08-25,21:46:00,Walmart,-149.21,Orlando FL,32816,5854.26,0
2031-08-25,12:43:00,Pep Boys,-130.49,Winter Park FL,32789,5723.77,0
2031-08-25,12:20:00,Subway,-22.95,Oviedo FL,32765,5700.82,0
2031-08-26,10:18:00,Amusement Park,-41.68,Winter Park FL,32789,5659.14,0
2031-08-26,19:30:00,Five Below,-36.01,Winter Park FL,32789,5623.13,0
2031-08-28,19:59:00,Accelerators,-581.62,Charleston SC,48779,5041.51,1
2031-08-29,13:42:00,Walmart,-30.76,Winter Park FL,32789,5592.37,0
2031-08-29,18:52:00,Amazon,-88.82,Orlando FL,32816,5503.55,0
2031-08-30,08:36:00,AutoZone,-59.0,Orlando FL,32816,5444.55,0
2031-08-30,21:36:00,Burger King,-30.87,Winter Park FL,32789,5413.68,0
2031-08-31,11:39:00,Burger King,-6.12,Orlando FL,32816,5407.56,0
2031-08-31,13:03:00,IBM,-2044.19,Pittsburgh PA,38881,3363.37,1
2031-08-31,11:51:00,Amusement Park,-58.56,Winter Park FL,32789,5349.0,0
2031-09-01,08:00:00,Paycheck,2000.0,Oviedo FL,32765,7349.0,0
2031-09-01,09:00:00,Rent,-960.0,Oviedo FL,32765,6389.0,0
2031-09-01,09:00:00,Insurance,-197.46,Oviedo FL,32765,6191.54,0
2031-09-01,09:00:00,Car,-300.0,Oviedo FL,32765,5891.54,0
2031-09-01,13:34:00,Subway,-32.97,Oviedo FL,32765,5858.57,0
2031-09-01,11:21:00,McDonald's,-7.02,Orlando FL,32816,5851.55,0
2031-09-01,19:15:00,Onlyfans,-142.82,Anchorage AL,54704,5708.73,1
2031-09-02,08:18:00,Exxon,-12.58,Orlando FL,32816,5838.97,0
2031-09-03,14:27:00,Midas,-172.16,Winter Park FL,32789,5666.81,0
2031-09-03,09:33:00,Best Buy,-113.79,Orlando FL,32816,5553.02,0
2031-09-03,14:13:00,CVS,-49.63,Oviedo FL,32765,5503.39,0
2031-09-03,00:41:00,Lockheed Martin,-2996.38,Mexico City MC,23964,2507.01,1
2031-09-05,15:12:00,McDonald's,-17.28,Orlando FL,32816,5486.11,0
2031-09-06,16:57:00,Walmart,-141.41,Orlando FL,32816,5344.7,0
2031-09-06,21:48:00,Lockheed Martin,-752.69,Anchorage AL,37972,4592.01,1
2031-09-07,09:00:00,Spotify,-11.99,Oviedo FL,32765,5332.71,0
2031-09-07,09:00:00,Internet,-70.89,Oviedo FL,32765,5261.82,0
2031-09-07,09:00:00,ChatGPT Plus,-20.0,Oviedo FL,32765,5241.82,0
2031-09-08,08:20:00,Kroger,-93.93,Oviedo FL,32765,5147.89,0
2031-09-08,19:52:00,Netflix,-29.02,Oviedo FL,32765,5118.87,0
2031-09-08,15:50:00,Dollar Tree,-17.45,Winter Park FL,32789,5101.42,0
2031-09-10,17:40:00,Amusement Park,-28.15,Oviedo FL,32765,5073.27,0
2031-09-10,21:06:00,Target,-102.09,Oviedo FL,32765,4971.18,0
2031-09-12,14:32:00,Concert Tickets,-57.75,Orlando FL,32816,4913.43,0
2031-09-12,16:13:00,Chevron,-26.41,Oviedo FL,32765,4887.02,0
2031-09-12,16:42:00,McDonald's,-5.04,Oviedo FL,32765,4881.98,0
2031-09-13,12:30:00,Shell,-20.45,Orlando FL,32816,4861.53,0
2031-09-13,17:35:00,Movie Theater,-20.97,Orlando FL,32816,4840.56,0
2031-09-14,21:19:00,Burger King,-13.58,Oviedo FL,32765,4826.98,0
2031-09-14,07:27:00,Fraud,-1110.61,Tokyo JP,41380,3716.37,1
2031-09-15,08:00:00,Paycheck,2000.0,Oviedo FL,32765,6826.98,0
2031-09-15,02:33:00,IBM,-1579.08,Anchorage AL,14808,5247.9,1
2031-09-15,20:46:00,Walgreens,-55.63,Orlando FL,32816,6771.35,0
2031-09-15,15:45:00,Burger King,-57.36,Orlando FL,32816,6713.99,0
2031-09-15,05:52:00,IBM,-1873.54,Groton CT,74189,4840.45,1
2031-09-16,19:44:00,Starbucks,-23.33,Orlando FL,32816,6690.66,0
2031-09-16,14:10:00,Five Below,-90.35,Winter Park FL,32789,6600.31,0
2031-09-16,20:27:00,Publix,-91.36,Oviedo FL,32765,6508.95,0
2031-09-17,10:04:00,McDonald's,-75.66,Winter Park FL,32789,6433.29,0
2031-09-17,20:48:00,McDonald's,-56.12,Oviedo FL,32765,6377.17,0
2031-09-17,10:59:00,CVS,-72.39,Winter Park FL,32789,6304.78,0
2031-09-18,15:48:00,Target,-89.76,Oviedo FL,32765,6215.02,0
2031-09-18,07:23:00,Onlyfans,-535.76,Mexico City MC,25968,5679.26,1
2031-09-18,15:02:00,Chevron,-34.98,Orlando FL,32816,6180.04,0
2031-09-19,17:49:00,Netflix,-30.51,Oviedo FL,32765,6149.53,0
2031-09-19,17:29:00,Chevron,-47.0,Winter Park FL,32789,6102.53,0
2031-09-19,12:19:00,Trader Joe's,-187.26,Orlando FL,32816,5915.27,0
2031-09-20,17:11:00,Burger King,-15.02,Winter Park FL,32789,5900.25,0
2031-09-20,09:16:00,Whole Foods,-74.74,Winter Park FL,32789,5825.51,0
2031-09-21,10:57:00,Chevron,-16.71,Winter Park FL,32789,5808.8,0
2031-09-21,19:12:00,Subway,-14.66,Orlando FL,32816,5794.14,0
2031-09-22,18:24:00,Starbucks,-29.81,Orlando FL,32816,5764.33,0
2031-09-22,09:54:00,Starbucks,-10.0,Orlando FL,32816,5754.33,0
2031-09-23,11:14:00,Movie Theater,-16.43,Oviedo FL,32765,5737.9,0
2031-09-23,14:52:00,Burger King,-38.43,Oviedo FL,32765,5699.47,0
2031-09-23,20:00:00,Amusement Park,-12.44,Oviedo FL,32765,5687.03,0
2031-09-23,12:51:00,IBM,-947.26,New York NY,93575,4739.77,1
2031-09-24,19:54:00,Subway,-23.52,Oviedo FL,32765,5663.51,0
2031-09-25,12:24:00,Amazon,-125.94,Orlando FL,32816,5537.57,0
2031-09-25,10:36:00,Subway,-20.15,Winter Park FL,32789,5517.42,0
2031-09-25,11:36:00,Movie Theater,-17.8,Orlando FL,32816,5499.62,0
2031-09-26,17:27:00,Burger King,-29.66,Winter Park FL,32789,5469.96,0
2031-09-26,02:17:00,Pawn Stars,-1627.54,London EN,60446,3842.42,1
2031-09-28,19:58:00,Whole Foods,-86.85,Oviedo FL,32765,5383.11,0
2031-09-28,11:39:00,Burger King,-23.16,Winter Park FL,32789,5359.95,0
2031-09-28,11:53:00,Amusement Park,-17.01,Oviedo FL,32765,5342.94,0
2031-09-29,08:00:00,Paycheck,2000.0,Oviedo FL,32765,7342.94,0
2031-09-29,13:19:00,Target,-85.85,Oviedo FL,32765,7257.09,0
2031-09-30,10:58:00,Pep Boys,-184.54,Oviedo FL,32765,7072.55,0
2031-10-01,09:00:00,Rent,-960.0,Oviedo FL,32765,6112.55,0
2031-10-01,09:00:00,Insurance,-197.46,Oviedo FL,32765,5915.09,0
2031-10-01,09:00:00,Car,-300.0,Oviedo FL,32765,5615.09,0
2031-10-01,08:40:00,Burger King,-25.73,Oviedo FL,32765,5589.36,0
2031-10-01,20:36:00,IBM,-1913.49,Mexico City MC,50821,3675.87,1
2031-10-02,21:37:00,Subway,-14.64,Orlando FL,32816,5574.72,0
2031-10-02,21:20:00,Five Below,-32.13,Orlando FL,32816,5542.59,0
2031-10-02,12:18:00,Fat Joe,-2214.42,Tokyo JP,16707,3328.17,1
2031-10-02,17:33:00,Walgreens,-7.09,Winter Park FL,32789,5535.5,0
2031-10-03,17:47:00,Trader Joe's,-47.47,Winter Park FL,32789,5488.03,0
2031-10-03,16:19:00,Midas,-144.35,Winter Park FL,32789,5343.68,0
2031-10-04,18:37:00,Target,-111.11,Oviedo FL,32765,5232.57,0
2031-10-05,13:01:00,McDonald's,-39.5,Orlando FL,32816,5193.07,0
2031-10-05,15:26:00,Accelerators,-2982.76,Anchorage AL,39531,2210.31,1
2031-10-05,09:34:00,Concert Tickets,-49.31,Oviedo FL,32765,5143.76,0
2031-10-05,20:55:00,Fat Joe,-696.73,Charleston SC,68146,4447.03,1
2031-10-05,16:43:00,Burger King,-17.36,Winter Park FL,32789,5126.4,0
2031-10-06,20:02:00,Magic the Gathering,-2973.74,Los Angeles CA,59344,2152.66,1
2031-10-06,13:46:00,Chevron,-24.03,Winter Park FL,32789,5102.37,0
2031-10-06,11:56:00,BP,-14.58,Oviedo FL,32765,5087.79,0
2031-10-06,11:03:00,Amazon,-142.47,Winter Park FL,32789,4945.32,0
2031-10-07,09:00:00,Spotify,-11.99,Oviedo FL,32765,4933.33,0
2031-10-07,09:00:00,Internet,-70.89,Oviedo FL,32765,4862.44,0
2031-10-07,09:00:00,ChatGPT Plus,-20.0,Oviedo FL,32765,4842.44,0
2031-10-07,17:19:00,Whole Foods,-61.35,Orlando FL,32816,4781.09,0
2031-10-07,19:59:00,Netflix,-40.62,Winter Park FL,32789,4740.47,0
2031-10-07,20:34:00,Amazon,-89.79,Winter Park FL,32789,4650.68,0
2031-10-08,13:34:00,Kroger,-91.14,Orlando FL,32816,4559.54,0
2031-10-09,18:52:00,Starbucks,-32.44,Oviedo FL,32765,4527.1,0
2031-10-09,20:17:00,Kroger,-33.21,Oviedo FL,32765,4493.89,0
2031-10-10,20:49:00,Trader Joe's,-65.62,Oviedo FL,32765,4428.27,0
2031-10-10,18:04:00,Whole Foods,-33.45,Orlando FL,32816,4394.82,0
2031-10-11,20:41:00,Starbucks,-19.61,Orlando FL,32816,4375.21,0
2031-10-11,11:19:00,Best Buy,-25.4,Winter Park FL,32789,4349.81,0
2031-10-11,16:24:00,Starbucks,-35.08,Oviedo FL,32765,4314.73,0
2031-10-12,16:00:00,Amusement Park,-12.06,Winter Park FL,32789,4302.67,0
2031-10-12,07:39:00,Fraud,-1595.15,Los Angeles CA,76032,2707.52,1
2031-10-13,08:00:00,Paycheck,2000.0,Oviedo FL,32765,6302.67,0
2031-10-13,18:34:00,Dollar Tree,-95.45,Oviedo FL,32765,6207.22,0
2031-10-14,09:57:00,Five Below,-77.96,Orlando FL,32816,6129.26,0
2031-10-14,19:37:00,Subway,-76.6,Orlando FL,32816,6052.66,0
2031-10-15,05:25:00,Fat Joe,-1753.25,Mexico City MC,95176,4299.41,1
2031-10-16,09:42:00,McDonald's,-67.79,Oviedo FL,32765,5984.87,0
2031-10-17,13:06:00,Netflix,-46.18,Oviedo FL,32765,5938.69,0
2031-10-17,16:11:00,Magic the Gathering,-2022.83,New York NY,89915,3915.86,1
2031-10-17,12:40:00,Amazon,-52.46,Winter Park FL,32789,5886.23,0
2031-10-17,12:58:00,McDonald's,-22.47,Orlando FL,32816,5863.76,0
2031-10-19,13:39:00,Amazon,-92.78,Oviedo FL,32765,5770.98,0
2031-10-19,18:23:00,Amusement Park,-20.38,Winter Park FL,32789,5750.6,0
2031-10-21,17:59:00,Exxon,-14.08,Oviedo FL,32765,5736.52,0
2031-10-21,18:08:00,Amusement Park,-27.46,Orlando FL,32816,5709.06,0
2031-10-21,11:58:00,Shell,-27.21,Oviedo FL,32765,5681.85,0
2031-10-22,08:59:00,Best Buy,-37.73,Winter Park FL,32789,5644.12,0
2031-10-22,14:14:00,Subway,-6.4,Orlando FL,32816,5637.72,0
2031-10-23,04:22:00,Pawn Stars,-1439.81,Honolulu HI,71762,4197.91,1
2031-10-23,10:54:00,Subway,-9.56,Oviedo FL,32765,5628.16,0
2031-10-24,13:16:00,Amusement Park,-22.28,Oviedo FL,32765,5605.88,0
2031-10-24,12:51:00,Midas,-64.45,Winter Park FL,32789,5541.43,0
2031-10-26,02:52:00,Accelerators,-1889.38,Anchorage AL,90104,3652.05,1
2031-10-26,14:24:00,Dollar Tree,-14.84,Orlando FL,32816,5526.59,0
2031-10-26,13:59:00,Midas,-145.12,Winter Park FL,32789,5381.47,0
2031-10-27,08:00:00,Paycheck,2000.0,Oviedo FL,32765,7381.47,0
2031-10-27,12:26:00,Best Buy,-283.36,Oviedo FL,32765,7098.11,0
2031-10-29,20:12:00,Concert Tickets,-21.03,Orlando FL,32816,7077.08,0
2031-10-29,21:21:00,Dollar Tree,-85.12,Oviedo FL,32765,6991.96,0
2031-10-30,10:12:00,Fraud,-2538.6,Los Angeles CA,57176,4453.36,1
2031-10-30,19:00:00,Walgreens,-50.54,Oviedo FL,32765,6941.42,0
2031-10-31,08:23:00,Target,-140.22,Oviedo FL,32765,6801.2,0
2031-10-31,17:51:00,McDonald's,-58.49,Winter Park FL,32789,6742.71,0
2031-10-31,17:36:00,Subway,-18.53,Oviedo FL,32765,6724.18,0
2031-10-31,18:43:00,Fraud,-1355.79,Pyongyang NK,54796,5368.39,1
2031-11-01,09:00:00,Rent,-960.0,Oviedo FL,32765,5764.18,0
2031-11-01,09:00:00,Insurance,-197.46,Oviedo FL,32765,5566.72,0
2031-11-01,09:00:00,Car,-300.0,Oviedo FL,32765,5266.72,0
2031-11-01,09:56:00,Lockheed Martin,-970.8,Honolulu HI,50936,4295.92,1
2031-11-01,17:03:00,Concert Tickets,-35.11,Oviedo FL,32765,5231.61,0
2031-11-01,13:59:00,Walgreens,-14.91,Winter Park FL,32789,5216.7,0
2031-11-01,21:04:00,BP,-17.01,Winter Park FL,32789,5199.69,0
2031-11-02,17:50:00,Subway,-14.49,Orlando FL,32816,5185.2,0
2031-11-02,18:10:00,McDonald's,-12.09,Winter Park FL,32789,5173.11,0
2031-11-03,20:39:00,Subway,-9.63,Winter Park FL,32789,5163.48,0
2031-11-03,13:56:00,Pep Boys,-190.67,Winter Park FL,32789,4972.81,0
2031-11-04,19:15:00,Starbucks,-15.74,Oviedo FL,32765,4957.07,0
2031-11-05,21:51:00,Shell,-20.12,Oviedo FL,32765,4936.95,0
2031-11-05,11:35:00,Subway,-31.8,Winter Park FL,32789,4905.15,0
2031-11-05,11:47:00,Five Below,-9.76,Winter Park FL,32789,4895.39,0
2031-11-05,22:28:00,Paypal,-785.54,London EN,20047,4109.85,1
2031-11-07,09:00:00,Spotify,-11.99,Oviedo FL,32765,4883.4,0
2031-11-07,09:00:00,Internet,-70.89,Oviedo FL,32765,4812.51,0
2031-11-07,09:00:00,ChatGPT Plus,-20.0,Oviedo FL,32765,4792.51,0
2031-11-07,14:29:00,Concert Tickets,-31.07,Orlando FL,32816,4761.44,0
2031-11-08,20:04:00,Amusement Park,-28.55,Orlando FL,32816,4732.89,0
2031-11-08,12:23:00,Subway,-8.87,Orlando FL,32816,4724.02,0
2031-11-08,07:02:00,Magic the Gathering,-736.07,New York NY,82448,3987.95,1
2031-11-08,08:22:00,Shell,-16.62,Orlando FL,32816,4707.4,0
2031-11-09,16:52:00,Publix,-40.33,Orlando FL,32816,4667.07,0
2031-11-09,20:56:00,Subway,-31.89,Orlando FL,32816,4635.18,0
2031-11-09,08:36:00,McDonald's,-6.2,Orlando FL,32816,4628.98,0
2031-11-10,08:00:00,Paycheck,2000.0,Oviedo FL,32765,6628.98,0
2031-11-10,18:47:00,Best Buy,-122.34,Orlando FL,32816,6506.64,0
2031-11-10,12:43:00,Trader Joe's,-196.52,Winter Park FL,32789,6310.12,0
2031-11-10,10:21:00,Target,-151.97,Winter Park FL,32789,6158.15,0
2031-11-12,13:31:00,Burger King,-43.87,Oviedo FL,32765,6114.28,0
2031-11-12,08:13:00,Movie Theater,-110.18,Oviedo FL,32765,6004.1,0
2031-11-12,15:44:00,McDonald's,-56.52,Oviedo FL,32765,5947.58,0
2031-11-13,18:24:00,Paypal,-2984.57,New York NY,71520,2963.01,1
2031-11-13,21:06:00,Five Below,-19.56,Winter Park FL,32789,5928.02,0
2031-11-13,15:42:00,Exxon,-24.04,Oviedo FL,32765,5903.98,0
2031-11-15,18:33:00,Dollar Tree,-21.6,Oviedo FL,32765,5882.38,0
2031-11-15,10:10:00,Burger King,-34.76,Orlando FL,32816,5847.62,0
2031-11-15,21:27:00,AutoZone,-40.55,Orlando FL,32816,5807.07,0
2031-11-17,14:14:00,AutoZone,-120.94,Orlando FL,32816,5686.13,0
2031-11-17,14:24:00,McDonald's,-15.19,Orlando FL,32816,5670.94,0
2031-11-17,21:24:00,Burger King,-6.56,Winter Park FL,32789,5664.38,0
2031-11-18,18:54:00,Exxon,-17.88,Winter Park FL,32789,5646.5,0
2031-11-19,15:14:00,McDonald's,-7.35,Winter Park FL,32789,5639.15,0
2031-11-21,11:00:00,Best Buy,-14.2,Oviedo FL,32765,5624.95,0
2031-11-21,11:36:00,CVS,-10.32,Winter Park FL,32789,5614.63,0
2031-11-21,13:34:00,Walmart,-142.49,Orlando FL,32816,5472.14,0
2031-11-22,19:03:00,Concert Tickets,-50.53,Oviedo FL,32765,5421.61,0
2031-11-24,08:00:00,Paycheck,2000.0,Oviedo FL,32765,7421.61,0
2031-11-24,12:07:00,CVS,-83.33,Winter Park FL,32789,7338.28,0
2031-11-24,08:01:00,Best Buy,-55.38,Winter Park FL,32789,7282.9,0
2031-11-24,14:28:00,Subway,-73.79,Oviedo FL,32765,7209.11,0
2031-11-25,15:01:00,McDonald's,-14.81,Oviedo FL,32765,7194.3,0
2031-11-26,17:58:00,Starbucks,-71.25,Winter Park FL,32789,7123.05,0
2031-11-26,22:32:00,Paypal,-124.1,Pyongyang NK,28089,6998.95,1
2031-11-28,18:14:00,Starbucks,-26.68,Orlando FL,32816,7096.37,0
2031-11-28,11:47:00,Burger King,-11.67,Oviedo FL,32765,7084.7,0
2031-11-29,16:50:00,Subway,-65.51,Winter Park FL,32789,7019.19,0
2031-11-30,17:11:00,Starbucks,-44.12,Winter Park FL,32789,6975.07,0
2031-11-30,12:25:00,McDonald's,-69.15,Winter Park FL,32789,6905.92,0
2031-12-01,09:00:00,Rent,-960.0,Oviedo FL,32765,5945.92,0
2031-12-01,09:00:00,Insurance,-197.46,Oviedo FL,32765,5748.46,0
2031-12-01,09:00:00,Car,-300.0,Oviedo FL,32765,5448.46,0
2031-12-01,16:39:00,Kroger,-91.68,Oviedo FL,32765,5356.78,0
2031-12-02,10:46:00,Chevron,-19.32,Orlando FL,32816,5337.46,0
2031-12-02,13:36:00,Walgreens,-45.73,Winter Park FL,32789,5291.73,0
2031-12-02,11:04:00,Amazon,-72.24,Winter Park FL,32789,5219.49,0
2031-12-03,15:41:00,Amazon,-18.79,Winter Park FL,32789,5200.7,0
2031-12-03,15:34:00,Trader Joe's,-37.07,Orlando FL,32816,5163.63,0
2031-12-04,14:37:00,AutoZone,-185.97,Orlando FL,32816,4977.66,0
2031-12-04,08:03:00,IBM,-1536.52,Mexico City MC,37158,3441.14,1
2031-12-04,20:04:00,Pep Boys,-191.12,Winter Park FL,32789,4786.54,0
2031-12-05,10:41:00,Starbucks,-21.42,Oviedo FL,32765,4765.12,0
2031-12-05,18:25:00,Concert Tickets,-59.67,Orlando FL,32816,4705.45,0
2031-12-05,15:27:00,Best Buy,-140.67,Oviedo FL,32765,4564.78,0
2031-12-06,09:25:00,Trader Joe's,-50.51,Orlando FL,32816,4514.27,0
2031-12-06,09:19:00,Accelerators,-2502.53,Tokyo JP,63452,2011.74,1
2031-12-07,09:00:00,Spotify,-11.99,Oviedo FL,32765,4502.28,0
2031-12-07,09:00:00,Internet,-70.89,Oviedo FL,32765,4431.39,0
2031-12-07,09:00:00,ChatGPT Plus,-20.0,Oviedo FL,32765,4411.39,0
2031-12-08,08:00:00,Paycheck,2000.0,Oviedo FL,32765,6411.39,0
2031-12-09,23:52:00,Servicenow,-2158.82,Pyongyang NK,58281,4252.57,1
2031-12-10,21:01:00,Best Buy,-167.7,Orlando FL,32816,6243.69,0
2031-12-11,16:11:00,Publix,-148.66,Oviedo FL,32765,6095.03,0
2031-12-11,20:43:00,Publix,-183.09,Orlando FL,32816,5911.94,0
2031-12-11,12:56:00,Five Below,-18.1,Orlando FL,32816,5893.84,0
2031-12-12,08:28:00,Best Buy,-35.88,Oviedo FL,32765,5857.96,0
2031-12-12,18:34:00,AutoZone,-61.46,Orlando FL,32816,5796.5,0
2031-12-13,19:29:00,Netflix,-25.67,Orlando FL,32816,5770.83,0
2031-12-13,18:53:00,Movie Theater,-58.01,Winter Park FL,32789,5712.82,0
2031-12-14,18:06:00,BP,-17.82,Oviedo FL,32765,5695.0,0
2031-12-14,14:01:00,Pep Boys,-52.8,Oviedo FL,32765,5642.2,0
2031-12-16,19:28:00,McDonald's,-35.91,Winter Park FL,32789,5606.29,0
2031-12-16,15:17:00,Five Below,-41.85,Oviedo FL,32765,5564.44,0
2031-12-16,20:54:00,Paypal,-2863.3,Mexico City MC,81422,2701.14,1
2031-12-17,12:11:00,Subway,-24.56,Winter Park FL,32789,5539.88,0
2031-12-17,04:50:00,Magic the Gathering,-670.75,New York NY,21770,4869.13,1
2031-12-18,14:34:00,Shell,-15.85,Orlando FL,32816,5524.03,0
2031-12-18,12:36:00,Whole Foods,-58.1,Oviedo FL,32765,5465.93,0
2031-12-18,09:52:00,Burger King,-16.22,Orlando FL,32816,5449.71,0
2031-12-19,10:32:00,Walgreens,-20.24,Winter Park FL,32789,5429.47,0
2031-12-19,12:17:00,BP,-14.68,Orlando FL,32816,5414.79,0
2031-12-19,10:32:00,Subway,-33.99,Orlando FL,32816,5380.8,0
2031-12-21,12:57:00,Concert Tickets,-39.39,Orlando FL,32816,5341.41,0
2031-12-21,16:17:00,Publix,-59.96,Orlando FL,32816,5281.45,0
2031-12-22,08:00:00,Paycheck,2000.0,Oviedo FL,32765,7281.45,0
2031-12-22,17:48:00,Starbucks,-56.44,Orlando FL,32816,7225.01,0
2031-12-22,18:35:00,McDonald's,-47.33,Orlando FL,32816,7177.68,0
2031-12-22,14:34:00,Burger King,-71.19,Winter Park FL,32789,7106.49,0
2031-12-23,12:11:00,McDonald's,-21.64,Oviedo FL,32765,7084.85,0
2031-12-23,19:27:00,Burger King,-38.09,Oviedo FL,32765,7046.76,0
2031-12-25,14:32:00,Burger King,-34.62,Orlando FL,32816,7012.14,0
2031-12-25,20:38:00,Amusement Park,-103.61,Oviedo FL,32765,6908.53,0
2031-12-26,13:21:00,Target,-288.83,Oviedo FL,32765,6619.7,0
2031-12-29,04:10:00,Monster Energy,-241.78,Los Angeles CA,74196,6377.92,1
2031-12-29,20:35:00,Jiffy Lube,-359.15,Orlando FL,32816,6260.55,0
2031-12-29,13:53:00,Walmart,-283.5,Winter Park FL,32789,5977.05,0
2032-01-01,09:00:00,Rent,-960.0,Oviedo FL,32765,5017.05,0
2032-01-01,09:00:00,Insurance,-197.46,Oviedo FL,32765,4819.59,0
2032-01-01,09:00:00,Car,-300.0,Oviedo FL,32765,4519.59,0
2032-01-01,17:50:00,Walmart,-114.09,Oviedo FL,32765,4405.5,0
2032-01-02,14:01:00,Burger King,-34.0,Orlando FL,32816,4371.5,0
2032-01-02,14:09:00,BP,-24.05,Oviedo FL,32765,4347.45,0
2032-01-02,13:26:00,BP,-16.18,Orlando FL,32816,4331.27,0
2032-01-03,14:18:00,McDonald's,-21.88,Oviedo FL,32765,4309.39,0
2032-01-03,12:30:00,Best Buy,-66.87,Orlando FL,32816,4242.52,0
2032-01-04,19:58:00,Best Buy,-142.81,Oviedo FL,32765,4099.71,0
2032-01-04,16:02:00,Pep Boys,-97.67,Orlando FL,32816,4002.04,0
2032-01-05,08:00:00,Paycheck,2000.0,Oviedo FL,32765,6002.04,0
2032-01-05,17:05:00,Amazon,-271.95,Oviedo FL,32765,5730.09,0
2032-01-05,15:56:00,Amazon,-84.3,Winter Park FL,32789,5645.79,0
2032-01-06,10:16:00,BP,-26.18,Oviedo FL,32765,5619.61,0
2032-01-06,20:24:00,Shell,-28.29,Winter Park FL,32789,5591.32,0
2032-01-06,12:47:00,Burger King,-29.93,Winter Park FL,32789,5561.39,0
2032-01-07,09:00:00,Spotify,-11.99,Oviedo FL,32765,5549.4,0
2032-01-07,09:00:00,Internet,-70.89,Oviedo FL,32765,5478.51,0
2032-01-07,09:00:00,ChatGPT Plus,-20.0,Oviedo FL,32765,5458.51,0
2032-01-07,15:17:00,Midas,-147.9,Winter Park FL,32789,5310.61,0
2032-01-08,09:50:00,CVS,-12.31,Orlando FL,32816,5298.3,0
2032-01-09,11:51:00,Dollar Tree,-22.77,Winter Park FL,32789,5275.53,0
2032-01-09,16:16:00,Dollar Tree,-40.84,Winter Park FL,32789,5234.69,0
2032-01-10,21:20:00,Burger King,-36.58,Winter Park FL,32789,5198.11,0
2032-01-10,20:41:00,Walgreens,-22.89,Winter Park FL,32789,5175.22,0
2032-01-10,12:08:00,Exxon,-13.61,Oviedo FL,32765,5161.61,0
2032-01-11,21:26:00,Chevron,-23.34,Orlando FL,32816,5138.27,0
2032-01-11,20:05:00,Monster Energy,-381.23,Honolulu HI,50991,4757.04,1
2032-01-11,12:10:00,CVS,-37.29,Orlando FL,32816,5100.98,0
2032-01-11,14:05:00,Whole Foods,-44.85,Winter Park FL,32789,5056.13,0
2032-01-14,08:33:00,Burger King,-39.58,Winter Park FL,32789,5016.55,0
2032-01-14,16:36:00,Best Buy,-47.86,Winter Park FL,32789,4968.69,0
2032-01-15,20:43:00,Concert Tickets,-47.52,Oviedo FL,32765,4921.17,0
2032-01-15,06:02:00,Impractical Jokers,-2136.7,Pyongyang NK,90401,2784.47,1
2032-01-15,10:13:00,Target,-47.55,Winter Park FL,32789,4873.62,0
2032-01-15,08:18:00,Subway,-28.17,Oviedo FL,32765,4845.45,0
2032-01-16,18:35:00,Starbucks,-10.07,Oviedo FL,32765,4835.38,0
2032-01-16,21:04:00,Amazon,-69.23,Orlando FL,32816,4766.15,0
2032-01-18,12:09:00,Amazon,-105.94,Winter Park FL,32789,4660.21,0
2032-01-18,16:12:00,Burger King,-22.92,Oviedo FL,32765,4637.29,0
2032-01-18,15:50:00,Kroger,-85.35,Oviedo FL,32765,4551.94,0
2032-01-19,08:00:00,Paycheck,2000.0,Oviedo FL,32765,6551.94,0
2032-01-21,10:26:00,Starbucks,-32.89,Oviedo FL,32765,6519.05,0
2032-01-21,17:30:00,Burger King,-26.28,Oviedo FL,32765,6492.77,0
2032-01-21,19:47:00,Amazon,-217.42,Oviedo FL,32765,6275.35,0
2032-01-23,10:34:00,Amusement Park,-66.92,Orlando FL,32816,6208.43,0
2032-01-23,15:03:00,Burger King,-14.16,Oviedo FL,32765,6194.27,0
2032-01-23,13:38:00,Netflix,-31.24,Orlando FL,32816,6163.03,0
2032-01-24,11:59:00,Publix,-133.2,Oviedo FL,32765,6029.83,0
2032-01-25,02:42:00,IBM,-1094.58,Los Angeles CA,33386,4935.25,1
2032-01-25,18:29:00,McDonald's,-66.75,Winter Park FL,32789,5963.08,0
2032-01-25,15:56:00,Concert Tickets,-46.3,Winter Park FL,32789,5916.78,0
2032-01-26,11:33:00,BP,-22.05,Oviedo FL,32765,5894.73,0
2032-01-26,16:29:00,Dollar Tree,-35.36,Oviedo FL,32765,5859.37,0
2032-01-26,18:12:00,Subway,-36.54,Orlando FL,32816,5822.83,0
2032-01-27,08:32:00,Concert Tickets,-20.01,Oviedo FL,32765,5802.82,0
2032-01-27,20:46:00,Amusement Park,-58.29,Winter Park FL,32789,5744.53,0
2032-01-28,10:15:00,CVS,-12.68,Orlando FL,32816,5731.85,0
2032-01-28,20:24:00,Shell,-27.9,Oviedo FL,32765,5703.95,0
2032-01-29,19:43:00,Starbucks,-24.71,Orlando FL,32816,5679.24,0
2032-01-30,18:04:00,Midas,-197.01,Orlando FL,32816,5482.23,0
2032-01-30,14:17:00,Starbucks,-31.61,Orlando FL,32816,5450.62,0
2032-01-30,16:18:00,Dollar Tree,-35.37,Winter Park FL,32789,5415.25,0
2032-02-01,09:00:00,Rent,-960.0,Oviedo FL,32765,4455.25,0
2032-02-01,09:00:00,Insurance,-197.46,Oviedo FL,32765,4257.79,0
2032-02-01,09:00:00,Car,-300.0,Oviedo FL,32765,3957.79,0
2032-02-02,08:00:00,Paycheck,2000.0,Oviedo FL,32765,5957.79,0
2032-02-02,08:13:00,Starbucks,-10.35,Oviedo FL,32765,5947.44,0
2032-02-02,17:19:00,McDonald's,-25.23,Winter Park FL,32789,5922.21,0
2032-02-03,21:06:00,Subway,-21.1,Winter Park FL,32789,5901.11,0
2032-02-03,18:34:00,Subway,-9.37,Oviedo FL,32765,5891.74,0
2032-02-03,11:46:00,CVS,-34.17,Oviedo FL,32765,5857.57,0
2032-02-06,10:43:00,Burger King,-37.19,Winter Park FL,32789,5820.38,0
2032-02-06,11:56:00,McDonald's,-32.73,Oviedo FL,32765,5787.65,0
2032-02-06,16:01:00,Shell,-16.56,Oviedo FL,32765,5771.09,0
2032-02-07,09:00:00,Spotify,-11.99,Oviedo FL,32765,5759.1,0
2032-02-07,09:00:00,Internet,-70.89,Oviedo FL,32765,5688.21,0
2032-02-07,09:00:00,ChatGPT Plus,-20.0,Oviedo FL,32765,5668.21,0
2032-02-07,20:17:00,Shell,-20.55,Winter Park FL,32789,5647.66,0
2032-02-08,09:49:00,Subway,-20.22,Winter Park FL,32789,5627.44,0
2032-02-08,15:25:00,Midas,-96.6,Oviedo FL,32765,5530.84,0
2032-02-08,14:56:00,Amazon,-139.88,Winter Park FL,32789,5390.96,0
2032-02-09,10:39:00,Starbucks,-15.78,Winter Park FL,32789,5375.18,0
2032-02-10,18:20:00,Burger King,-7.64,Oviedo FL,32765,5367.54,0
2032-02-10,13:55:00,Starbucks,-13.99,Oviedo FL,32765,5353.55,0
2032-02-11,07:32:00,Servicenow,-2854.46,New York NY,69074,2499.09,1
2032-02-12,10:31:00,Subway,-26.98,Orlando FL,32816,5326.57,0
2032-02-12,15:24:00,Subway,-35.59,Oviedo FL,32765,5290.98,0
2032-02-13,11:00:00,Amazon,-50.94,Orlando FL,32816,5240.04,0
2032-02-14,08:12:00,Trader Joe's,-35.11,Winter Park FL,32789,5204.93,0
2032-02-15,20:20:00,Amazon,-74.77,Orlando FL,32816,5130.16,0
2032-02-15,18:06:00,Concert Tickets,-59.15,Winter Park FL,32789,5071.01,0
2032-02-16,08:00:00,Paycheck,2000.0,Oviedo FL,32765,7071.01,0
2032-02-16,18:35:00,Trader Joe's,-156.94,Winter Park FL,32789,6914.07,0
2032-02-16,09:16:00,Starbucks,-37.79,Oviedo FL,32765,6876.28,0
2032-02-16,19:06:00,Burger King,-17.86,Orlando FL,32816,6858.42,0
2032-02-17,09:52:00,Starbucks,-33.9,Winter Park FL,32789,6824.52,0
2032-02-17,18:29:00,Subway,-25.81,Orlando FL,32816,6798.71,0
2032-02-18,10:57:00,Midas,-390.49,Oviedo FL,32765,6408.22,0
2032-02-18,11:19:00,Walgreens,-10.47,Orlando FL,32816,6397.75,0
2032-02-18,02:25:00,Accelerators,-2013.2,Charleston SC,38379,4384.55,1
2032-02-19,09:58:00,Starbucks,-57.44,Winter Park FL,32789,6340.31,0
2032-02-19,13:23:00,Dollar Tree,-26.14,Oviedo FL,32765,6314.17,0
2032-02-20,18:33:00,Publix,-109.24,Orlando FL,32816,6204.93,0
2032-02-21,12:34:00,Amusement Park,-72.96,Oviedo FL,32765,6131.97,0
2032-02-21,12:57:00,Burger King,-54.12,Oviedo FL,32765,6077.85,0
2032-02-21,08:27:00,Best Buy,-198.31,Oviedo FL,32765,5879.54,0
2032-02-22,06:32:00,Paypal,-180.76,Anchorage AL,54731,5698.78,1
2032-02-23,07:54:00,Paypal,-865.59,Tokyo JP,46837,5013.95,1
2032-02-23,18:11:00,Walmart,-47.88,Winter Park FL,32789,5831.66,0
2032-02-23,00:04:00,Paypal,-318.32,Groton CT,46319,5513.34,1
2032-02-24,15:03:00,BP,-18.26,Orlando FL,32816,5813.4,0
2032-02-27,16:26:00,Starbucks,-24.02,Orlando FL,32816,5789.38,0
2032-02-27,12:52:00,Exxon,-19.95,Orlando FL,32816,5769.43,0
2032-02-28,18:11:00,McDonald's,-35.29,Winter Park FL,32789,5734.14,0
2032-02-28,10:02:00,Target,-141.38,Orlando FL,32816,5592.76,0
2032-02-28,21:46:00,Starbucks,-33.05,Oviedo FL,32765,5559.71,0
2032-02-29,09:19:00,Trader Joe's,-58.9,Winter Park FL,32789,5500.81,0
2032-02-29,12:07:00,Burger King,-8.47,Oviedo FL,32765,5492.34,0
2032-03-01,08:00:00,Paycheck,2000.0,Oviedo FL,32765,7492.34,0
2032-03-01,09:00:00,Rent,-960.0,Oviedo FL,32765,6532.34,0
2032-03-01,09:00:00,Insurance,-197.46,Oviedo FL,32765,6334.88,0
2032-03-01,09:00:00,Car,-300.0,Oviedo FL,32765,6034.88,0
2032-03-01,20:25:00,Amusement Park,-87.82,Orlando FL,32816,5947.06,0
2032-03-03,15:04:00,Publix,-76.39,Winter Park FL,32789,5870.67,0
2032-03-03,09:26:00,Netflix,-37.57,Oviedo FL,32765,5833.1,0
2032-03-03,08:08:00,Burger King,-33.72,Orlando FL,32816,5799.38,0
2032-03-03,14:33:00,Onlyfans,-2377.26,Tokyo JP,28077,3422.12,1
2032-03-05,18:01:00,Netflix,-39.97,Oviedo FL,32765,5759.41,0
2032-03-05,16:43:00,Amazon,-15.74,Orlando FL,32816,5743.67,0
2032-03-05,17:14:00,Burger King,-9.23,Oviedo FL,32765,5734.44,0
2032-03-06,11:00:00,Chevron,-10.4,Oviedo FL,32765,5724.04,0
2032-03-06,16:11:00,McDonald's,-30.39,Winter Park FL,32789,5693.65,0
2032-03-06,13:34:00,Concert Tickets,-53.07,Oviedo FL,32765,5640.58,0
2032-03-07,09:00:00,Spotify,-11.99,Oviedo FL,32765,5628.59,0
2032-03-07,09:00:00,Internet,-70.89,Oviedo FL,32765,5557.7,0
2032-03-07,09:00:00,ChatGPT Plus,-20.0,Oviedo FL,32765,5537.7,0
2032-03-07,21:33:00,Trader Joe's,-97.65,Oviedo FL,32765,5440.05,0
2032-03-09,13:24:00,Whole Foods,-83.2,Winter Park FL,32789,5356.85,0
2032-03-09,14:30:00,Burger King,-27.92,Orlando FL,32816,5328.93,0
2032-03-10,11:10:00,Concert Tickets,-30.32,Orlando FL,32816,5298.61,0
2032-03-10,09:16:00,Netflix,-58.66,Winter Park FL,32789,5239.95,0
2032-03-10,17:18:00,CVS,-30.11,Oviedo FL,32765,5209.84,0
2032-03-11,13:29:00,Shell,-27.56,Orlando FL,32816,5182.28,0
2032-03-11,12:33:00,Walgreens,-32.29,Orlando FL,32816,5149.99,0
2032-03-11,02:26:00,Fraud,-631.27,Charleston SC,54398,4518.72,1
2032-03-11,18:43:00,Starbucks,-27.13,Orlando FL,32816,5122.86,0
2032-03-12,20:02:00,Walmart,-33.48,Winter Park FL,32789,5089.38,0
2032-03-12,09:36:00,Walmart,-140.55,Orlando FL,32816,4948.83,0
2032-03-13,11:06:00,Pep Boys,-181.98,Oviedo FL,32765,4766.85,0
2032-03-14,18:26:00,Target,-100.51,Winter Park FL,32789,4666.34,0
2032-03-14,11:54:00,Walmart,-133.53,Oviedo FL,32765,4532.81,0
2032-03-14,12:47:00,Movie Theater,-42.75,Orlando FL,32816,4490.06,0
2032-03-15,08:00:00,Paycheck,2000.0,Oviedo FL,32765,6490.06,0
2032-03-16,19:10:00,Whole Foods,-114.94,Oviedo FL,32765,6375.12,0
2032-03-16,08:58:00,Publix,-142.94,Winter Park FL,32789,6232.18,0
2032-03-17,20:18:00,Starbucks,-14.4,Winter Park FL,32789,6217.78,0
2032-03-18,21:23:00,McDonald's,-18.73,Orlando FL,32816,6199.05,0
2032-03-18,18:35:00,Starbucks,-72.39,Orlando FL,32816,6126.66,0
2032-03-19,08:35:00,Whole Foods,-127.59,Orlando FL,32816,5999.07,0
2032-03-19,12:00:00,McDonald's,-22.07,Winter Park FL,32789,5977.0,0
2032-03-19,18:20:00,Fat Joe,-784.42,Pittsburgh PA,85130,5192.58,1
2032-03-20,16:58:00,McDonald's,-35.93,Oviedo FL,32765,5941.07,0
2032-03-20,09:17:00,Burger King,-15.25,Oviedo FL,32765,5925.82,0
2032-03-20,20:51:00,Walgreens,-44.53,Winter Park FL,32789,5881.29,0
2032-03-20,03:22:00,Fraud,-1654.88,Pittsburgh PA,90929,4226.41,1
2032-03-21,10:21:00,Chevron,-14.69,Oviedo FL,32765,5866.6,0
2032-03-21,14:31:00,Amazon,-123.48,Orlando FL,32816,5743.12,0
2032-03-22,14:40:00,Subway,-15.42,Oviedo FL,32765,5727.7,0
2032-03-23,16:48:00,Concert Tickets,-22.31,Oviedo FL,32765,5705.39,0
2032-03-23,12:22:00,BP,-27.58,Winter Park FL,32789,5677.81,0
2032-03-23,17:36:00,Lockheed Martin,-2685.95,London EN,27974,2991.86,1
2032-03-24,09:38:00,Starbucks,-35.99,Winter Park FL,32789,5641.82,0
2032-03-24,16:26:00,Target,-147.86,Oviedo FL,32765,5493.96,0
2032-03-24,10:05:00,McDonald's,-7.93,Winter Park FL,32789,5486.03,0
2032-03-25,14:42:00,Burger King,-26.35,Oviedo FL,32765,5459.68,0
2032-03-25,20:07:00,Fraud,-2041.58,New York NY,19026,3418.1,1
2032-03-26,16:53:00,Subway,-38.83,Oviedo FL,32765,5420.85,0
2032-03-26,08:18:00,Five Below,-37.21,Oviedo FL,32765,5383.64,0
2032-03-26,13:17:00,Starbucks,-20.11,Winter Park FL,32789,5363.53,0
2032-03-29,08:00:00,Paycheck,2000.0,Oviedo FL,32765,7363.53,0
2032-03-30,02:11:00,Onlyfans,-410.38,Pyongyang NK,25723,6953.15,1
2032-04-01,09:00:00,Rent,-960.0,Oviedo FL,32765,6403.53,0
2032-04-01,09:00:00,Insurance,-197.46,Oviedo FL,32765,6206.07,0
2032-04-01,09:00:00,Car,-300.0,Oviedo FL,32765,5906.07,0
2032-04-01,15:23:00,McDonald's,-22.58,Oviedo FL,32765,5883.49,0
2032-04-01,22:35:00,Fat Joe,-1852.81,London EN,83967,4030.68,1
2032-04-01,19:41:00,CVS,-25.18,Winter Park FL,32789,5858.31,0
2032-04-01,10:47:00,Servicenow,-1278.07,Tokyo JP,93905,4580.24,1
2032-04-02,12:27:00,Paypal,-718.19,Mexico City MC,42261,5140.12,1
2032-04-04,17:41:00,Netflix,-10.85,Orlando FL,32816,5847.46,0
2032-04-04,03:39:00,Magic the Gathering,-2822.64,Los Angeles CA,99493,3024.82,1
2032-04-05,08:56:00,Starbucks,-33.74,Winter Park FL,32789,5813.72,0
2032-04-05,18:37:00,Starbucks,-9.92,Orlando FL,32816,5803.8,0
2032-04-05,21:09:00,Publix,-32.4,Winter Park FL,32789,5771.4,0
2032-04-06,12:45:00,Walgreens,-7.39,Winter Park FL,32789,5764.01,0
2032-04-06,17:44:00,Pep Boys,-91.6,Winter Park FL,32789,5672.41,0
2032-04-06,17:00:00,Concert Tickets,-20.74,Oviedo FL,32765,5651.67,0
2032-04-07,09:00:00,Spotify,-11.99,Oviedo FL,32765,5639.68,0
2032-04-07,09:00:00,Internet,-70.89,Oviedo FL,32765,5568.79,0
2032-04-07,09:00:00,ChatGPT Plus,-20.0,Oviedo FL,32765,5548.79,0
2032-04-08,08:59:00,Onlyfans,-1750.36,Pyongyang NK,15076,3798.43,1
2032-04-09,13:13:00,BP,-12.51,Winter Park FL,32789,5536.28,0
2032-04-09,14:48:00,CVS,-14.93,Oviedo FL,32765,5521.35,0
2032-04-09,13:26:00,Starbucks,-39.73,Winter Park FL,32789,5481.62,0
2032-04-10,08:26:00,Amazon,-99.01,Winter Park FL,32789,5382.61,0
2032-04-10,14:06:00,Best Buy,-100.12,Orlando FL,32816,5282.49,0
2032-04-11,16:14:00,Starbucks,-21.02,Oviedo FL,32765,5261.47,0
2032-04-11,19:08:00,Whole Foods,-70.21,Orlando FL,32816,5191.26,0
2032-04-12,08:00:00,Paycheck,2000.0,Oviedo FL,32765,7191.26,0
2032-04-12,21:06:00,Amazon,-290.38,Oviedo FL,32765,6900.88,0
2032-04-12,21:19:00,Exxon,-53.1,Orlando FL,32816,6847.78,0
2032-04-12,09:41:00,Concert Tickets,-55.77,Winter Park FL,32789,6792.01,0
2032-04-13,14:33:00,Subway,-16.76,Winter Park FL,32789,6775.25,0
2032-04-13,16:43:00,Dollar Tree,-69.68,Orlando FL,32816,6705.57,0
2032-04-13,18:25:00,Amazon,-128.46,Oviedo FL,32765,6577.11,0
2032-04-13,16:13:00,Paypal,-237.23,Anchorage AL,63798,6339.88,1
2032-04-14,10:30:00,Midas,-280.98,Winter Park FL,32789,6296.13,0
2032-04-14,16:13:00,Starbucks,-50.14,Oviedo FL,32765,6245.99,0
2032-04-15,11:24:00,Burger King,-28.8,Winter Park FL,32789,6217.19,0
2032-04-15,15:31:00,Burger King,-39.01,Winter Park FL,32789,6178.18,0
2032-04-16,12:47:00,Whole Foods,-91.63,Oviedo FL,32765,6086.55,0
2032-04-18,11:19:00,Best Buy,-239.06,Oviedo FL,32765,5847.49,0
2032-04-18,12:22:00,Fat Joe,-275.21,Pyongyang NK,68563,5572.28,1
2032-04-18,16:35:00,Whole Foods,-76.01,Winter Park FL,32789,5771.48,0
2032-04-19,21:56:00,Walgreens,-32.16,Oviedo FL,32765,5739.32,0
2032-04-19,08:23:00,Starbucks,-34.82,Oviedo FL,32765,5704.5,0
2032-04-19,20:30:00,Amusement Park,-35.93,Winter Park FL,32789,5668.57,0
2032-04-21,17:45:00,Dollar Tree,-36.65,Oviedo FL,32765,5631.92,0
2032-04-22,10:58:00,Starbucks,-31.21,Winter Park FL,32789,5600.71,0
2032-04-22,17:00:00,Subway,-37.86,Orlando FL,32816,5562.85,0
2032-04-22,16:32:00,Subway,-8.74,Oviedo FL,32765,5554.11,0
2032-04-23,21:52:00,Shell,-29.4,Winter Park FL,32789,5524.71,0
2032-04-23,08:18:00,McDonald's,-24.79,Orlando FL,32816,5499.92,0
2032-04-23,08:34:00,McDonald's,-13.26,Orlando FL,32816,5486.66,0
2032-04-23,18:24:00,Magic the Gathering,-2300.51,Honolulu HI,59434,3186.15,1
2032-04-24,19:39:00,Amusement Park,-39.96,Oviedo FL,32765,5446.7,0
2032-04-24,14:20:00,Exxon,-24.92,Oviedo FL,32765,5421.78,0
2032-04-25,19:15:00,Burger King,-22.94,Winter Park FL,32789,5398.84,0
2032-04-26,08:00:00,Paycheck,2000.0,Oviedo FL,32765,7398.84,0
2032-04-26,19:32:00,McDonald's,-48.73,Winter Park FL,32789,7350.11,0
2032-04-26,16:18:00,CVS,-27.03,Winter Park FL,32789,7323.08,0
2032-04-27,19:48:00,Starbucks,-31.06,Winter Park FL,32789,7292.02,0
2032-04-29,11:08:00,Concert Tickets,-29.19,Winter Park FL,32789,7262.83,0
2032-04-29,12:36:00,Walmart,-117.5,Oviedo FL,32765,7145.33,0
2032-04-29,12:27:00,Subway,-53.33,Orlando FL,32816,7092.0,0
2032-04-30,13:39:00,Dollar Tree,-11.94,Oviedo FL,32765,7080.06,0
2032-04-30,14:42:00,Publix,-116.95,Oviedo FL,32765,6963.11,0
2032-04-30,21:01:00,Subway,-39.17,Oviedo FL,32765,6923.94,0
2032-05-01,09:00:00,Rent,-960.0,Oviedo FL,32765,5963.94,0
2032-05-01,09:00:00,Insurance,-197.46,Oviedo FL,32765,5766.48,0
2032-05-01,09:00:00,Car,-300.0,Oviedo FL,32765,5466.48,0
2032-05-01,10:10:00,Five Below,-38.75,Winter Park FL,32789,5427.73,0
2032-05-01,01:44:00,Magic the Gathering,-740.2,Pyongyang NK,69531,4687.53,1
2032-05-01,08:38:00,Amazon,-106.89,Orlando FL,32816,5320.84,0
2032-05-02,10:03:00,Burger King,-8.81,Oviedo FL,32765,5312.03,0
2032-05-02,13:31:00,McDonald's,-26.78,Oviedo FL,32765,5285.25,0
2032-05-02,16:18:00,Exxon,-16.52,Winter Park FL,32789,5268.73,0
2032-05-03,12:12:00,Starbucks,-9.74,Winter Park FL,32789,5258.99,0
2032-05-03,12:45:00,Target,-133.47,Orlando FL,32816,5125.52,0
2032-05-03,17:52:00,Best Buy,-123.34,Oviedo FL,32765,5002.18,0
2032-05-04,14:56:00,Shell,-12.59,Orlando FL,32816,4989.59,0
2032-05-06,16:46:00,Concert Tickets,-32.33,Winter Park FL,32789,4957.26,0
2032-05-06,10:35:00,Whole Foods,-72.93,Winter Park FL,32789,4884.33,0
2032-05-06,08:39:00,McDonald's,-34.14,Orlando FL,32816,4850.19,0
2032-05-07,09:00:00,Spotify,-11.99,Oviedo FL,32765,4838.2,0
2032-05-07,09:00:00,Internet,-70.89,Oviedo FL,32765,4767.31,0
2032-05-07,09:00:00,ChatGPT Plus,-20.0,Oviedo FL,32765,4747.31,0
2032-05-07,08:07:00,BP,-19.73,Winter Park FL,32789,4727.58,0
2032-05-08,15:17:00,Walmart,-120.45,Winter Park FL,32789,4607.13,0
2032-05-08,18:55:00,Publix,-60.65,Winter Park FL,32789,4546.48,0
2032-05-08,21:47:00,Amazon,-37.64,Winter Park FL,32789,4508.84,0
2032-05-09,12:08:00,McDonald's,-24.91,Orlando FL,32816,4483.93,0
2032-05-09,20:09:00,Walmart,-55.38,Orlando FL,32816,4428.55,0
2032-05-09,01:26:00,Accelerators,-1135.45,Los Angeles CA,39325,3293.1,1
2032-05-10,08:00:00,Paycheck,2000.0,Oviedo FL,32765,6428.55,0
2032-05-10,14:00:00,Servicenow,-2674.26,Mexico City MC,52324,3754.29,1
2032-05-11,07:31:00,IBM,-215.14,Honolulu HI,80562,6213.41,1
2032-05-11,18:25:00,Whole Foods,-135.5,Orlando FL,32816,6293.05,0
2032-05-11,16:00:00,Movie Theater,-22.82,Orlando FL,32816,6270.23,0
2032-05-11,15:57:00,IBM,-347.4,Los Angeles CA,69939,5922.83,1
2032-05-13,11:48:00,Magic the Gathering,-1359.98,Pyongyang NK,87774,4910.25,1
2032-05-13,12:04:00,Walgreens,-37.12,Winter Park FL,32789,6233.11,0
2032-05-13,05:33:00,Pawn Stars,-1089.93,Los Angeles CA,29554,5143.18,1
2032-05-13,13:48:00,Amusement Park,-67.59,Oviedo FL,32765,6165.52,0
2032-05-15,20:06:00,Amazon,-159.72,Oviedo FL,32765,6005.8,0
2032-05-16,12:06:00,Target,-200.89,Orlando FL,32816,5804.91,0
2032-05-16,22:17:00,Pawn Stars,-2853.56,Groton CT,73954,2951.35,1
2032-05-16,12:27:00,Five Below,-43.07,Orlando FL,32816,5761.84,0
2032-05-17,10:30:00,Trader Joe's,-59.02,Oviedo FL,32765,5702.82,0
2032-05-17,07:56:00,Fraud,-606.79,Pittsburgh PA,31753,5096.03,1
2032-05-18,13:46:00,Walmart,-128.38,Oviedo FL,32765,5574.44,0
2032-05-18,08:43:00,Impractical Jokers,-766.35,Pyongyang NK,64160,4808.09,1
2032-05-18,14:03:00,Pep Boys,-199.09,Winter Park FL,32789,5375.35,0
2032-05-18,10:11:00,AutoZone,-91.92,Oviedo FL,32765,5283.43,0
2032-05-18,10:12:00,Magic the Gathering,-1243.45,Tokyo JP,28616,4039.98,1
2032-05-19,16:14:00,Netflix,-55.18,Winter Park FL,32789,5228.25,0
2032-05-20,12:48:00,Exxon,-21.36,Orlando FL,32816,5206.89,0
2032-05-20,19:54:00,Walmart,-90.1,Oviedo FL,32765,5116.79,0
2032-05-20,01:34:00,Servicenow,-1127.51,New York NY,91537,3989.28,1
2032-05-21,12:21:00,Starbucks,-30.29,Orlando FL,32816,5086.5,0
2032-05-21,17:15:00,Amusement Park,-24.81,Winter Park FL,32789,5061.69,0
2032-05-21,10:34:00,Subway,-32.74,Winter Park FL,32789,5028.95,0
2032-05-22,18:08:00,Magic the Gathering,-2743.84,London EN,74362,2285.11,1
2032-05-23,18:36:00,Trader Joe's,-32.39,Orlando FL,32816,4996.56,0
2032-05-23,19:01:00,Amazon,-149.62,Winter Park FL,32789,4846.94,0
2032-05-24,08:00:00,Paycheck,2000.0,Oviedo FL,32765,6846.94,0
2032-05-24,12:13:00,Whole Foods,-129.66,Orlando FL,32816,6717.28,0
2032-05-25,17:37:00,McDonald's,-68.03,Orlando FL,32816,6649.25,0
2032-05-25,10:41:00,Burger King,-28.43,Orlando FL,32816,6620.82,0
2032-05-25,14:54:00,Burger King,-68.32,Oviedo FL,32765,6552.5,0
2032-05-26,16:35:00,Whole Foods,-151.93,Orlando FL,32816,6400.57,0
2032-05-28,21:58:00,Walgreens,-55.69,Orlando FL,32816,6344.88,0
2032-05-28,14:59:00,Dollar Tree,-82.29,Winter Park FL,32789,6262.59,0
2032-05-28,15:33:00,Subway,-72.39,Winter Park FL,32789,6190.2,0
2032-05-30,12:33:00,Dollar Tree,-20.56,Orlando FL,32816,6169.64,0
2032-05-30,08:54:00,Starbucks,-31.14,Oviedo FL,32765,6138.5,0
2032-05-30,13:26:00,Netflix,-68.64,Orlando FL,32816,6069.86,0
2032-05-31,12:49:00,Fat Joe,-2714.69,Tokyo JP,54007,3355.17,1
2032-05-31,19:54:00,Target,-25.4,Orlando FL,32816,6044.46,0
2032-05-31,15:22:00,Publix,-145.71,Orlando FL,32816,5898.75,0
2032-06-01,09:00:00,Rent,-960.0,Oviedo FL,32765,4938.75,0
2032-06-01,09:00:00,Insurance,-197.46,Oviedo FL,32765,4741.29,0
2032-06-01,09:00:00,Car,-300.0,Oviedo FL,32765,4441.29,0
2032-06-01,12:37:00,Subway,-20.69,Winter Park FL,32789,4420.6,0
2032-06-01,05:59:00,Impractical Jokers,-489.39,Honolulu HI,46665,3931.21,1
2032-06-01,08:02:00,Publix,-73.59,Oviedo FL,32765,4347.01,0
2032-06-02,15:42:00,Publix,-48.77,Oviedo FL,32765,4298.24,0
2032-06-03,14:24:00,McDonald's,-8.88,Winter Park FL,32789,4289.36,0
2032-06-03,16:29:00,Exxon,-15.28,Oviedo FL,32765,4274.08,0
2032-06-05,10:36:00,Subway,-23.35,Orlando FL,32816,4250.73,0
2032-06-06,20:36:00,Amusement Park,-55.94,Orlando FL,32816,4194.79,0
2032-06-07,08:00:00,Paycheck,2000.0,Oviedo FL,32765,6194.79,0
2032-06-07,09:00:00,Spotify,-11.99,Oviedo FL,32765,6182.8,0
2032-06-07,09:00:00,Internet,-70.89,Oviedo FL,32765,6111.91,0
2032-06-07,09:00:00,ChatGPT Plus,-20.0,Oviedo FL,32765,6091.91,0
2032-06-07,21:50:00,Concert Tickets,-72.71,Winter Park FL,32789,6019.2,0
2032-06-09,21:06:00,Walmart,-196.23,Orlando FL,32816,5822.97,0
2032-06-10,19:47:00,Burger King,-17.54,Oviedo FL,32765,5805.43,0
2032-06-10,15:14:00,Walgreens,-37.36,Oviedo FL,32765,5768.07,0
2032-06-11,11:45:00,Subway,-12.85,Winter Park FL,32789,5755.22,0
2032-06-12,10:32:00,Burger King,-37.64,Oviedo FL,32765,5717.58,0
2032-06-13,18:16:00,Target,-65.35,Orlando FL,32816,5652.23,0
2032-06-13,13:50:00,Starbucks,-25.14,Oviedo FL,32765,5627.09,0
2032-06-13,11:24:00,Starbucks,-15.27,Orlando FL,32816,5611.82,0
2032-06-14,21:48:00,Amazon,-77.67,Oviedo FL,32765,5534.15,0
2032-06-17,11:48:00,Kroger,-40.25,Oviedo FL,32765,5493.9,0
2032-06-17,15:53:00,Walmart,-45.89,Oviedo FL,32765,5448.01,0
2032-06-18,13:35:00,Monster Energy,-1120.74,Tokyo JP,57484,4327.27,1
2032-06-18,08:33:00,McDonald's,-28.72,Winter Park FL,32789,5419.29,0
2032-06-18,20:36:00,Amazon,-129.29,Winter Park FL,32789,5290.0,0
2032-06-18,18:53:00,Burger King,-25.1,Oviedo FL,32765,5264.9,0
2032-06-19,14:25:00,Subway,-20.19,Winter Park FL,32789,5244.71,0
2032-06-19,10:22:00,Kroger,-47.76,Orlando FL,32816,5196.95,0
2032-06-20,13:49:00,McDonald's,-25.26,Winter Park FL,32789,5171.69,0
2032-06-20,11:45:00,Burger King,-5.7,Orlando FL,32816,5165.99,0
2032-06-21,08:00:00,Paycheck,2000.0,Oviedo FL,32765,7165.99,0
2032-06-21,11:43:00,McDonald's,-10.39,Winter Park FL,32789,7155.6,0
2032-06-21,15:23:00,Exxon,-57.23,Winter Park FL,32789,7098.37,0
2032-06-21,14:13:00,BP,-58.35,Winter Park FL,32789,7040.02,0
2032-06-22,08:34:00,McDonald's,-26.12,Orlando FL,32816,7013.9,0
2032-06-22,17:42:00,Whole Foods,-189.58,Oviedo FL,32765,6824.32,0
2032-06-22,19:01:00,Burger King,-33.19,Winter Park FL,32789,6791.13,0
2032-06-23,18:38:00,Publix,-182.68,Winter Park FL,32789,6608.45,0
2032-06-23,08:33:00,Exxon,-53.06,Winter Park FL,32789,6555.39,0
2032-06-23,09:48:00,Exxon,-55.3,Winter Park FL,32789,6500.09,0
2032-06-23,23:48:00,Servicenow,-2609.59,Tokyo JP,17480,3890.5,1
2032-06-24,12:23:00,Burger King,-44.56,Orlando FL,32816,6455.53,0
2032-06-24,08:54:00,Paypal,-705.99,Mexico City MC,55349,5749.54,1
2032-06-24,10:38:00,Best Buy,-194.34,Orlando FL,32816,6261.19,0
2032-06-24,18:59:00,Amazon,-110.3,Oviedo FL,32765,6150.89,0
2032-06-25,18:01:00,Starbucks,-20.87,Winter Park FL,32789,6130.02,0
2032-06-25,10:45:00,Starbucks,-17.61,Orlando FL,32816,6112.41,0
2032-06-26,18:13:00,Subway,-66.85,Oviedo FL,32765,6045.56,0
2032-06-26,18:20:00,Subway,-45.23,Winter Park FL,32789,6000.33,0
2032-06-29,17:41:00,Walmart,-63.66,Orlando FL,32816,5936.67,0
2032-06-30,12:28:00,Magic the Gathering,-1942.82,Groton CT,76026,3993.85,1
2032-06-30,12:11:00,BP,-22.16,Orlando FL,32816,5914.51,0
2032-07-01,09:00:00,Rent,-960.0,Oviedo FL,32765,4954.51,0
2032-07-01,09:00:00,Insurance,-197.46,Oviedo FL,32765,4757.05,0
2032-07-01,09:00:00,Car,-300.0,Oviedo FL,32765,4457.05,0
2032-07-02,18:19:00,Magic the Gathering,-2585.93,Honolulu HI,36946,1871.12,1
2032-07-03,04:48:00,Servicenow,-435.75,Pyongyang NK,18454,4021.3,1
2032-07-04,18:51:00,Subway,-38.07,Oviedo FL,32765,4418.98,0
2032-07-04,11:57:00,Burger King,-34.73,Orlando FL,32816,4384.25,0
2032-07-04,21:33:00,Walmart,-41.8,Winter Park FL,32789,4342.45,0
2032-07-05,08:00:00,Paycheck,2000.0,Oviedo FL,32765,6342.45,0
2032-07-05,21:32:00,Onlyfans,-1830.1,Groton CT,91179,4512.35,1
2032-07-05,10:04:00,Amazon,-193.34,Winter Park FL,32789,6149.11,0
2032-07-05,18:55:00,McDonald's,-13.67,Orlando FL,32816,6135.44,0
2032-07-05,11:05:00,Whole Foods,-195.21,Winter Park FL,32789,5940.23,0
2032-07-06,12:04:00,BP,-24.87,Orlando FL,32816,5915.36,0
2032-07-06,15:48:00,Whole Foods,-91.53,Orlando FL,32816,5823.83,0
2032-07-07,09:00:00,Spotify,-11.99,Oviedo FL,32765,5811.84,0
2032-07-07,09:00:00,Internet,-70.89,Oviedo FL,32765,5740.95,0
2032-07-07,09:00:00,ChatGPT Plus,-20.0,Oviedo FL,32765,5720.95,0
2032-07-07,11:56:00,Subway,-16.63,Oviedo FL,32765,5704.32,0
2032-07-08,18:05:00,Amusement Park,-33.67,Winter Park FL,32789,5670.65,0
2032-07-08,11:21:00,Subway,-7.47,Winter Park FL,32789,5663.18,0
2032-07-09,20:32:00,Amazon,-79.62,Winter Park FL,32789,5583.56,0
2032-07-10,15:35:00,Amusement Park,-33.5,Orlando FL,32816,5550.06,0
2032-07-10,20:28:00,McDonald's,-6.35,Orlando FL,32816,5543.71,0
2032-07-10,17:03:00,Subway,-39.47,Orlando FL,32816,5504.24,0
2032-07-11,10:52:00,Paypal,-1447.97,Tokyo JP,27706,4056.27,1
2032-07-12,10:31:00,Publix,-45.04,Winter Park FL,32789,5459.2,0
2032-07-12,17:45:00,Starbucks,-32.43,Orlando FL,32816,5426.77,0
2032-07-13,13:44:00,Kroger,-33.5,Winter Park FL,32789,5393.27,0
2032-07-14,11:12:00,Five Below,-12.95,Winter Park FL,32789,5380.32,0
2032-07-14,06:42:00,Pawn Stars,-2637.59,Mexico City MC,49536,2742.73,1
2032-07-14,18:37:00,Trader Joe's,-59.17,Orlando FL,32816,5321.15,0
2032-07-14,10:19:00,Amazon,-149.42,Winter Park FL,32789,5171.73,0
2032-07-15,08:25:00,Concert Tickets,-44.88,Winter Park FL,32789,5126.85,0
2032-07-15,08:02:00,CVS,-17.23,Oviedo FL,32765,5109.62,0
2032-07-17,17:05:00,Walmart,-45.85,Oviedo FL,32765,5063.77,0
2032-07-17,13:21:00,Midas,-93.49,Oviedo FL,32765,4970.28,0
2032-07-17,15:11:00,McDonald's,-35.52,Orlando FL,32816,4934.76,0
2032-07-18,20:44:00,Subway,-39.32,Winter Park FL,32789,4895.44,0
2032-07-18,18:15:00,Walgreens,-7.35,Winter Park FL,32789,4888.09,0
2032-07-18,18:36:00,McDonald's,-10.9,Winter Park FL,32789,4877.19,0
2032-07-19,08:00:00,Paycheck,2000.0,Oviedo FL,32765,6877.19,0
2032-07-19,15:28:00,Dollar Tree,-73.2,Winter Park FL,32789,6803.99,0
2032-07-19,19:08:00,Trader Joe's,-159.11,Winter Park FL,32789,6644.88,0
2032-07-20,17:43:00,Burger King,-78.45,Oviedo FL,32765,6566.43,0
2032-07-20,08:55:00,Onlyfans,-1134.98,Tokyo JP,41466,5431.45,1
2032-07-21,14:41:00,BP,-47.13,Oviedo FL,32765,6519.3,0
2032-07-21,13:46:00,Trader Joe's,-168.43,Winter Park FL,32789,6350.87,0
2032-07-24,16:14:00,CVS,-60.39,Orlando FL,32816,6290.48,0
2032-07-24,14:40:00,Shell,-25.14,Orlando FL,32816,6265.34,0
2032-07-24,01:55:00,Accelerators,-1575.15,New York NY,87339,4690.19,1
2032-07-25,14:28:00,Walgreens,-48.61,Oviedo FL,32765,6216.73,0
2032-07-25,21:32:00,Amazon,-215.86,Winter Park FL,32789,6000.87,0
2032-07-25,13:09:00,Burger King,-64.72,Oviedo FL,32765,5936.15,0
2032-07-26,08:23:00,Walmart,-107.04,Oviedo FL,32765,5829.11,0
2032-07-26,09:21:00,Burger King,-30.97,Winter Park FL,32789,5798.14,0
2032-07-26,14:43:00,Jiffy Lube,-151.16,Oviedo FL,32765,5646.98,0
2032-07-27,11:12:00,Concert Tickets,-43.36,Oviedo FL,32765,5603.62,0
2032-07-27,09:00:00,Best Buy,-109.04,Oviedo FL,32765,5494.58,0
2032-07-28,18:24:00,BP,-24.98,Oviedo FL,32765,5469.6,0
2032-07-28,09:44:00,Subway,-21.08,Orlando FL,32816,5448.52,0
2032-07-30,09:07:00,Lockheed Martin,-1403.73,Honolulu HI,43144,4044.79,1
2032-07-30,21:17:00,McDonald's,-12.0,Oviedo FL,32765,5436.52,0
2032-07-30,12:55:00,Best Buy,-46.55,Winter Park FL,32789,5389.97,0
2032-07-31,14:13:00,Accelerators,-2096.09,London EN,53204,3293.88,1
2032-07-31,13:37:00,Amazon,-125.4,Oviedo FL,32765,5264.57,0
2032-08-01,09:00:00,Rent,-960.0,Oviedo FL,32765,4304.57,0
2032-08-01,09:00:00,Insurance,-197.46,Oviedo FL,32765,4107.11,0
2032-08-01,09:00:00,Car,-300.0,Oviedo FL,32765,3807.11,0
2032-08-01,09:01:00,Amusement Park,-58.41,Oviedo FL,32765,3748.7,0
2032-08-01,08:01:00,Subway,-19.95,Winter Park FL,32789,3728.75,0
2032-08-01,09:27:00,Dollar Tree,-13.5,Oviedo FL,32765,3715.25,0
2032-08-02,08:00:00,Paycheck,2000.0,Oviedo FL,32765,5715.25,0
2032-08-02,15:46:00,Amusement Park,-10.47,Winter Park FL,32789,5704.78,0
2032-08-02,21:09:00,Walmart,-135.0,Winter Park FL,32789,5569.78,0
2032-08-02,13:40:00,CVS,-13.24,Oviedo FL,32765,5556.54,0
2032-08-03,13:02:00,CVS,-8.75,Oviedo FL,32765,5547.79,0
2032-08-04,14:50:00,Netflix,-25.22,Orlando FL,32816,5522.57,0
2032-08-04,17:44:00,Burger King,-11.85,Orlando FL,32816,5510.72,0
2032-08-05,18:02:00,Five Below,-9.45,Orlando FL,32816,5501.27,0
2032-08-05,14:32:00,Best Buy,-87.8,Oviedo FL,32765,5413.47,0
2032-08-07,09:00:00,Spotify,-11.99,Oviedo FL,32765,5401.48,0
2032-08-07,09:00:00,Internet,-70.89,Oviedo FL,32765,5330.59,0
2032-08-07,09:00:00,ChatGPT Plus,-20.0,Oviedo FL,32765,5310.59,0
2032-08-07,10:07:00,Target,-126.96,Winter Park FL,32789,5183.63,0
2032-08-08,13:44:00,Walgreens,-17.35,Orlando FL,32816,5166.28,0
2032-08-08,14:16:00,Fat Joe,-1196.92,Anchorage AL,87304,3969.36,1
2032-08-09,21:38:00,Accelerators,-2815.77,Pyongyang NK,99361,2350.51,1
2032-08-09,12:08:00,McDonald's,-30.7,Oviedo FL,32765,5135.58,0
2032-08-09,21:19:00,Movie Theater,-25.85,Oviedo FL,32765,5109.73,0
2032-08-10,13:11:00,Movie Theater,-22.73,Oviedo FL,32765,5087.0,0
2032-08-10,12:12:00,Publix,-43.7,Winter Park FL,32789,5043.3,0
2032-08-10,12:37:00,Netflix,-21.65,Oviedo FL,32765,5021.65,0
2032-08-11,09:32:00,Fraud,-1652.37,Groton CT,53109,3369.28,1
2032-08-13,19:13:00,Burger King,-20.9,Orlando FL,32816,5000.75,0
2032-08-13,09:05:00,Best Buy,-89.18,Oviedo FL,32765,4911.57,0
2032-08-13,11:51:00,McDonald's,-26.03,Winter Park FL,32789,4885.54,0
2032-08-13,11:40:00,Fat Joe,-904.0,Tokyo JP,28400,3981.54,1
2032-08-14,08:05:00,Burger King,-29.08,Winter Park FL,32789,4856.46,0
2032-08-14,08:54:00,CVS,-7.47,Winter Park FL,32789,4848.99,0
2032-08-15,17:55:00,BP,-20.23,Oviedo FL,32765,4828.76,0
2032-08-15,18:36:00,Target,-29.58,Winter Park FL,32789,4799.18,0
2032-08-16,08:00:00,Paycheck,2000.0,Oviedo FL,32765,6799.18,0
2032-08-16,12:47:00,Exxon,-55.53,Orlando FL,32816,6743.65,0
2032-08-16,19:21:00,CVS,-55.16,Orlando FL,32816,6688.49,0
2032-08-17,08:58:00,Amazon,-161.21,Winter Park FL,32789,6527.28,0
2032-08-17,08:53:00,Pep Boys,-227.61,Winter Park FL,32789,6299.67,0
2032-08-18,08:37:00,Burger King,-18.92,Orlando FL,32816,6280.75,0
2032-08-18,20:25:00,Whole Foods,-128.01,Orlando FL,32816,6152.74,0
2032-08-19,11:43:00,Burger King,-55.16,Orlando FL,32816,6097.58,0
2032-08-20,21:38:00,Concert Tickets,-107.7,Orlando FL,32816,5989.88,0
2032-08-22,14:09:00,Amusement Park,-49.89,Orlando FL,32816,5939.99,0
2032-08-24,15:09:00,AutoZone,-90.7,Winter Park FL,32789,5849.29,0
2032-08-26,08:57:00,Target,-120.95,Oviedo FL,32765,5728.34,0
2032-08-26,20:47:00,Starbucks,-17.61,Winter Park FL,32789,5710.73,0
2032-08-27,09:37:00,Best Buy,-19.2,Winter Park FL,32789,5691.53,0
2032-08-27,15:36:00,Concert Tickets,-46.32,Orlando FL,32816,5645.21,0
2032-08-27,10:03:00,Jiffy Lube,-93.19,Orlando FL,32816,5552.02,0
2032-08-27,23:49:00,IBM,-931.06,Los Angeles CA,70501,4620.96,1
2032-08-28,09:50:00,Best Buy,-113.97,Orlando FL,32816,5438.05,0
2032-08-28,12:37:00,Starbucks,-7.91,Orlando FL,32816,5430.14,0
2032-08-28,13:10:00,Walmart,-135.95,Winter Park FL,32789,5294.19,0
2032-08-29,20:57:00,Five Below,-24.17,Oviedo FL,32765,5270.02,0
2032-08-30,08:00:00,Paycheck,2000.0,Oviedo FL,32765,7270.02,0
2032-08-30,21:17:00,Monster Energy,-1561.32,Tokyo JP,30810,5708.7,1
2032-08-30,13:57:00,Chevron,-51.52,Orlando FL,32816,7218.5,0
2032-08-30,12:40:00,Subway,-61.87,Oviedo FL,32765,7156.63,0
2032-08-31,13:32:00,McDonald's,-54.87,Winter Park FL,32789,7101.76,0
2032-08-31,12:25:00,Movie Theater,-47.02,Winter Park FL,32789,7054.74,0
2032-08-31,08:20:00,Amazon,-201.3,Winter Park FL,32789,6853.44,0
2032-09-01,09:00:00,Rent,-960.0,Oviedo FL,32765,5893.44,0
2032-09-01,09:00:00,Insurance,-197.46,Oviedo FL,32765,5695.98,0
2032-09-01,09:00:00,Car,-300.0,Oviedo FL,32765,5395.98,0
2032-09-01,10:37:00,Amusement Park,-15.92,Oviedo FL,32765,5380.06,0
2032-09-02,08:36:00,Exxon,-12.38,Oviedo FL,32765,5367.68,0
2032-09-02,14:51:00,Walmart,-16.74,Winter Park FL,32789,5350.94,0
2032-09-02,08:36:00,Magic the Gathering,-925.58,Charleston SC,17939,4425.36,1
2032-09-02,09:35:00,Target,-144.99,Oviedo FL,32765,5205.95,0
2032-09-02,22:07:00,Paypal,-519.14,Tokyo JP,93907,4686.81,1
2032-09-03,21:09:00,Best Buy,-106.14,Orlando FL,32816,5099.81,0
2032-09-05,14:11:00,Publix,-56.59,Orlando FL,32816,5043.22,0
2032-09-06,18:35:00,Starbucks,-39.1,Orlando FL,32816,5004.12,0
2032-09-06,16:28:00,Walmart,-131.17,Oviedo FL,32765,4872.95,0
2032-09-07,09:00:00,Spotify,-11.99,Oviedo FL,32765,4860.96,0
2032-09-07,09:00:00,Internet,-70.89,Oviedo FL,32765,4790.07,0
2032-09-07,09:00:00,ChatGPT Plus,-20.0,Oviedo FL,32765,4770.07,0
2032-09-07,19:44:00,Burger King,-20.34,Winter Park FL,32789,4749.73,0
2032-09-07,15:08:00,Amusement Park,-56.58,Winter Park FL,32789,4693.15,0
2032-09-07,15:19:00,Best Buy,-48.7,Winter Park FL,32789,4644.45,0
2032-09-08,15:11:00,AutoZone,-199.53,Oviedo FL,32765,4444.92,0
2032-09-09,08:56:00,Starbucks,-24.42,Oviedo FL,32765,4420.5,0
2032-09-09,17:42:00,Whole Foods,-97.65,Orlando FL,32816,4322.85,0
2032-09-09,02:50:00,Servicenow,-1297.27,Charleston SC,66960,3025.58,1
2032-09-09,21:40:00,Starbucks,-31.87,Winter Park FL,32789,4290.98,0
2032-09-10,08:38:00,Movie Theater,-52.9,Orlando FL,32816,4238.08,0
2032-09-10,08:05:00,McDonald's,-15.84,Orlando FL,32816,4222.24,0
2032-09-11,18:22:00,Starbucks,-11.08,Oviedo FL,32765,4211.16,0
2032-09-11,08:52:00,Exxon,-27.03,Orlando FL,32816,4184.13,0
2032-09-11,08:47:00,McDonald's,-35.96,Winter Park FL,32789,4148.17,0
2032-09-12,17:20:00,Exxon,-19.1,Orlando FL,32816,4129.07,0
2032-09-12,14:21:00,CVS,-14.71,Winter Park FL,32789,4114.36,0
2032-09-12,17:51:00,Dollar Tree,-21.34,Winter Park FL,32789,4093.02,0
2032-09-13,08:00:00,Paycheck,2000.0,Oviedo FL,32765,6093.02,0
2032-09-14,20:27:00,Midas,-124.7,Oviedo FL,32765,5968.32,0
2032-09-14,18:35:00,Subway,-14.81,Winter Park FL,32789,5953.51,0
2032-09-14,11:31:00,Shell,-14.94,Orlando FL,32816,5938.57,0
2032-09-15,21:27:00,Exxon,-17.95,Oviedo FL,32765,5920.62,0
2032-09-15,20:33:00,Jiffy Lube,-47.7,Winter Park FL,32789,5872.92,0
2032-09-15,17:58:00,Lockheed Martin,-414.77,Groton CT,79430,5458.15,1
2032-09-16,10:00:00,Kroger,-60.85,Orlando FL,32816,5812.07,0
2032-09-17,08:23:00,Movie Theater,-32.27,Oviedo FL,32765,5779.8,0
2032-09-17,18:09:00,Exxon,-24.11,Orlando FL,32816,5755.69,0
2032-09-17,21:25:00,Amazon,-47.36,Oviedo FL,32765,5708.33,0
2032-09-18,15:26:00,Subway,-20.72,Winter Park FL,32789,5687.61,0
2032-09-21,18:40:00,BP,-28.8,Orlando FL,32816,5658.81,0
2032-09-21,19:16:00,McDonald's,-12.01,Orlando FL,32816,5646.8,0
2032-09-21,15:28:00,Subway,-15.44,Winter Park FL,32789,5631.36,0
2032-09-22,15:48:00,Best Buy,-82.86,Orlando FL,32816,5548.5,0
2032-09-22,17:02:00,Walgreens,-31.42,Winter Park FL,32789,5517.08,0
2032-09-22,04:46:00,Accelerators,-711.33,London EN,92380,4805.75,1
2032-09-22,13:54:00,Subway,-35.3,Winter Park FL,32789,5481.78,0
2032-09-23,18:11:00,Starbucks,-27.94,Orlando FL,32816,5453.84,0
2032-09-23,20:08:00,Starbucks,-29.69,Oviedo FL,32765,5424.15,0
2032-09-23,20:30:00,Publix,-32.38,Oviedo FL,32765,5391.77,0
2032-09-24,11:44:00,CVS,-7.15,Oviedo FL,32765,5384.62,0
2032-09-24,00:14:00,Onlyfans,-2534.32,Groton CT,69466,2850.3,1
2032-09-25,21:53:00,Walgreens,-25.18,Winter Park FL,32789,5359.44,0
2032-09-26,17:47:00,Subway,-22.16,Oviedo FL,32765,5337.28,0
2032-09-26,16:51:00,Netflix,-27.19,Winter Park FL,32789,5310.09,0
2032-09-26,11:24:00,Five Below,-28.66,Winter Park FL,32789,5281.43,0
2032-09-27,08:00:00,Paycheck,2000.0,Oviedo FL,32765,7281.43,0
2032-09-27,12:37:00,Publix,-175.16,Winter Park FL,32789,7106.27,0
2032-09-27,20:49:00,Burger King,-64.64,Orlando FL,32816,7041.63,0
2032-09-27,13:12:00,Starbucks,-56.66,Orlando FL,32816,6984.97,0
2032-09-28,12:25:00,Impractical Jokers,-1060.98,Pittsburgh PA,56393,5923.99,1
2032-09-29,10:54:00,BP,-37.28,Orlando FL,32816,6947.69,0
2032-09-29,21:16:00,Servicenow,-2480.37,Los Angeles CA,78794,4467.32,1
2032-09-30,14:31:00,Dollar Tree,-32.85,Oviedo FL,32765,6914.84,0
2032-09-30,03:12:00,Fraud,-2441.52,Groton CT,19117,4473.32,1
2032-09-30,19:29:00,Starbucks,-21.56,Orlando FL,32816,6893.28,0
2032-09-30,17:32:00,Walgreens,-46.84,Oviedo FL,32765,6846.44,0
2032-10-01,09:00:00,Rent,-960.0,Oviedo FL,32765,5886.44,0
2032-10-01,09:00:00,Insurance,-197.46,Oviedo FL,32765,5688.98,0
2032-10-01,09:00:00,Car,-300.0,Oviedo FL,32765,5388.98,0
2032-10-01,13:07:00,Walmart,-90.41,Orlando FL,32816,5298.57,0
2032-10-01,20:59:00,Burger King,-20.17,Orlando FL,32816,5278.4,0
2032-10-01,17:38:00,Dollar Tree,-5.66,Oviedo FL,32765,5272.74,0
2032-10-02,09:41:00,Fat Joe,-641.59,London EN,31386,4631.15,1
2032-10-02,19:44:00,Walgreens,-43.61,Oviedo FL,32765,5229.13,0
2032-10-02,15:39:00,Shell,-11.17,Orlando FL,32816,5217.96,0
2032-10-02,15:25:00,Concert Tickets,-25.2,Orlando FL,32816,5192.76,0
2032-10-03,14:50:00,Subway,-20.74,Oviedo FL,32765,5172.02,0
2032-10-03,20:44:00,Trader Joe's,-50.48,Oviedo FL,32765,5121.54,0
2032-10-04,17:51:00,Movie Theater,-47.76,Winter Park FL,32789,5073.78,0
2032-10-04,10:40:00,Dollar Tree,-29.94,Winter Park FL,32789,5043.84,0
2032-10-04,21:10:00,Kroger,-86.24,Winter Park FL,32789,4957.6,0
2032-10-05,21:14:00,Subway,-10.27,Orlando FL,32816,4947.33,0
2032-10-05,01:41:00,Pawn Stars,-646.18,Honolulu HI,47358,4301.15,1
2032-10-05,11:29:00,Best Buy,-37.66,Orlando FL,32816,4909.67,0
2032-10-05,18:42:00,Impractical Jokers,-869.26,Charleston SC,79628,4040.41,1
2032-10-05,13:07:00,Burger King,-35.79,Winter Park FL,32789,4873.88,0
2032-10-05,06:34:00,IBM,-2029.73,Los Angeles CA,22765,2844.15,1
2032-10-06,17:58:00,Walmart,-10.14,Oviedo FL,32765,4863.74,0
2032-10-06,12:02:00,Publix,-48.46,Orlando FL,32816,4815.28,0
2032-10-07,09:00:00,Spotify,-11.99,Oviedo FL,32765,4803.29,0
2032-10-07,09:00:00,Internet,-70.89,Oviedo FL,32765,4732.4,0
2032-10-07,09:00:00,ChatGPT Plus,-20.0,Oviedo FL,32765,4712.4,0
2032-10-07,00:03:00,Paypal,-140.75,Charleston SC,72741,4571.65,1
2032-10-07,14:04:00,Whole Foods,-31.5,Oviedo FL,32765,4680.9,0
2032-10-08,16:41:00,Burger King,-27.79,Orlando FL,32816,4653.11,0
2032-10-08,08:47:00,Starbucks,-7.24,Orlando FL,32816,4645.87,0
2032-10-08,18:40:00,Amusement Park,-15.12,Winter Park FL,32789,4630.75,0
2032-10-10,16:17:00,Chevron,-25.31,Oviedo FL,32765,4605.44,0
2032-10-11,08:00:00,Paycheck,2000.0,Oviedo FL,32765,6605.44,0
2032-10-12,10:22:00,Amazon,-179.39,Winter Park FL,32789,6426.05,0
2032-10-12,20:09:00,Pep Boys,-104.28,Winter Park FL,32789,6321.77,0
2032-10-12,08:12:00,Servicenow,-2340.1,London EN,71284,3981.67,1
2032-10-12,13:16:00,Target,-226.07,Orlando FL,32816,6095.7,0
2032-10-13,19:55:00,Trader Joe's,-166.72,Orlando FL,32816,5928.98,0
2032-10-13,10:43:00,Amusement Park,-20.08,Orlando FL,32816,5908.9,0
2032-10-13,13:57:00,Concert Tickets,-54.03,Orlando FL,32816,5854.87,0
2032-10-15,21:29:00,Starbucks,-6.49,Oviedo FL,32765,5848.38,0
2032-10-15,09:19:00,Paypal,-1955.24,London EN,26968,3893.14,1
2032-10-15,11:32:00,Whole Foods,-48.82,Oviedo FL,32765,5799.56,0
2032-10-15,19:50:00,Starbucks,-37.72,Oviedo FL,32765,5761.84,0
2032-10-16,09:29:00,Burger King,-34.76,Oviedo FL,32765,5727.08,0
2032-10-16,20:58:00,Best Buy,-37.36,Orlando FL,32816,5689.72,0
2032-10-16,11:52:00,Accelerators,-2303.32,New York NY,74434,3386.4,1
2032-10-18,18:13:00,Target,-36.21,Oviedo FL,32765,5653.51,0
2032-10-18,17:35:00,Burger King,-19.3,Winter Park FL,32789,5634.21,0
2032-10-19,09:07:00,Servicenow,-2732.45,Groton CT,43167,2901.76,1
2032-10-20,16:08:00,Kroger,-35.6,Winter Park FL,32789,5598.61,0
2032-10-20,09:21:00,IBM,-426.56,Groton CT,44519,5172.05,1
2032-10-21,12:53:00,McDonald's,-34.32,Winter Park FL,32789,5564.29,0
2032-10-21,10:58:00,Chevron,-12.96,Orlando FL,32816,5551.33,0
2032-10-21,19:19:00,Amazon,-113.18,Winter Park FL,32789,5438.15,0
2032-10-22,20:07:00,Midas,-54.05,Orlando FL,32816,5384.1,0
2032-10-23,16:07:00,Subway,-38.47,Orlando FL,32816,5345.63,0
2032-10-25,08:00:00,Paycheck,2000.0,Oviedo FL,32765,7345.63,0
2032-10-25,18:40:00,Pawn Stars,-955.65,Honolulu HI,65590,6389.98,1
2032-10-25,13:42:00,Concert Tickets,-90.18,Oviedo FL,32765,7255.45,0
2032-10-25,17:25:00,BP,-20.52,Oviedo FL,32765,7234.93,0
2032-10-25,21:50:00,Subway,-19.32,Winter Park FL,32789,7215.61,0
2032-10-27,18:08:00,Pep Boys,-83.02,Winter Park FL,32789,7132.59,0
2032-10-27,16:07:00,Publix,-74.26,Orlando FL,32816,7058.33,0
2032-10-28,15:24:00,Netflix,-67.59,Oviedo FL,32765,6990.74,0
2032-10-28,11:34:00,Best Buy,-185.27,Winter Park FL,32789,6805.47,0
2032-10-29,20:07:00,Best Buy,-93.34,Winter Park FL,32789,6712.13,0
2032-10-29,18:10:00,Whole Foods,-93.11,Winter Park FL,32789,6619.02,0
2032-10-30,15:42:00,Concert Tickets,-99.01,Winter Park FL,32789,6520.01,0
2032-10-30,09:14:00,Concert Tickets,-28.19,Winter Park FL,32789,6491.82,0
2032-10-31,12:29:00,Subway,-32.7,Winter Park FL,32789,6459.12,0
2032-10-31,11:14:00,Shell,-26.46,Winter Park FL,32789,6432.66,0
2032-11-01,09:00:00,Rent,-960.0,Oviedo FL,32765,5472.66,0
2032-11-01,09:00:00,Insurance,-197.46,Oviedo FL,32765,5275.2,0
2032-11-01,09:00:00,Car,-300.0,Oviedo FL,32765,4975.2,0
2032-11-01,21:04:00,Trader Joe's,-80.32,Orlando FL,32816,4894.88,0
2032-11-02,08:08:00,Amazon,-140.33,Winter Park FL,32789,4754.55,0
2032-11-02,12:13:00,Amazon,-44.79,Oviedo FL,32765,4709.76,0
2032-11-02,15:09:00,Shell,-10.92,Oviedo FL,32765,4698.84,0
2032-11-03,14:49:00,Shell,-13.63,Oviedo FL,32765,4685.21,0
2032-11-03,16:56:00,Servicenow,-1488.45,Mexico City MC,34183,3196.76,1
2032-11-03,19:51:00,Burger King,-29.12,Orlando FL,32816,4656.09,0
2032-11-03,11:01:00,Burger King,-9.67,Oviedo FL,32765,4646.42,0
2032-11-04,11:06:00,Best Buy,-42.54,Winter Park FL,32789,4603.88,0
2032-11-04,17:26:00,Chevron,-24.1,Oviedo FL,32765,4579.78,0
2032-11-04,12:31:00,Target,-137.66,Winter Park FL,32789,4442.12,0
2032-11-04,06:23:00,IBM,-2657.89,London EN,93808,1784.23,1
2032-11-06,13:36:00,Five Below,-42.42,Oviedo FL,32765,4399.7,0
2032-11-07,09:00:00,Spotify,-11.99,Oviedo FL,32765,4387.71,0
2032-11-07,09:00:00,Internet,-70.89,Oviedo FL,32765,4316.82,0
2032-11-07,09:00:00,ChatGPT Plus,-20.0,Oviedo FL,32765,4296.82,0
2032-11-08,08:00:00,Paycheck,2000.0,Oviedo FL,32765,6296.82,0
2032-11-09,03:50:00,Paypal,-2432.12,New York NY,35676,3864.7,1
2032-11-09,17:03:00,McDonald's,-73.83,Oviedo FL,32765,6222.99,0
2032-11-09,16:45:00,Target,-224.34,Oviedo FL,32765,5998.65,0
2032-11-10,12:24:00,Starbucks,-31.95,Orlando FL,32816,5966.7,0
2032-11-10,14:23:00,Dollar Tree,-27.58,Oviedo FL,32765,5939.12,0
2032-11-11,14:47:00,Dollar Tree,-35.93,Orlando FL,32816,5903.19,0
2032-11-11,11:30:00,Amazon,-127.74,Winter Park FL,32789,5775.45,0
2032-11-11,15:55:00,Dollar Tree,-9.73,Winter Park FL,32789,5765.72,0
2032-11-12,15:00:00,Whole Foods,-37.55,Oviedo FL,32765,5728.17,0
2032-11-12,13:59:00,Amazon,-22.33,Orlando FL,32816,5705.84,0
2032-11-12,10:04:00,McDonald's,-19.49,Winter Park FL,32789,5686.35,0
2032-11-14,12:02:00,AutoZone,-42.63,Oviedo FL,32765,5643.72,0
2032-11-14,16:26:00,Exxon,-14.98,Oviedo FL,32765,5628.74,0
2032-11-14,16:22:00,Amazon,-128.19,Oviedo FL,32765,5500.55,0
2032-11-15,21:59:00,Starbucks,-14.58,Winter Park FL,32789,5485.97,0
2032-11-16,10:20:00,Onlyfans,-374.99,Pittsburgh PA,81046,5110.98,1
2032-11-17,20:42:00,Walgreens,-21.71,Orlando FL,32816,5464.26,0
2032-11-17,09:51:00,Amazon,-92.13,Orlando FL,32816,5372.13,0
2032-11-18,10:01:00,BP,-18.08,Oviedo FL,32765,5354.05,0
2032-11-18,14:57:00,Amazon,-29.37,Orlando FL,32816,5324.68,0
2032-11-18,17:38:00,Target,-143.01,Oviedo FL,32765,5181.67,0
2032-11-19,17:45:00,Target,-57.99,Orlando FL,32816,5123.68,0
2032-11-19,12:34:00,BP,-18.93,Winter Park FL,32789,5104.75,0
2032-11-20,16:31:00,AutoZone,-100.12,Oviedo FL,32765,5004.63,0
2032-11-21,17:44:00,Dollar Tree,-43.49,Winter Park FL,32789,4961.14,0
2032-11-21,13:30:00,Subway,-8.41,Orlando FL,32816,4952.73,0
2032-11-21,16:32:00,Shell,-10.78,Orlando FL,32816,4941.95,0
2032-11-22,08:00:00,Paycheck,2000.0,Oviedo FL,32765,6941.95,0
2032-11-22,13:23:00,Subway,-67.1,Oviedo FL,32765,6874.85,0
2032-11-25,10:19:00,BP,-36.41,Winter Park FL,32789,6838.44,0
2032-11-27,08:10:00,Starbucks,-54.02,Orlando FL,32816,6784.42,0
2032-11-28,08:05:00,Walmart,-100.56,Oviedo FL,32765,6683.86,0
2032-11-28,21:12:00,Midas,-366.63,Oviedo FL,32765,6317.23,0
2032-11-30,09:05:00,Monster Energy,-1875.61,New York NY,17975,4441.62,1
2032-12-01,09:00:00,Rent,-960.0,Oviedo FL,32765,5357.23,0
2032-12-01,09:00:00,Insurance,-197.46,Oviedo FL,32765,5159.77,0
2032-12-01,09:00:00,Car,-300.0,Oviedo FL,32765,4859.77,0
2032-12-01,08:16:00,Walmart,-86.06,Winter Park FL,32789,4773.71,0
2032-12-01,12:48:00,Walmart,-106.8,Winter Park FL,32789,4666.91,0
2032-12-02,17:19:00,Burger King,-17.51,Orlando FL,32816,4649.4,0
2032-12-02,12:17:00,Five Below,-15.9,Oviedo FL,32765,4633.5,0
2032-12-02,08:57:00,Burger King,-15.9,Oviedo FL,32765,4617.6,0
2032-12-03,11:53:00,Best Buy,-146.21,Oviedo FL,32765,4471.39,0
2032-12-03,14:56:00,Magic the Gathering,-947.7,Pyongyang NK,94875,3523.69,1
2032-12-04,19:53:00,Paypal,-927.54,Mexico City MC,96250,3543.85,1
2032-12-05,12:12:00,Movie Theater,-46.74,Oviedo FL,32765,4424.65,0
2032-12-05,09:22:00,Five Below,-42.2,Orlando FL,32816,4382.45,0
2032-12-05,21:51:00,Accelerators,-1527.9,London EN,39435,2854.55,1
2032-12-05,13:55:00,Pep Boys,-193.46,Oviedo FL,32765,4188.99,0
2032-12-06,08:00:00,Paycheck,2000.0,Oviedo FL,32765,6188.99,0
2032-12-06,12:06:00,Concert Tickets,-62.66,Orlando FL,32816,6126.33,0
2032-12-06,20:32:00,Walmart,-108.9,Winter Park FL,32789,6017.43,0
2032-12-06,09:49:00,Concert Tickets,-100.92,Winter Park FL,32789,5916.51,0
2032-12-07,09:00:00,Spotify,-11.99,Oviedo FL,32765,5904.52,0
2032-12-07,09:00:00,Internet,-70.89,Oviedo FL,32765,5833.63,0
2032-12-07,09:00:00,ChatGPT Plus,-20.0,Oviedo FL,32765,5813.63,0
2032-12-08,21:30:00,Amazon,-62.74,Oviedo FL,32765,5750.89,0
2032-12-08,12:59:00,Target,-66.04,Orlando FL,32816,5684.85,0
2032-12-10,11:01:00,McDonald's,-36.53,Oviedo FL,32765,5648.32,0
2032-12-10,12:18:00,Burger King,-37.76,Oviedo FL,32765,5610.56,0
2032-12-10,15:18:00,McDonald's,-31.3,Orlando FL,32816,5579.26,0
2032-12-11,09:11:00,McDonald's,-8.14,Oviedo FL,32765,5571.12,0
2032-12-12,19:36:00,Burger King,-26.19,Orlando FL,32816,5544.93,0
2032-12-14,09:21:00,Exxon,-16.09,Orlando FL,32816,5528.84,0
2032-12-14,13:06:00,Lockheed Martin,-607.38,Pyongyang NK,26065,4921.46,1
2032-12-14,09:41:00,Amazon,-66.56,Orlando FL,32816,5462.28,0
2032-12-14,17:08:00,Lockheed Martin,-2637.09,Tokyo JP,45791,2825.19,1
2032-12-15,14:39:00,Netflix,-18.3,Oviedo FL,32765,5443.98,0
2032-12-15,04:03:00,Fraud,-2903.77,Anchorage AL,78829,2540.21,1
2032-12-18,13:30:00,Whole Foods,-42.53,Oviedo FL,32765,5401.45,0
2032-12-19,18:07:00,Burger King,-29.31,Oviedo FL,32765,5372.14,0
2032-12-20,08:00:00,Paycheck,2000.0,Oviedo FL,32765,7372.14,0
2032-12-20,17:39:00,Dollar Tree,-87.72,Winter Park FL,32789,7284.42,0
2032-12-20,14:53:00,Amazon,-159.11,Winter Park FL,32789,7125.31,0
2032-12-21,13:40:00,Shell,-58.6,Orlando FL,32816,7066.71,0
2032-12-21,00:45:00,Accelerators,-1803.12,Los Angeles CA,96444,5263.59,1
2032-12-22,23:52:00,Servicenow,-2685.75,Mexico City MC,47941,4380.96,1
2032-12-22,21:51:00,Target,-293.72,Orlando FL,32816,6772.99,0
2032-12-22,17:34:00,Magic the Gathering,-1141.37,Pittsburgh PA,37239,5631.62,1
2032-12-22,15:29:00,Midas,-170.79,Orlando FL,32816,6602.2,0
2032-12-23,21:09:00,Accelerators,-2421.68,Tokyo JP,61278,4180.52,1
2032-12-24,20:05:00,Amusement Park,-95.39,Orlando FL,32816,6506.81,0
2032-12-25,14:47:00,Concert Tickets,-45.09,Orlando FL,32816,6461.72,0
2032-12-25,17:10:00,Kroger,-117.46,Winter Park FL,32789,6344.26,0
2032-12-28,14:52:00,Exxon,-48.0,Orlando FL,32816,6296.26,0
2032-12-28,19:32:00,CVS,-73.61,Winter Park FL,32789,6222.65,0
2032-12-29,21:26:00,Exxon,-26.58,Winter Park FL,32789,6196.07,0
2032-12-29,20:27:00,Walgreens,-20.03,Oviedo FL,32765,6176.04,0
2032-12-30,11:58:00,Pawn Stars,-188.25,Charleston SC,26094,5987.79,1
2032-12-30,09:54:00,Concert Tickets,-75.74,Orlando FL,32816,6100.3,0
2032-12-30,14:59:00,McDonald's,-26.38,Orlando FL,32816,6073.92,0
2032-12-31,20:29:00,Burger King,-13.44,Oviedo FL,32765,6060.48,0
2032-12-31,13:35:00,Whole Foods,-183.91,Winter Park FL,32789,5876.57,0
2032-12-31,08:36:00,Shell,-13.91,Winter Park FL,32789,5862.66,0
2033-01-01,09:00:00,Rent,-960.0,Oviedo FL,32765,4902.66,0
2033-01-01,09:00:00,Insurance,-197.46,Oviedo FL,32765,4705.2,0
2033-01-01,09:00:00,Car,-300.0,Oviedo FL,32765,4405.2,0
2033-01-01,13:33:00,Midas,-53.99,Orlando FL,32816,4351.21,0
2033-01-02,10:39:00,Fat Joe,-1507.37,Anchorage AL,29155,2843.84,1
2033-01-03,08:00:00,Paycheck,2000.0,Oviedo FL,32765,6351.21,0
2033-01-03,20:49:00,Subway,-68.56,Orlando FL,32816,6282.65,0
2033-01-04,12:04:00,Amazon,-28.09,Winter Park FL,32789,6254.56,0
2033-01-05,18:59:00,IBM,-2641.6,Groton CT,26372,3612.96,1
2033-01-05,18:08:00,Starbucks,-26.48,Oviedo FL,32765,6228.08,0
2033-01-05,18:03:00,Starbucks,-57.88,Orlando FL,32816,6170.2,0
2033-01-06,17:55:00,Target,-202.84,Winter Park FL,32789,5967.36,0
2033-01-06,17:30:00,McDonald's,-5.56,Oviedo FL,32765,5961.8,0
2033-01-07,09:00:00,Spotify,-11.99,Oviedo FL,32765,5949.81,0
2033-01-07,09:00:00,Internet,-70.89,Oviedo FL,32765,5878.92,0
2033-01-07,09:00:00,ChatGPT Plus,-20.0,Oviedo FL,32765,5858.92,0
2033-01-07,12:15:00,Best Buy,-74.75,Orlando FL,32816,5784.17,0
2033-01-07,08:27:00,Whole Foods,-93.48,Orlando FL,32816,5690.69,0
2033-01-07,08:06:00,Subway,-21.87,Oviedo FL,32765,5668.82,0
2033-01-08,16:59:00,Target,-23.79,Orlando FL,32816,5645.03,0
2033-01-08,13:11:00,Best Buy,-93.57,Orlando FL,32816,5551.46,0
2033-01-08,16:17:00,CVS,-48.69,Oviedo FL,32765,5502.77,0
2033-01-09,13:34:00,McDonald's,-30.9,Orlando FL,32816,5471.87,0
2033-01-09,21:53:00,Movie Theater,-51.92,Orlando FL,32816,5419.95,0
2033-01-09,13:07:00,Burger King,-24.46,Oviedo FL,32765,5395.49,0
2033-01-11,14:31:00,Fraud,-735.95,New York NY,73836,4659.54,1
2033-01-11,19:41:00,Starbucks,-30.28,Orlando FL,32816,5365.21,0
2033-01-11,20:25:00,McDonald's,-17.78,Orlando FL,32816,5347.43,0
2033-01-11,02:22:00,Pawn Stars,-239.73,Charleston SC,90455,5107.7,1
2033-01-12,11:26:00,Chevron,-13.65,Orlando FL,32816,5333.78,0
2033-01-12,15:22:00,CVS,-24.95,Winter Park FL,32789,5308.83,0
2033-01-12,15:54:00,CVS,-6.79,Oviedo FL,32765,5302.04,0
2033-01-13,08:03:00,Walmart,-13.45,Oviedo FL,32765,5288.59,0
2033-01-13,14:26:00,Best Buy,-33.76,Winter Park FL,32789,5254.83,0
2033-01-13,07:25:00,IBM,-510.38,New York NY,26423,4744.45,1
2033-01-14,11:26:00,Kroger,-78.28,Oviedo FL,32765,5176.55,0
2033-01-15,13:38:00,Subway,-28.47,Orlando FL,32816,5148.08,0
2033-01-16,08:52:00,Subway,-6.92,Orlando FL,32816,5141.16,0
2033-01-17,08:00:00,Paycheck,2000.0,Oviedo FL,32765,7141.16,0
2033-01-17,11:40:00,Shell,-49.5,Orlando FL,32816,7091.66,0
2033-01-17,14:45:00,Burger King,-60.47,Oviedo FL,32765,7031.19,0
2033-01-17,14:27:00,Exxon,-26.75,Winter Park FL,32789,7004.44,0
2033-01-18,20:35:00,Burger King,-15.13,Orlando FL,32816,6989.31,0
2033-01-18,16:46:00,Monster Energy,-2103.98,Pittsburgh PA,41200,4885.33,1
2033-01-18,11:30:00,BP,-35.74,Oviedo FL,32765,6953.57,0
2033-01-18,01:45:00,Paypal,-2706.09,New York NY,42450,4247.48,1
2033-01-18,17:09:00,Shell,-24.35,Oviedo FL,32765,6929.22,0
2033-01-19,20:57:00,Pawn Stars,-1200.93,Pittsburgh PA,45909,5728.29,1
2033-01-21,19:12:00,Subway,-39.05,Orlando FL,32816,6890.17,0
2033-01-21,09:24:00,Five Below,-92.85,Oviedo FL,32765,6797.32,0
2033-01-21,18:48:00,Amusement Park,-79.59,Winter Park FL,32789,6717.73,0
2033-01-22,20:41:00,Chevron,-39.58,Winter Park FL,32789,6678.15,0
2033-01-22,22:09:00,Servicenow,-1127.05,New York NY,73791,5551.1,1
2033-01-22,14:15:00,CVS,-91.55,Orlando FL,32816,6586.6,0
2033-01-23,11:14:00,Whole Foods,-173.1,Winter Park FL,32789,6413.5,0
2033-01-24,14:47:00,Burger King,-44.42,Winter Park FL,32789,6369.08,0
2033-01-24,16:26:00,Dollar Tree,-65.55,Winter Park FL,32789,6303.53,0
2033-01-25,16:13:00,Amazon,-146.81,Oviedo FL,32765,6156.72,0
2033-01-25,11:14:00,Concert Tickets,-31.46,Orlando FL,32816,6125.26,0
2033-01-25,10:16:00,Lockheed Martin,-2049.01,Charleston SC,38966,4076.25,1
2033-01-25,18:05:00,Shell,-31.36,Winter Park FL,32789,6093.9,0
2033-01-26,17:09:00,Netflix,-57.68,Winter Park FL,32789,6036.22,0
2033-01-26,15:41:00,Kroger,-142.15,Orlando FL,32816,5894.07,0
2033-01-26,12:41:00,Whole Foods,-79.46,Winter Park FL,32789,5814.61,0
2033-01-28,16:59:00,Servicenow,-856.46,New York NY,40249,4958.15,1
2033-01-28,20:52:00,Concert Tickets,-11.1,Winter Park FL,32789,5803.51,0
2033-01-29,11:08:00,Trader Joe's,-32.07,Orlando FL,32816,5771.44,0
2033-01-29,19:21:00,Fat Joe,-2910.76,Groton CT,52599,2860.68,1
2033-01-29,11:46:00,AutoZone,-157.78,Winter Park FL,32789,5613.66,0
2033-01-29,10:42:00,Target,-106.86,Winter Park FL,32789,5506.8,0
2033-01-30,17:20:00,Burger King,-17.63,Orlando FL,32816,5489.17,0
2033-01-30,15:21:00,Movie Theater,-15.38,Winter Park FL,32789,5473.79,0
2033-01-30,09:24:00,Chevron,-21.23,Winter Park FL,32789,5452.56,0
2033-01-31,08:00:00,Paycheck,2000.0,Oviedo FL,32765,7452.56,0
2033-01-31,08:35:00,Best Buy,-139.22,Orlando FL,32816,7313.34,0
2033-01-31,21:52:00,Pep Boys,-141.09,Winter Park FL,32789,7172.25,0
2033-02-01,09:00:00,Rent,-960.0,Oviedo FL,32765,6212.25,0
2033-02-01,09:00:00,Insurance,-197.46,Oviedo FL,32765,6014.79,0
2033-02-01,09:00:00,Car,-300.0,Oviedo FL,32765,5714.79,0
2033-02-02,11:17:00,Walmart,-149.69,Winter Park FL,32789,5565.1,0
2033-02-03,11:39:00,Walgreens,-32.99,Winter Park FL,32789,5532.11,0
2033-02-03,19:08:00,Trader Joe's,-57.72,Orlando FL,32816,5474.39,0
2033-02-03,13:57:00,McDonald's,-7.65,Oviedo FL,32765,5466.74,0
2033-02-05,18:20:00,Exxon,-27.52,Winter Park FL,32789,5439.22,0
2033-02-06,11:35:00,Kroger,-93.65,Orlando FL,32816,5345.57,0
2033-02-06,13:06:00,Burger King,-23.91,Oviedo FL,32765,5321.66,0
2033-02-07,09:00:00,Spotify,-11.99,Oviedo FL,32765,5309.67,0
2033-02-07,09:00:00,Internet,-70.89,Oviedo FL,32765,5238.78,0
2033-02-07,09:00:00,ChatGPT Plus,-20.0,Oviedo FL,32765,5218.78,0
2033-02-07,13:52:00,Target,-115.52,Orlando FL,32816,5103.26,0
2033-02-07,19:01:00,Subway,-10.25,Winter Park FL,32789,5093.01,0
2033-02-07,13:49:00,Fat Joe,-1468.33,Pittsburgh PA,15341,3624.68,1
2033-02-07,10:51:00,Starbucks,-13.67,Winter Park FL,32789,5079.34,0
2033-02-10,13:56:00,Burger King,-12.89,Orlando FL,32816,5066.45,0
2033-02-12,12:57:00,Exxon,-24.29,Orlando FL,32816,5042.16,0
2033-02-13,18:31:00,McDonald's,-22.42,Winter Park FL,32789,5019.74,0
2033-02-14,08:00:00,Paycheck,2000.0,Oviedo FL,32765,7019.74,0
2033-02-14,18:53:00,Concert Tickets,-53.9,Orlando FL,32816,6965.84,0
2033-02-14,09:29:00,Burger King,-70.9,Orlando FL,32816,6894.94,0
2033-02-14,11:37:00,Starbucks,-28.05,Oviedo FL,32765,6866.89,0
2033-02-15,17:21:00,Monster Energy,-1555.8,Honolulu HI,87615,5311.09,1
2033-02-15,17:28:00,CVS,-82.31,Oviedo FL,32765,6784.58,0
2033-02-16,19:27:00,Burger King,-63.68,Winter Park FL,32789,6720.9,0
2033-02-16,12:49:00,McDonald's,-25.59,Oviedo FL,32765,6695.31,0
2033-02-16,13:13:00,Walgreens,-58.64,Oviedo FL,32765,6636.67,0
2033-02-17,19:20:00,Walmart,-273.64,Oviedo FL,32765,6363.03,0
2033-02-17,11:57:00,Burger King,-45.66,Orlando FL,32816,6317.37,0
2033-02-18,12:02:00,Burger King,-55.22,Winter Park FL,32789,6262.15,0
2033-02-18,15:47:00,Starbucks,-19.14,Orlando FL,32816,6243.01,0
2033-02-18,20:36:00,Burger King,-23.41,Orlando FL,32816,6219.6,0
2033-02-19,17:39:00,Chevron,-53.49,Oviedo FL,32765,6166.11,0
2033-02-19,18:30:00,Target,-159.13,Winter Park FL,32789,6006.98,0
2033-02-20,21:35:00,Midas,-201.27,Winter Park FL,32789,5805.71,0
2033-02-22,20:29:00,Starbucks,-38.1,Oviedo FL,32765,5767.61,0
2033-02-23,09:08:00,Subway,-8.99,Oviedo FL,32765,5758.62,0
2033-02-23,19:56:00,Exxon,-19.19,Winter Park FL,32789,5739.43,0
2033-02-23,06:17:00,Monster Energy,-1027.87,Mexico City MC,82894,4711.56,1
2033-02-25,14:32:00,McDonald's,-13.13,Winter Park FL,32789,5726.3,0
2033-02-25,12:58:00,McDonald's,-27.39,Oviedo FL,32765,5698.91,0
2033-02-25,09:52:00,Starbucks,-34.0,Orlando FL,32816,5664.91,0
2033-02-26,14:50:00,Walmart,-20.39,Orlando FL,32816,5644.52,0
2033-02-26,18:10:00,Amazon,-132.24,Orlando FL,32816,5512.28,0
2033-02-27,09:24:00,Trader Joe's,-89.63,Oviedo FL,32765,5422.65,0
2033-02-27,11:48:00,Chevron,-13.69,Winter Park FL,32789,5408.96,0
2033-02-28,08:00:00,Paycheck,2000.0,Oviedo FL,32765,7408.96,0
2033-02-28,21:45:00,Amusement Park,-73.02,Winter Park FL,32789,7335.94,0
2033-02-28,02:46:00,Pawn Stars,-2630.87,Pyongyang NK,77038,4705.07,1
2033-02-28,09:17:00,Burger King,-44.66,Orlando FL,32816,7291.28,0
2033-02-28,10:41:00,CVS,-24.2,Winter Park FL,32789,7267.08,0
2033-03-01,09:00:00,Rent,-960.0,Oviedo FL,32765,6307.08,0
2033-03-01,09:00:00,Insurance,-197.46,Oviedo FL,32765,6109.62,0
2033-03-01,09:00:00,Car,-300.0,Oviedo FL,32765,5809.62,0
2033-03-01,20:57:00,Jiffy Lube,-77.37,Orlando FL,32816,5732.25,0
2033-03-02,20:12:00,Trader Joe's,-63.91,Orlando FL,32816,5668.34,0
2033-03-02,17:11:00,Subway,-9.37,Oviedo FL,32765,5658.97,0
2033-03-02,16:57:00,Walgreens,-31.94,Winter Park FL,32789,5627.03,0
2033-03-03,09:46:00,Subway,-30.59,Winter Park FL,32789,5596.44,0
2033-03-03,12:35:00,Dollar Tree,-32.45,Oviedo FL,32765,5563.99,0
2033-03-03,10:04:00,Walmart,-100.58,Winter Park FL,32789,5463.41,0
2033-03-04,20:10:00,Walgreens,-17.99,Winter Park FL,32789,5445.42,0
2033-03-04,19:38:00,Exxon,-17.72,Winter Park FL,32789,5427.7,0
2033-03-05,08:45:00,Best Buy,-18.28,Oviedo FL,32765,5409.42,0
2033-03-07,09:00:00,Spotify,-11.99,Oviedo FL,32765,5397.43,0
2033-03-07,09:00:00,Internet,-70.89,Oviedo FL,32765,5326.54,0
2033-03-07,09:00:00,ChatGPT Plus,-20.0,Oviedo FL,32765,5306.54,0
2033-03-07,15:50:00,Kroger,-72.13,Oviedo FL,32765,5234.41,0
2033-03-07,20:40:00,Fraud,-1945.72,Groton CT,34868,3288.69,1
2033-03-07,20:03:00,Subway,-24.62,Oviedo FL,32765,5209.79,0
2033-03-09,05:55:00,Accelerators,-1903.27,Anchorage AL,96980,3306.52,1
2033-03-09,18:19:00,Whole Foods,-79.59,Orlando FL,32816,5130.2,0
2033-03-10,19:02:00,McDonald's,-23.17,Winter Park FL,32789,5107.03,0
2033-03-14,08:00:00,Paycheck,2000.0,Oviedo FL,32765,7107.03,0
2033-03-14,13:32:00,Netflix,-56.42,Orlando FL,32816,7050.61,0
2033-03-14,09:08:00,Burger King,-26.91,Orlando FL,32816,7023.7,0
2033-03-15,11:25:00,McDonald's,-45.58,Winter Park FL,32789,6978.12,0
2033-03-15,15:01:00,Whole Foods,-145.36,Winter Park FL,32789,6832.76,0
2033-03-16,18:11:00,Best Buy,-213.01,Oviedo FL,32765,6619.75,0
2033-03-17,16:41:00,Publix,-130.23,Winter Park FL,32789,6489.52,0
2033-03-17,04:49:00,Fat Joe,-386.95,Pittsburgh PA,14556,6102.57,1
2033-03-17,18:12:00,Burger King,-37.99,Orlando FL,32816,6451.53,0
2033-03-18,08:57:00,Amusement Park,-54.71,Oviedo FL,32765,6396.82,0
2033-03-19,21:44:00,Chevron,-34.64,Orlando FL,32816,6362.18,0
2033-03-19,13:34:00,Target,-129.82,Winter Park FL,32789,6232.36,0
2033-03-19,16:13:00,Walmart,-114.77,Winter Park FL,32789,6117.59,0
2033-03-21,09:48:00,Pep Boys,-340.33,Oviedo FL,32765,5777.26,0
2033-03-21,16:03:00,Netflix,-48.05,Oviedo FL,32765,5729.21,0
2033-03-21,13:48:00,Burger King,-13.68,Orlando FL,32816,5715.53,0
2033-03-22,04:03:00,Servicenow,-1410.37,New York NY,48149,4305.16,1
2033-03-23,08:46:00,Walmart,-113.23,Orlando FL,32816,5602.3,0
2033-03-24,14:06:00,Starbucks,-32.0,Orlando FL,32816,5570.3,0
2033-03-24,14:03:00,Walmart,-25.45,Orlando FL,32816,5544.85,0
2033-03-24,18:35:00,Starbucks,-30.18,Oviedo FL,32765,5514.67,0
2033-03-26,15:48:00,IBM,-1834.89,Charleston SC,79607,3679.78,1
2033-03-26,12:30:00,Subway,-39.91,Oviedo FL,32765,5474.76,0
2033-03-27,14:09:00,Subway,-24.06,Orlando FL,32816,5450.7,0
2033-03-27,12:32:00,Exxon,-20.14,Oviedo FL,32765,5430.56,0
2033-03-27,19:06:00,Whole Foods,-97.7,Winter Park FL,32789,5332.86,0
2033-03-28,08:00:00,Paycheck,2000.0,Oviedo FL,32765,7332.86,0
2033-03-29,14:13:00,Accelerators,-2086.9,London EN,44287,5245.96,1
2033-03-29,10:27:00,Midas,-247.1,Winter Park FL,32789,7085.76,0
2033-03-29,12:57:00,Walmart,-215.8,Orlando FL,32816,6869.96,0
2033-03-31,10:17:00,Walmart,-198.81,Orlando FL,32816,6671.15,0
2033-04-01,09:00:00,Rent,-960.0,Oviedo FL,32765,5711.15,0
2033-04-01,09:00:00,Insurance,-197.46,Oviedo FL,32765,5513.69,0
2033-04-01,09:00:00,Car,-300.0,Oviedo FL,32765,5213.69,0
2033-04-01,08:27:00,Subway,-34.0,Oviedo FL,32765,5179.69,0
2033-04-02,08:47:00,Chevron,-18.67,Winter Park FL,32789,5161.02,0
2033-04-03,13:43:00,McDonald's,-39.6,Winter Park FL,32789,5121.42,0
2033-04-04,08:47:00,Chevron,-29.36,Orlando FL,32816,5092.06,0
2033-04-06,18:17:00,McDonald's,-10.06,Orlando FL,32816,5082.0,0
2033-04-07,09:00:00,Spotify,-11.99,Oviedo FL,32765,5070.01,0
2033-04-07,09:00:00,Internet,-70.89,Oviedo FL,32765,4999.12,0
2033-04-07,09:00:00,ChatGPT Plus,-20.0,Oviedo FL,32765,4979.12,0
2033-04-07,15:58:00,McDonald's,-25.19,Oviedo FL,32765,4953.93,0
2033-04-07,18:29:00,Fraud,-113.77,London EN,15842,4840.16,1
2033-04-07,08:19:00,Walgreens,-12.77,Winter Park FL,32789,4941.16,0
2033-04-08,10:43:00,Subway,-22.73,Oviedo FL,32765,4918.43,0
2033-04-08,23:38:00,Fraud,-803.84,Charleston SC,54974,4114.59,1
2033-04-08,10:54:00,Dollar Tree,-29.95,Orlando FL,32816,4888.48,0
2033-04-08,08:37:00,Midas,-86.94,Oviedo FL,32765,4801.54,0
2033-04-09,16:44:00,Whole Foods,-32.53,Winter Park FL,32789,4769.01,0
2033-04-11,08:00:00,Paycheck,2000.0,Oviedo FL,32765,6769.01,0
2033-04-12,14:36:00,Publix,-108.92,Winter Park FL,32789,6660.09,0
2033-04-12,20:50:00,Concert Tickets,-46.82,Oviedo FL,32765,6613.27,0
2033-04-13,10:05:00,Whole Foods,-152.09,Orlando FL,32816,6461.18,0
2033-04-14,08:55:00,McDonald's,-35.21,Oviedo FL,32765,6425.97,0
2033-04-16,19:42:00,Impractical Jokers,-852.89,Pyongyang NK,53641,5573.08,1
2033-04-16,15:40:00,Walmart,-291.36,Orlando FL,32816,6134.61,0
2033-04-18,02:32:00,IBM,-2197.78,Los Angeles CA,99181,3936.83,1
2033-04-19,13:14:00,Starbucks,-72.0,Oviedo FL,32765,6062.61,0
2033-04-19,20:09:00,Trader Joe's,-72.92,Oviedo FL,32765,5989.69,0
2033-04-22,21:44:00,IBM,-2877.92,London EN,75416,3111.77,1
2033-04-23,18:25:00,Target,-92.68,Oviedo FL,32765,5897.01,0
2033-04-23,16:16:00,Walgreens,-23.55,Oviedo FL,32765,5873.46,0
2033-04-23,20:02:00,Subway,-14.46,Orlando FL,32816,5859.0,0
2033-04-24,14:04:00,Starbucks,-18.12,Winter Park FL,32789,5840.88,0
2033-04-24,10:27:00,Target,-116.05,Winter Park FL,32789,5724.83,0
2033-04-25,08:00:00,Paycheck,2000.0,Oviedo FL,32765,7724.83,0
2033-04-25,17:45:00,Burger King,-48.39,Oviedo FL,32765,7676.44,0
2033-04-25,09:08:00,McDonald's,-74.48,Oviedo FL,32765,7601.96,0
2033-04-26,15:40:00,Chevron,-29.49,Winter Park FL,32789,7572.47,0
2033-04-27,20:37:00,BP,-49.34,Oviedo FL,32765,7523.13,0
2033-04-27,08:23:00,McDonald's,-34.9,Orlando FL,32816,7488.23,0
2033-04-27,20:48:00,Impractical Jokers,-309.93,Mexico City MC,21194,7178.3,1
2033-04-27,14:44:00,AutoZone,-193.55,Winter Park FL,32789,7294.68,0
2033-04-29,14:42:00,CVS,-85.53,Oviedo FL,32765,7209.15,0
2033-04-30,12:04:00,Walmart,-35.39,Orlando FL,32816,7173.76,0
2033-04-30,17:47:00,Magic the Gathering,-245.6,Mexico City MC,88707,6928.16,1
2033-04-30,19:05:00,CVS,-78.79,Winter Park FL,32789,7094.97,0
2033-05-01,09:00:00,Rent,-960.0,Oviedo FL,32765,6134.97,0
2033-05-01,09:00:00,Insurance,-197.46,Oviedo FL,32765,5937.51,0
2033-05-01,09:00:00,Car,-300.0,Oviedo FL,32765,5637.51,0
2033-05-01,09:08:00,Concert Tickets,-29.43,Winter Park FL,32789,5608.08,0
2033-05-01,16:01:00,Subway,-35.5,Oviedo FL,32765,5572.58,0
2033-05-02,19:50:00,Starbucks,-39.09,Orlando FL,32816,5533.49,0
2033-05-02,14:33:00,Burger King,-18.5,Winter Park FL,32789,5514.99,0
2033-05-03,14:27:00,Fraud,-2968.76,Los Angeles CA,98854,2546.23,1
2033-05-03,08:15:00,Shell,-18.94,Winter Park FL,32789,5496.05,0
2033-05-03,10:26:00,Movie Theater,-47.3,Oviedo FL,32765,5448.75,0
2033-05-03,08:23:00,Whole Foods,-54.74,Orlando FL,32816,5394.01,0
2033-05-06,14:37:00,Movie Theater,-29.47,Oviedo FL,32765,5364.54,0
2033-05-06,18:36:00,Publix,-34.64,Winter Park FL,32789,5329.9,0
2033-05-06,17:20:00,Whole Foods,-83.5,Oviedo FL,32765,5246.4,0
2033-05-07,09:00:00,Spotify,-11.99,Oviedo FL,32765,5234.41,0
2033-05-07,09:00:00,Internet,-70.89,Oviedo FL,32765,5163.52,0
2033-05-07,09:00:00,ChatGPT Plus,-20.0,Oviedo FL,32765,5143.52,0
2033-05-07,14:54:00,Kroger,-93.26,Orlando FL,32816,5050.26,0
2033-05-07,17:09:00,Trader Joe's,-55.06,Winter Park FL,32789,4995.2,0
2033-05-08,17:27:00,Shell,-13.22,Orlando FL,32816,4981.98,0
2033-05-08,18:57:00,Whole Foods,-59.54,Winter Park FL,32789,4922.44,0
2033-05-09,08:00:00,Paycheck,2000.0,Oviedo FL,32765,6922.44,0
2033-05-10,11:07:00,McDonald's,-48.12,Winter Park FL,32789,6874.32,0
2033-05-10,12:00:00,Subway,-72.12,Winter Park FL,32789,6802.2,0
2033-05-10,13:39:00,Kroger,-162.51,Winter Park FL,32789,6639.69,0
2033-05-10,19:11:00,Onlyfans,-1998.81,Los Angeles CA,15467,4640.88,1
2033-05-12,12:51:00,Subway,-17.98,Winter Park FL,32789,6621.71,0
2033-05-12,14:51:00,Best Buy,-183.66,Winter Park FL,32789,6438.05,0
2033-05-13,16:17:00,Target,-179.19,Oviedo FL,32765,6258.86,0
2033-05-13,20:31:00,Best Buy,-188.12,Orlando FL,32816,6070.74,0
2033-05-14,19:13:00,Trader Joe's,-99.93,Oviedo FL,32765,5970.81,0
2033-05-14,16:37:00,Subway,-33.43,Oviedo FL,32765,5937.38,0
2033-05-14,08:35:00,Dollar Tree,-34.56,Winter Park FL,32789,5902.82,0
2033-05-15,21:05:00,Starbucks,-16.42,Oviedo FL,32765,5886.4,0
2033-05-17,19:19:00,Subway,-15.58,Orlando FL,32816,5870.82,0
2033-05-18,09:21:00,Publix,-97.7,Orlando FL,32816,5773.12,0
2033-05-18,10:10:00,McDonald's,-15.2,Oviedo FL,32765,5757.92,0
2033-05-18,10:04:00,Burger King,-35.12,Oviedo FL,32765,5722.8,0
2033-05-19,13:58:00,Burger King,-18.58,Winter Park FL,32789,5704.22,0
2033-05-20,10:56:00,Dollar Tree,-11.08,Orlando FL,32816,5693.14,0
2033-05-21,09:49:00,Starbucks,-39.51,Orlando FL,32816,5653.63,0
2033-05-22,09:29:00,Whole Foods,-57.97,Winter Park FL,32789,5595.66,0
2033-05-22,14:53:00,Jiffy Lube,-168.6,Winter Park FL,32789,5427.06,0
2033-05-23,08:00:00,Paycheck,2000.0,Oviedo FL,32765,7427.06,0
2033-05-23,19:00:00,Amusement Park,-113.51,Oviedo FL,32765,7313.55,0
2033-05-23,08:07:00,Amazon,-22.19,Oviedo FL,32765,7291.36,0
2033-05-23,08:04:00,Trader Joe's,-66.3,Oviedo FL,32765,7225.06,0
2033-05-24,20:26:00,Starbucks,-51.46,Oviedo FL,32765,7173.6,0
2033-05-24,20:28:00,Five Below,-11.84,Orlando FL,32816,7161.76,0
2033-05-25,19:58:00,Netflix,-116.46,Orlando FL,32816,7045.3,0
2033-05-26,20:48:00,Starbucks,-60.65,Oviedo FL,32765,6984.65,0
2033-05-26,11:49:00,Servicenow,-1868.72,Los Angeles CA,94549,5115.93,1
2033-05-27,12:56:00,Movie Theater,-82.6,Orlando FL,32816,6902.05,0
2033-05-27,20:32:00,Walmart,-149.23,Oviedo FL,32765,6752.82,0
2033-05-27,08:26:00,Trader Joe's,-180.35,Winter Park FL,32789,6572.47,0
2033-05-28,08:17:00,McDonald's,-73.18,Orlando FL,32816,6499.29,0
2033-05-28,20:02:00,Amusement Park,-52.92,Oviedo FL,32765,6446.37,0
2033-05-28,20:19:00,Servicenow,-652.33,Mexico City MC,58064,5794.04,1
2033-05-29,11:12:00,Netflix,-70.45,Oviedo FL,32765,6375.92,0
2033-05-29,17:48:00,Trader Joe's,-133.02,Orlando FL,32816,6242.9,0
2033-05-30,12:49:00,Chevron,-54.73,Oviedo FL,32765,6188.17,0
2033-05-30,14:25:00,Best Buy,-156.96,Oviedo FL,32765,6031.21,0
2033-05-30,20:45:00,Kroger,-126.83,Oviedo FL,32765,5904.38,0
2033-05-31,19:48:00,Publix,-85.18,Oviedo FL,32765,5819.2,0
2033-05-31,20:26:00,Starbucks,-7.42,Winter Park FL,32789,5811.78,0
2033-05-31,20:35:00,Movie Theater,-32.08,Winter Park FL,32789,5779.7,0
2033-05-31,23:54:00,Onlyfans,-2296.2,Groton CT,86810,3483.5,1
2033-06-01,09:00:00,Rent,-960.0,Oviedo FL,32765,4819.7,0
2033-06-01,09:00:00,Insurance,-197.46,Oviedo FL,32765,4622.24,0
2033-06-01,09:00:00,Car,-300.0,Oviedo FL,32765,4322.24,0
2033-06-02,15:52:00,Lockheed Martin,-140.31,London EN,52668,4181.93,1
2033-06-02,21:14:00,Starbucks,-31.77,Oviedo FL,32765,4290.47,0
2033-06-02,15:27:00,McDonald's,-30.59,Oviedo FL,32765,4259.88,0
2033-06-03,14:24:00,Impractical Jokers,-2945.11,Pittsburgh PA,18754,1314.77,1
2033-06-03,09:32:00,Walmart,-91.14,Winter Park FL,32789,4168.74,0
2033-06-03,20:27:00,Subway,-6.81,Oviedo FL,32765,4161.93,0
2033-06-04,13:35:00,Walmart,-106.66,Oviedo FL,32765,4055.27,0
2033-06-04,09:17:00,Lockheed Martin,-517.33,Mexico City MC,28429,3537.94,1
2033-06-04,14:59:00,Subway,-34.22,Oviedo FL,32765,4021.05,0
2033-06-04,11:13:00,Walgreens,-25.52,Oviedo FL,32765,3995.53,0
2033-06-05,19:18:00,Midas,-95.6,Winter Park FL,32789,3899.93,0
2033-06-06,08:00:00,Paycheck,2000.0,Oviedo FL,32765,5899.93,0
2033-06-06,17:27:00,Movie Theater,-42.98,Orlando FL,32816,5856.95,0
2033-06-07,09:00:00,Spotify,-11.99,Oviedo FL,32765,5844.96,0
2033-06-07,09:00:00,Internet,-70.89,Oviedo FL,32765,5774.07,0
2033-06-07,09:00:00,ChatGPT Plus,-20.0,Oviedo FL,32765,5754.07,0
2033-06-07,09:28:00,Burger King,-23.86,Oviedo FL,32765,5730.21,0
2033-06-08,18:31:00,Target,-67.11,Winter Park FL,32789,5663.1,0
2033-06-08,19:59:00,Burger King,-8.21,Winter Park FL,32789,5654.89,0
2033-06-08,10:29:00,Walmart,-122.76,Oviedo FL,32765,5532.13,0
2033-06-09,10:28:00,Shell,-14.71,Orlando FL,32816,5517.42,0
2033-06-09,20:05:00,Starbucks,-9.12,Winter Park FL,32789,5508.3,0
2033-06-09,14:33:00,Netflix,-24.35,Orlando FL,32816,5483.95,0
2033-06-10,11:45:00,Burger King,-7.1,Orlando FL,32816,5476.85,0
2033-06-11,15:26:00,Paypal,-2997.21,Tokyo JP,31200,2479.64,1
2033-06-11,16:03:00,Whole Foods,-83.93,Winter Park FL,32789,5392.92,0
2033-06-11,00:31:00,IBM,-641.84,Anchorage AL,61657,4751.08,1
2033-06-13,21:30:00,Jiffy Lube,-123.18,Winter Park FL,32789,5269.74,0
2033-06-13,09:19:00,Subway,-13.75,Winter Park FL,32789,5255.99,0
2033-06-14,16:12:00,Burger King,-19.24,Orlando FL,32816,5236.75,0
2033-06-14,04:30:00,Accelerators,-1924.83,Charleston SC,66743,3311.92,1
2033-06-14,19:59:00,Jiffy Lube,-93.67,Winter Park FL,32789,5143.08,0
2033-06-14,17:52:00,Magic the Gathering,-2557.53,Honolulu HI,14295,2585.55,1
2033-06-16,20:43:00,Concert Tickets,-24.66,Oviedo FL,32765,5118.42,0
2033-06-16,12:38:00,Concert Tickets,-36.48,Orlando FL,32816,5081.94,0
2033-06-17,10:59:00,Dollar Tree,-32.99,Winter Park FL,32789,5048.95,0
2033-06-18,11:58:00,Burger King,-18.55,Winter Park FL,32789,5030.4,0
2033-06-18,20:30:00,Publix,-75.25,Winter Park FL,32789,4955.15,0
2033-06-18,15:10:00,Burger King,-39.62,Oviedo FL,32765,4915.53,0
2033-06-19,21:41:00,Burger King,-39.49,Oviedo FL,32765,4876.04,0
2033-06-19,12:25:00,Netflix,-44.3,Oviedo FL,32765,4831.74,0
2033-06-19,00:42:00,IBM,-2351.81,New York NY,85339,2479.93,1
2033-06-20,08:00:00,Paycheck,2000.0,Oviedo FL,32765,6831.74,0
2033-06-20,10:25:00,Starbucks,-34.35,Oviedo FL,32765,6797.39,0
2033-06-21,20:33:00,Burger King,-39.48,Orlando FL,32816,6757.91,0
2033-06-21,17:28:00,Fraud,-2969.94,Los Angeles CA,74729,3787.97,1
2033-06-22,17:33:00,Burger King,-40.76,Oviedo FL,32765,6717.15,0
2033-06-22,09:25:00,Amusement Park,-77.98,Orlando FL,32816,6639.17,0
2033-06-23,19:58:00,McDonald's,-57.38,Oviedo FL,32765,6581.79,0
2033-06-23,20:10:00,Burger King,-18.69,Oviedo FL,32765,6563.1,0
2033-06-24,17:29:00,BP,-49.44,Oviedo FL,32765,6513.66,0
2033-06-24,21:57:00,Netflix,-28.49,Winter Park FL,32789,6485.17,0
2033-06-24,10:38:00,Dollar Tree,-80.81,Orlando FL,32816,6404.36,0
2033-06-25,13:46:00,Dollar Tree,-61.24,Orlando FL,32816,6343.12,0
2033-06-25,15:25:00,Concert Tickets,-83.11,Winter Park FL,32789,6260.01,0
2033-06-26,19:22:00,Burger King,-32.93,Oviedo FL,32765,6227.08,0
2033-06-27,11:00:00,Starbucks,-71.47,Orlando FL,32816,6155.61,0
2033-06-27,14:13:00,Target,-236.58,Oviedo FL,32765,5919.03,0
2033-06-29,16:40:00,Starbucks,-8.63,Winter Park FL,32789,5910.4,0
2033-06-30,14:42:00,Trader Joe's,-49.3,Oviedo FL,32765,5861.1,0
2033-06-30,18:27:00,Chevron,-24.4,Orlando FL,32816,5836.7,0
2033-06-30,19:44:00,Publix,-34.58,Orlando FL,32816,5802.12,0
2033-07-01,09:00:00,Rent,-960.0,Oviedo FL,32765,4842.12,0
2033-07-01,09:00:00,Insurance,-197.46,Oviedo FL,32765,4644.66,0
2033-07-01,09:00:00,Car,-300.0,Oviedo FL,32765,4344.66,0
2033-07-01,08:19:00,Whole Foods,-51.68,Orlando FL,32816,4292.98,0
2033-07-01,09:30:00,Burger King,-36.76,Orlando FL,32816,4256.22,0
2033-07-02,17:48:00,McDonald's,-30.57,Winter Park FL,32789,4225.65,0
2033-07-03,19:36:00,Starbucks,-15.21,Winter Park FL,32789,4210.44,0
2033-07-04,08:00:00,Paycheck,2000.0,Oviedo FL,32765,6210.44,0
2033-07-04,09:42:00,Subway,-77.29,Orlando FL,32816,6133.15,0
2033-07-04,17:03:00,Fat Joe,-1218.23,Los Angeles CA,84967,4914.92,1
2033-07-04,08:33:00,Pep Boys,-336.24,Orlando FL,32816,5796.91,0
2033-07-04,09:03:00,Netflix,-32.63,Winter Park FL,32789,5764.28,0
2033-07-05,09:01:00,Best Buy,-17.61,Orlando FL,32816,5746.67,0
2033-07-06,16:22:00,Publix,-38.49,Oviedo FL,32765,5708.18,0
2033-07-06,15:21:00,Whole Foods,-92.73,Orlando FL,32816,5615.45,0
2033-07-07,09:00:00,Spotify,-11.99,Oviedo FL,32765,5603.46,0
2033-07-07,09:00:00,Internet,-70.89,Oviedo FL,32765,5532.57,0
2033-07-07,09:00:00,ChatGPT Plus,-20.0,Oviedo FL,32765,5512.57,0
2033-07-07,15:28:00,Burger King,-21.44,Winter Park FL,32789,5491.13,0
2033-07-07,10:05:00,Walmart,-111.78,Orlando FL,32816,5379.35,0
2033-07-07,13:30:00,Best Buy,-81.6,Winter Park FL,32789,5297.75,0
2033-07-08,19:06:00,Amazon,-147.59,Orlando FL,32816,5150.16,0
2033-07-08,19:21:00,Burger King,-5.31,Oviedo FL,32765,5144.85,0
2033-07-09,16:26:00,Lockheed Martin,-1570.06,New York NY,44247,3574.79,1
2033-07-09,19:51:00,Subway,-26.86,Winter Park FL,32789,5117.99,0
2033-07-09,18:05:00,Trader Joe's,-53.03,Orlando FL,32816,5064.96,0
2033-07-09,21:22:00,Starbucks,-28.43,Winter Park FL,32789,5036.53,0
2033-07-11,09:04:00,Starbucks,-24.27,Orlando FL,32816,5012.26,0
2033-07-11,09:07:00,Movie Theater,-27.27,Orlando FL,32816,4984.99,0
2033-07-12,14:26:00,Kroger,-61.55,Orlando FL,32816,4923.44,0
2033-07-13,20:03:00,Subway,-32.63,Oviedo FL,32765,4890.81,0
2033-07-13,09:46:00,Pep Boys,-49.39,Winter Park FL,32789,4841.42,0
2033-07-14,08:59:00,Walmart,-64.52,Orlando FL,32816,4776.9,0
2033-07-15,09:34:00,Burger King,-23.26,Oviedo FL,32765,4753.64,0
2033-07-15,21:22:00,Netflix,-45.7,Oviedo FL,32765,4707.94,0
2033-07-15,18:54:00,Monster Energy,-944.46,Pittsburgh PA,90109,3763.48,1
2033-07-15,11:48:00,Kroger,-37.13,Orlando FL,32816,4670.81,0
2033-07-18,08:00:00,Paycheck,2000.0,Oviedo FL,32765,6670.81,0
2033-07-18,19:27:00,Starbucks,-41.15,Oviedo FL,32765,6629.66,0
2033-07-18,17:16:00,Starbucks,-30.24,Orlando FL,32816,6599.42,0
2033-07-19,16:32:00,Starbucks,-50.48,Winter Park FL,32789,6548.94,0
2033-07-20,13:51:00,Amazon,-204.98,Winter Park FL,32789,6343.96,0
2033-07-20,17:13:00,IBM,-1926.97,Tokyo JP,41137,4416.99,1
2033-07-20,18:55:00,Movie Theater,-110.79,Orlando FL,32816,6233.17,0
2033-07-21,18:38:00,Shell,-30.22,Winter Park FL,32789,6202.95,0
2033-07-21,19:31:00,Amazon,-178.96,Oviedo FL,32765,6023.99,0
2033-07-21,15:13:00,Starbucks,-45.6,Orlando FL,32816,5978.39,0
2033-07-23,17:44:00,McDonald's,-22.82,Orlando FL,32816,5955.57,0
2033-07-23,10:46:00,McDonald's,-16.56,Winter Park FL,32789,5939.01,0
2033-07-23,19:31:00,Whole Foods,-99.36,Orlando FL,32816,5839.65,0
2033-07-24,17:15:00,McDonald's,-24.03,Winter Park FL,32789,5815.62,0
2033-07-24,12:18:00,Magic the Gathering,-190.66,Groton CT,93309,5624.96,1
2033-07-25,12:14:00,Whole Foods,-49.07,Winter Park FL,32789,5766.55,0
2033-07-26,16:27:00,Walgreens,-25.05,Winter Park FL,32789,5741.5,0
2033-07-27,12:52:00,Starbucks,-9.45,Winter Park FL,32789,5732.05,0
2033-07-27,08:55:00,Target,-26.07,Orlando FL,32816,5705.98,0
2033-07-27,02:12:00,Paypal,-1071.18,Pittsburgh PA,47339,4634.8,1
2033-07-27,10:18:00,McDonald's,-31.15,Orlando FL,32816,5674.83,0
2033-07-28,19:25:00,Walgreens,-32.37,Oviedo FL,32765,5642.46,0
2033-07-28,16:46:00,Shell,-15.08,Winter Park FL,32789,5627.38,0
2033-07-29,19:24:00,Burger King,-29.85,Orlando FL,32816,5597.53,0
2033-07-29,20:14:00,McDonald's,-27.32,Oviedo FL,32765,5570.21,0
2033-07-29,14:45:00,Kroger,-36.53,Winter Park FL,32789,5533.68,0
2033-07-31,18:23:00,Walmart,-55.83,Winter Park FL,32789,5477.85,0
2033-08-01,08:00:00,Paycheck,2000.0,Oviedo FL,32765,7477.85,0
2033-08-01,09:00:00,Rent,-960.0,Oviedo FL,32765,6517.85,0
2033-08-01,09:00:00,Insurance,-197.46,Oviedo FL,32765,6320.39,0
2033-08-01,09:00:00,Car,-300.0,Oviedo FL,32765,6020.39,0
2033-08-01,15:37:00,Walmart,-282.45,Orlando FL,32816,5737.94,0
2033-08-01,12:26:00,Shell,-12.54,Winter Park FL,32789,5725.4,0
2033-08-02,09:12:00,Onlyfans,-886.45,Pittsburgh PA,82931,4838.95,1
2033-08-02,15:34:00,Chevron,-19.41,Orlando FL,32816,5705.99,0
2033-08-02,19:11:00,McDonald's,-34.39,Oviedo FL,32765,5671.6,0
2033-08-02,18:28:00,Monster Energy,-1208.75,Mexico City MC,45902,4462.85,1
2033-08-02,13:58:00,Movie Theater,-29.25,Winter Park FL,32789,5642.35,0
2033-08-03,11:13:00,McDonald's,-30.19,Orlando FL,32816,5612.16,0
2033-08-03,18:51:00,Kroger,-93.6,Winter Park FL,32789,5518.56,0
2033-08-04,09:17:00,Subway,-5.56,Winter Park FL,32789,5513.0,0
2033-08-06,11:30:00,Dollar Tree,-13.91,Orlando FL,32816,5499.09,0
2033-08-06,11:03:00,Subway,-35.47,Orlando FL,32816,5463.62,0
2033-08-06,21:26:00,Kroger,-94.66,Oviedo FL,32765,5368.96,0
2033-08-06,09:55:00,Onlyfans,-2665.01,Tokyo JP,38924,2703.95,1
2033-08-07,09:00:00,Spotify,-11.99,Oviedo FL,32765,5356.97,0
2033-08-07,09:00:00,Internet,-70.89,Oviedo FL,32765,5286.08,0
2033-08-07,09:00:00,ChatGPT Plus,-20.0,Oviedo FL,32765,5266.08,0
2033-08-07,18:54:00,Subway,-14.0,Winter Park FL,32789,5252.08,0
2033-08-09,08:33:00,Burger King,-11.64,Oviedo FL,32765,5240.44,0
2033-08-10,08:22:00,Concert Tickets,-41.58,Oviedo FL,32765,5198.86,0
2033-08-10,13:24:00,Burger King,-18.0,Winter Park FL,32789,5180.86,0
2033-08-12,11:27:00,Walmart,-149.48,Oviedo FL,32765,5031.38,0
2033-08-12,08:15:00,Jiffy Lube,-101.5,Winter Park FL,32789,4929.88,0
2033-08-13,13:01:00,Subway,-30.27,Orlando FL,32816,4899.61,0
2033-08-13,11:22:00,Exxon,-25.14,Oviedo FL,32765,4874.47,0
2033-08-13,04:05:00,Servicenow,-1403.17,Groton CT,63539,3471.3,1
2033-08-14,13:15:00,Amazon,-60.64,Winter Park FL,32789,4813.83,0
2033-08-14,15:11:00,Kroger,-61.73,Oviedo FL,32765,4752.1,0
2033-08-15,08:00:00,Paycheck,2000.0,Oviedo FL,32765,6752.1,0
2033-08-15,14:22:00,Movie Theater,-108.16,Winter Park FL,32789,6643.94,0
2033-08-15,09:15:00,Subway,-76.66,Oviedo FL,32765,6567.28,0
2033-08-17,13:31:00,Monster Energy,-1454.23,Groton CT,13598,5113.05,1
2033-08-17,17:23:00,AutoZone,-165.01,Orlando FL,32816,6402.27,0
2033-08-18,08:41:00,Best Buy,-87.93,Oviedo FL,32765,6314.34,0
2033-08-18,21:31:00,McDonald's,-52.72,Orlando FL,32816,6261.62,0
2033-08-19,00:15:00,Paypal,-2314.29,London EN,42400,3947.33,1
2033-08-19,18:04:00,Movie Theater,-67.71,Winter Park FL,32789,6193.91,0
2033-08-20,13:55:00,Amazon,-156.0,Oviedo FL,32765,6037.91,0
2033-08-21,17:50:00,Subway,-32.5,Oviedo FL,32765,6005.41,0
2033-08-22,19:47:00,Walgreens,-16.05,Winter Park FL,32789,5989.36,0
2033-08-22,13:33:00,McDonald's,-14.74,Orlando FL,32816,5974.62,0
2033-08-23,14:20:00,Best Buy,-138.87,Winter Park FL,32789,5835.75,0
2033-08-23,13:41:00,Burger King,-14.7,Oviedo FL,32765,5821.05,0
2033-08-23,09:57:00,Accelerators,-2485.03,Pittsburgh PA,73002,3336.02,1
2033-08-24,16:48:00,Trader Joe's,-58.9,Oviedo FL,32765,5762.15,0
2033-08-24,12:15:00,McDonald's,-38.94,Winter Park FL,32789,5723.21,0
2033-08-25,17:52:00,Walmart,-91.44,Winter Park FL,32789,5631.77,0
2033-08-25,18:03:00,Best Buy,-95.38,Oviedo FL,32765,5536.39,0
2033-08-25,17:10:00,Concert Tickets,-43.59,Oviedo FL,32765,5492.8,0
2033-08-27,16:58:00,Best Buy,-100.64,Winter Park FL,32789,5392.16,0
2033-08-27,16:18:00,Movie Theater,-54.06,Winter Park FL,32789,5338.1,0
2033-08-27,01:17:00,Paypal,-2938.51,Groton CT,36565,2399.59,1
2033-08-29,08:00:00,Paycheck,2000.0,Oviedo FL,32765,7338.1,0
2033-08-29,18:59:00,Netflix,-115.67,Oviedo FL,32765,7222.43,0
2033-08-29,08:50:00,Amazon,-291.91,Oviedo FL,32765,6930.52,0
2033-08-29,15:50:00,Target,-197.25,Oviedo FL,32765,6733.27,0
2033-08-31,17:04:00,Movie Theater,-86.12,Oviedo FL,32765,6647.15,0
2033-08-31,10:33:00,Starbucks,-13.4,Orlando FL,32816,6633.75,0
2033-08-31,11:36:00,Starbucks,-51.38,Winter Park FL,32789,6582.37,0
2033-09-01,09:00:00,Rent,-960.0,Oviedo FL,32765,5622.37,0
2033-09-01,09:00:00,Insurance,-197.46,Oviedo FL,32765,5424.91,0
2033-09-01,09:00:00,Car,-300.0,Oviedo FL,32765,5124.91,0
2033-09-02,16:02:00,Midas,-192.5,Oviedo FL,32765,4932.41,0
2033-09-02,08:09:00,CVS,-31.04,Winter Park FL,32789,4901.37,0
2033-09-03,08:59:00,Amazon,-91.14,Orlando FL,32816,4810.23,0
2033-09-03,10:07:00,Amazon,-58.38,Orlando FL,32816,4751.85,0
2033-09-04,08:12:00,Subway,-30.23,Orlando FL,32816,4721.62,0
2033-09-04,10:56:00,Starbucks,-6.39,Orlando FL,32816,4715.23,0
2033-09-04,17:05:00,Netflix,-51.14,Winter Park FL,32789,4664.09,0
2033-09-05,12:40:00,Dollar Tree,-19.09,Orlando FL,32816,4645.0,0
2033-09-05,08:37:00,McDonald's,-24.4,Orlando FL,32816,4620.6,0
2033-09-05,14:16:00,Walgreens,-21.23,Orlando FL,32816,4599.37,0
2033-09-06,18:41:00,Burger King,-23.44,Oviedo FL,32765,4575.93,0
2033-09-07,09:00:00,Spotify,-11.99,Oviedo FL,32765,4563.94,0
2033-09-07,09:00:00,Internet,-70.89,Oviedo FL,32765,4493.05,0
2033-09-07,09:00:00,ChatGPT Plus,-20.0,Oviedo FL,32765,4473.05,0
2033-09-07,17:11:00,Starbucks,-18.62,Orlando FL,32816,4454.43,0
2033-09-07,14:23:00,Five Below,-12.4,Orlando FL,32816,4442.03,0
2033-09-07,15:40:00,Midas,-79.13,Orlando FL,32816,4362.9,0
2033-09-08,14:05:00,Walgreens,-13.11,Orlando FL,32816,4349.79,0
2033-09-08,09:26:00,CVS,-10.86,Orlando FL,32816,4338.93,0
2033-09-08,09:43:00,Kroger,-97.45,Winter Park FL,32789,4241.48,0
2033-09-09,13:15:00,Chevron,-13.72,Winter Park FL,32789,4227.76,0
2033-09-09,20:34:00,Amazon,-85.48,Oviedo FL,32765,4142.28,0
2033-09-10,20:14:00,McDonald's,-29.83,Orlando FL,32816,4112.45,0
2033-09-10,18:27:00,Kroger,-70.72,Winter Park FL,32789,4041.73,0
2033-09-10,20:44:00,Exxon,-24.32,Oviedo FL,32765,4017.41,0
2033-09-11,15:42:00,McDonald's,-28.16,Orlando FL,32816,3989.25,0
2033-09-11,06:39:00,Onlyfans,-1192.08,Mexico City MC,23073,2797.17,1
2033-09-11,12:08:00,Whole Foods,-49.94,Oviedo FL,32765,3939.31,0
2033-09-11,13:26:00,Best Buy,-51.2,Orlando FL,32816,3888.11,0
2033-09-12,08:00:00,Paycheck,2000.0,Oviedo FL,32765,5888.11,0
2033-09-12,19:03:00,Movie Theater,-36.75,Orlando FL,32816,5851.36,0
2033-09-12,18:22:00,Shell,-23.88,Oviedo FL,32765,5827.48,0
2033-09-12,16:27:00,Movie Theater,-47.67,Orlando FL,32816,5779.81,0
2033-09-13,04:19:00,Accelerators,-637.04,Honolulu HI,57322,5142.77,1
2033-09-13,20:02:00,Best Buy,-142.15,Oviedo FL,32765,5637.66,0
2033-09-14,21:42:00,Amazon,-62.66,Orlando FL,32816,5575.0,0
2033-09-14,18:13:00,Best Buy,-141.69,Oviedo FL,32765,5433.31,0
2033-09-14,10:36:00,Starbucks,-37.04,Orlando FL,32816,5396.27,0
2033-09-15,14:07:00,Jiffy Lube,-135.28,Winter Park FL,32789,5260.99,0
2033-09-15,10:38:00,Concert Tickets,-13.07,Orlando FL,32816,5247.92,0
2033-09-15,21:47:00,Target,-59.85,Winter Park FL,32789,5188.07,0
2033-09-15,13:29:00,Onlyfans,-1911.19,London EN,40543,3276.88,1
2033-09-16,08:36:00,CVS,-6.77,Oviedo FL,32765,5181.3,0
2033-09-17,11:04:00,Exxon,-18.51,Oviedo FL,32765,5162.79,0
2033-09-18,17:44:00,Five Below,-26.51,Oviedo FL,32765,5136.28,0
2033-09-18,20:35:00,Servicenow,-2667.56,Mexico City MC,17819,2468.72,1
2033-09-20,10:01:00,CVS,-14.64,Winter Park FL,32789,5121.64,0
2033-09-21,18:39:00,BP,-18.18,Oviedo FL,32765,5103.46,0
2033-09-21,13:51:00,Burger King,-16.03,Orlando FL,32816,5087.43,0
2033-09-22,16:06:00,Best Buy,-119.08,Winter Park FL,32789,4968.35,0
2033-09-22,21:22:00,BP,-17.54,Winter Park FL,32789,4950.81,0
2033-09-22,11:25:00,Amusement Park,-38.55,Oviedo FL,32765,4912.26,0
2033-09-23,17:30:00,Starbucks,-30.12,Orlando FL,32816,4882.14,0
2033-09-23,20:43:00,Target,-93.43,Winter Park FL,32789,4788.71,0
2033-09-24,18:08:00,Exxon,-12.86,Winter Park FL,32789,4775.85,0
2033-09-24,09:23:00,Subway,-16.52,Winter Park FL,32789,4759.33,0
2033-09-25,20:52:00,Kroger,-95.89,Orlando FL,32816,4663.44,0
2033-09-25,12:30:00,McDonald's,-28.53,Orlando FL,32816,4634.91,0
2033-09-26,08:00:00,Paycheck,2000.0,Oviedo FL,32765,6634.91,0
2033-09-26,18:32:00,McDonald's,-27.78,Winter Park FL,32789,6607.13,0
2033-09-26,06:02:00,Fraud,-677.16,Honolulu HI,83407,5929.97,1
2033-09-26,15:55:00,Walgreens,-80.77,Oviedo FL,32765,6526.36,0
2033-09-27,12:48:00,Burger King,-12.51,Orlando FL,32816,6513.85,0
2033-09-27,16:23:00,Burger King,-32.42,Orlando FL,32816,6481.43,0
2033-09-27,13:31:00,IBM,-1666.63,New York NY,44528,4814.8,1
2033-09-29,20:32:00,Walmart,-245.43,Orlando FL,32816,6236.0,0
2033-09-29,14:57:00,Burger King,-77.74,Winter Park FL,32789,6158.26,0
2033-09-30,05:44:00,Fraud,-2764.96,Charleston SC,88840,3393.3,1
2033-10-01,09:00:00,Rent,-960.0,Oviedo FL,32765,5198.26,0
2033-10-01,09:00:00,Insurance,-197.46,Oviedo FL,32765,5000.8,0
2033-10-01,09:00:00,Car,-300.0,Oviedo FL,32765,4700.8,0
2033-10-01,21:45:00,McDonald's,-22.72,Oviedo FL,32765,4678.08,0
2033-10-01,18:12:00,Best Buy,-93.98,Winter Park FL,32789,4584.1,0
2033-10-03,19:46:00,Paypal,-2579.13,Tokyo JP,87612,2004.97,1
2033-10-05,20:38:00,Subway,-16.94,Winter Park FL,32789,4567.16,0
2033-10-06,20:09:00,Target,-117.81,Winter Park FL,32789,4449.35,0
2033-10-06,17:17:00,Exxon,-29.49,Winter Park FL,32789,4419.86,0
2033-10-07,09:00:00,Spotify,-11.99,Oviedo FL,32765,4407.87,0
2033-10-07,09:00:00,Internet,-70.89,Oviedo FL,32765,4336.98,0
2033-10-07,09:00:00,ChatGPT Plus,-20.0,Oviedo FL,32765,4316.98,0
2033-10-08,12:41:00,Trader Joe's,-61.08,Winter Park FL,32789,4255.9,0
2033-10-08,08:21:00,Target,-34.0,Oviedo FL,32765,4221.9,0
2033-10-08,08:53:00,BP,-11.16,Winter Park FL,32789,4210.74,0
2033-10-09,08:47:00,Accelerators,-693.3,Groton CT,79998,3517.44,1
2033-10-09,14:48:00,Concert Tickets,-14.63,Orlando FL,32816,4196.11,0
2033-10-09,19:58:00,Subway,-27.6,Orlando FL,32816,4168.51,0
2033-10-10,08:00:00,Paycheck,2000.0,Oviedo FL,32765,6168.51,0
2033-10-13,15:09:00,Target,-152.6,Oviedo FL,32765,6015.91,0
2033-10-14,19:51:00,Best Buy,-116.09,Winter Park FL,32789,5899.82,0
2033-10-14,15:58:00,Monster Energy,-504.98,Anchorage AL,96129,5394.84,1
2033-10-14,15:42:00,Amazon,-43.97,Orlando FL,32816,5855.85,0
2033-10-14,18:32:00,CVS,-22.83,Orlando FL,32816,5833.02,0
2033-10-16,08:19:00,Whole Foods,-51.39,Winter Park FL,32789,5781.63,0
2033-10-16,21:11:00,Burger King,-20.4,Oviedo FL,32765,5761.23,0
2033-10-16,14:31:00,Amazon,-56.45,Oviedo FL,32765,5704.78,0
2033-10-17,10:10:00,Burger King,-39.44,Winter Park FL,32789,5665.34,0
2033-10-17,08:32:00,Concert Tickets,-37.65,Orlando FL,32816,5627.69,0
2033-10-17,17:01:00,Movie Theater,-39.7,Winter Park FL,32789,5587.99,0
2033-10-18,09:14:00,Subway,-32.23,Winter Park FL,32789,5555.76,0
2033-10-19,11:29:00,Burger King,-14.82,Winter Park FL,32789,5540.94,0
2033-10-20,11:38:00,Five Below,-27.85,Oviedo FL,32765,5513.09,0
2033-10-22,16:58:00,Shell,-21.2,Winter Park FL,32789,5491.89,0
2033-10-22,20:32:00,Amusement Park,-23.31,Oviedo FL,32765,5468.58,0
2033-10-24,08:00:00,Paycheck,2000.0,Oviedo FL,32765,7468.58,0
2033-10-24,15:51:00,Burger King,-34.86,Orlando FL,32816,7433.72,0
2033-10-24,16:10:00,Onlyfans,-720.42,Anchorage AL,39735,6713.3,1
2033-10-25,15:02:00,Best Buy,-211.3,Oviedo FL,32765,7222.42,0
2033-10-25,17:00:00,Concert Tickets,-60.14,Winter Park FL,32789,7162.28,0
2033-10-25,13:53:00,Chevron,-21.88,Oviedo FL,32765,7140.4,0
2033-10-29,17:09:00,McDonald's,-30.73,Winter Park FL,32789,7109.67,0
2033-10-29,08:31:00,BP,-51.38,Winter Park FL,32789,7058.29,0
2033-10-30,08:12:00,Movie Theater,-66.63,Oviedo FL,32765,6991.66,0
2033-10-30,14:01:00,Burger King,-60.96,Orlando FL,32816,6930.7,0
2033-10-31,17:18:00,BP,-58.58,Oviedo FL,32765,6872.12,0
2033-10-31,18:13:00,Target,-173.23,Orlando FL,32816,6698.89,0
2033-10-31,08:55:00,Burger King,-61.63,Orlando FL,32816,6637.26,0
2033-11-01,09:00:00,Rent,-960.0,Oviedo FL,32765,5677.26,0
2033-11-01,09:00:00,Insurance,-197.46,Oviedo FL,32765,5479.8,0
2033-11-01,09:00:00,Car,-300.0,Oviedo FL,32765,5179.8,0
2033-11-01,14:53:00,Subway,-30.81,Winter Park FL,32789,5148.99,0
2033-11-03,08:22:00,Subway,-36.79,Orlando FL,32816,5112.2,0
2033-11-03,11:29:00,Walgreens,-21.76,Winter Park FL,32789,5090.44,0
2033-11-04,09:00:00,Pawn Stars,-1569.11,Los Angeles CA,45117,3521.33,1
2033-11-04,20:05:00,McDonald's,-15.19,Oviedo FL,32765,5075.25,0
2033-11-05,16:10:00,Walmart,-70.81,Oviedo FL,32765,5004.44,0
2033-11-05,12:49:00,Burger King,-8.43,Winter Park FL,32789,4996.01,0
2033-11-05,10:47:00,Concert Tickets,-21.16,Oviedo FL,32765,4974.85,0
2033-11-06,12:49:00,Netflix,-26.3,Oviedo FL,32765,4948.55,0
2033-11-07,08:00:00,Paycheck,2000.0,Oviedo FL,32765,6948.55,0
2033-11-07,09:00:00,Spotify,-11.99,Oviedo FL,32765,6936.56,0
2033-11-07,09:00:00,Internet,-70.89,Oviedo FL,32765,6865.67,0
2033-11-07,09:00:00,ChatGPT Plus,-20.0,Oviedo FL,32765,6845.67,0
2033-11-07,20:25:00,Magic the Gathering,-863.67,Tokyo JP,89436,5982.0,1
2033-11-08,09:16:00,Best Buy,-31.93,Winter Park FL,32789,6813.74,0
2033-11-08,13:01:00,Best Buy,-142.43,Winter Park FL,32789,6671.31,0
2033-11-09,09:28:00,Five Below,-54.96,Winter Park FL,32789,6616.35,0
2033-11-09,08:04:00,Chevron,-26.87,Orlando FL,32816,6589.48,0
2033-11-10,15:36:00,Walmart,-20.73,Winter Park FL,32789,6568.75,0
2033-11-10,10:40:00,Impractical Jokers,-1334.46,Charleston SC,97913,5234.29,1
2033-11-10,21:20:00,McDonald's,-68.83,Oviedo FL,32765,6499.92,0
2033-11-10,02:21:00,Lockheed Martin,-431.17,Charleston SC,19364,6068.75,1
2033-11-12,09:34:00,Midas,-157.36,Orlando FL,32816,6342.56,0
2033-11-12,09:46:00,Concert Tickets,-57.76,Orlando FL,32816,6284.8,0
2033-11-12,18:00:00,Shell,-20.4,Orlando FL,32816,6264.4,0
2033-11-13,09:55:00,Pep Boys,-386.66,Orlando FL,32816,5877.74,0
2033-11-13,12:56:00,CVS,-44.66,Winter Park FL,32789,5833.08,0
2033-11-14,12:45:00,McDonald's,-18.58,Orlando FL,32816,5814.5,0
2033-11-14,21:38:00,Movie Theater,-36.89,Orlando FL,32816,5777.61,0
2033-11-14,10:57:00,Starbucks,-32.46,Orlando FL,32816,5745.15,0
2033-11-15,14:11:00,Midas,-157.85,Orlando FL,32816,5587.3,0
2033-11-15,17:24:00,Kroger,-35.49,Winter Park FL,32789,5551.81,0
2033-11-15,08:29:00,Burger King,-30.15,Orlando FL,32816,5521.66,0
2033-11-16,12:00:00,Starbucks,-27.32,Orlando FL,32816,5494.34,0
2033-11-17,10:39:00,Starbucks,-28.11,Oviedo FL,32765,5466.23,0
2033-11-18,17:27:00,Walmart,-77.0,Oviedo FL,32765,5389.23,0
2033-11-18,12:09:00,Walgreens,-25.29,Orlando FL,32816,5363.94,0
2033-11-19,19:46:00,Target,-23.8,Orlando FL,32816,5340.14,0
2033-11-19,18:51:00,Whole Foods,-76.96,Orlando FL,32816,5263.18,0
2033-11-19,09:01:00,Paypal,-1933.11,London EN,23106,3330.07,1
2033-11-19,21:26:00,Best Buy,-48.3,Winter Park FL,32789,5214.88,0
2033-11-20,13:34:00,Amazon,-64.95,Winter Park FL,32789,5149.93,0
2033-11-20,09:30:00,McDonald's,-7.79,Winter Park FL,32789,5142.14,0
2033-11-20,21:09:00,Dollar Tree,-14.74,Orlando FL,32816,5127.4,0
2033-11-21,08:00:00,Paycheck,2000.0,Oviedo FL,32765,7127.4,0
2033-11-21,21:36:00,Amazon,-157.69,Orlando FL,32816,6969.71,0
2033-11-21,14:20:00,Trader Joe's,-135.86,Winter Park FL,32789,6833.85,0
2033-11-25,21:07:00,Shell,-34.62,Oviedo FL,32765,6799.23,0
2033-11-25,15:52:00,Target,-209.72,Orlando FL,32816,6589.51,0
2033-11-25,19:38:00,Exxon,-51.6,Orlando FL,32816,6537.91,0
2033-11-26,15:17:00,Netflix,-85.28,Orlando FL,32816,6452.63,0
2033-11-26,14:33:00,Netflix,-24.9,Oviedo FL,32765,6427.73,0
2033-11-27,16:35:00,Starbucks,-64.52,Oviedo FL,32765,6363.21,0
2033-11-27,20:07:00,BP,-36.81,Orlando FL,32816,6326.4,0
2033-11-28,17:08:00,Burger King,-70.7,Orlando FL,32816,6255.7,0
2033-11-28,08:02:00,Shell,-27.9,Orlando FL,32816,6227.8,0
2033-11-28,10:03:00,Lockheed Martin,-2670.74,Honolulu HI,20669,3557.06,1
2033-11-30,20:30:00,Chevron,-55.5,Winter Park FL,32789,6172.3,0
2033-11-30,13:44:00,Publix,-166.7,Oviedo FL,32765,6005.6,0
2033-11-30,10:43:00,Starbucks,-46.13,Orlando FL,32816,5959.47,0
2033-11-30,18:25:00,Lockheed Martin,-2336.03,London EN,15336,3623.44,1
2033-12-01,09:00:00,Rent,-960.0,Oviedo FL,32765,4999.47,0
2033-12-01,09:00:00,Insurance,-197.46,Oviedo FL,32765,4802.01,0
2033-12-01,09:00:00,Car,-300.0,Oviedo FL,32765,4502.01,0
2033-12-01,09:14:00,Publix,-93.88,Winter Park FL,32789,4408.13,0
2033-12-01,12:14:00,Dollar Tree,-6.97,Orlando FL,32816,4401.16,0
2033-12-01,12:21:00,Amazon,-88.9,Winter Park FL,32789,4312.26,0
2033-12-02,10:00:00,McDonald's,-36.59,Winter Park FL,32789,4275.67,0
2033-12-02,11:43:00,Whole Foods,-57.04,Orlando FL,32816,4218.63,0
2033-12-03,20:33:00,Whole Foods,-45.98,Winter Park FL,32789,4172.65,0
2033-12-04,12:42:00,Burger King,-13.68,Winter Park FL,32789,4158.97,0
2033-12-04,16:13:00,Jiffy Lube,-134.76,Winter Park FL,32789,4024.21,0
2033-12-04,14:21:00,Concert Tickets,-47.07,Winter Park FL,32789,3977.14,0
2033-12-05,08:00:00,Paycheck,2000.0,Oviedo FL,32765,5977.14,0
2033-12-05,11:11:00,Monster Energy,-200.25,Pittsburgh PA,84137,5776.89,1
2033-12-05,13:39:00,Target,-66.51,Oviedo FL,32765,5910.63,0
2033-12-05,15:07:00,Jiffy Lube,-75.64,Oviedo FL,32765,5834.99,0
2033-12-05,08:09:00,Movie Theater,-27.41,Oviedo FL,32765,5807.58,0
2033-12-06,11:29:00,Best Buy,-119.01,Oviedo FL,32765,5688.57,0
2033-12-07,09:00:00,Spotify,-11.99,Oviedo FL,32765,5676.58,0
2033-12-07,09:00:00,Internet,-70.89,Oviedo FL,32765,5605.69,0
2033-12-07,09:00:00,ChatGPT Plus,-20.0,Oviedo FL,32765,5585.69,0
2033-12-07,21:29:00,Concert Tickets,-10.61,Orlando FL,32816,5575.08,0
2033-12-07,10:52:00,Chevron,-19.22,Orlando FL,32816,5555.86,0
2033-12-08,19:59:00,Walmart,-116.14,Orlando FL,32816,5439.72,0
2033-12-09,15:13:00,Concert Tickets,-22.02,Oviedo FL,32765,5417.7,0
2033-12-09,10:51:00,Burger King,-5.66,Oviedo FL,32765,5412.04,0
2033-12-10,18:28:00,Best Buy,-96.74,Orlando FL,32816,5315.3,0
2033-12-11,09:16:00,McDonald's,-27.71,Orlando FL,32816,5287.59,0
2033-12-12,08:27:00,CVS,-23.85,Winter Park FL,32789,5263.74,0
2033-12-14,08:18:00,Starbucks,-16.41,Winter Park FL,32789,5247.33,0
2033-12-14,18:27:00,Starbucks,-18.34,Winter Park FL,32789,5228.99,0
2033-12-15,09:24:00,Dollar Tree,-7.74,Winter Park FL,32789,5221.25,0
2033-12-16,18:00:00,Subway,-19.42,Winter Park FL,32789,5201.83,0
2033-12-18,10:36:00,McDonald's,-13.15,Orlando FL,32816,5188.68,0
2033-12-18,18:28:00,Starbucks,-25.24,Oviedo FL,32765,5163.44,0
2033-12-19,08:00:00,Paycheck,2000.0,Oviedo FL,32765,7163.44,0
2033-12-19,15:37:00,Magic the Gathering,-2994.23,Honolulu HI,33801,4169.21,1
2033-12-19,18:45:00,Burger King,-39.42,Winter Park FL,32789,7124.02,0
2033-12-19,21:57:00,Subway,-13.85,Orlando FL,32816,7110.17,0
2033-12-19,14:31:00,Starbucks,-32.42,Orlando FL,32816,7077.75,0
2033-12-20,08:08:00,Five Below,-24.63,Winter Park FL,32789,7053.12,0
2033-12-20,09:46:00,Subway,-11.31,Orlando FL,32816,7041.81,0
2033-12-21,08:25:00,Starbucks,-39.05,Orlando FL,32816,7002.76,0
2033-12-22,19:16:00,McDonald's,-61.5,Orlando FL,32816,6941.26,0
2033-12-23,15:34:00,AutoZone,-265.53,Orlando FL,32816,6675.73,0
2033-12-23,10:26:00,Exxon,-26.5,Oviedo FL,32765,6649.23,0
2033-12-24,18:19:00,Kroger,-81.15,Oviedo FL,32765,6568.08,0
2033-12-24,08:08:00,IBM,-1255.1,Groton CT,97424,5312.98,1
2033-12-24,09:53:00,Amusement Park,-52.62,Oviedo FL,32765,6515.46,0
2033-12-25,13:19:00,Dollar Tree,-53.31,Winter Park FL,32789,6462.15,0
2033-12-25,13:09:00,Whole Foods,-174.3,Orlando FL,32816,6287.85,0
2033-12-25,21:23:00,Burger King,-15.88,Oviedo FL,32765,6271.97,0
2033-12-26,10:49:00,Shell,-53.74,Winter Park FL,32789,6218.23,0
2033-12-26,12:46:00,Amazon,-247.77,Oviedo FL,32765,5970.46,0
2033-12-26,08:41:00,Monster Energy,-136.57,Groton CT,91789,5833.89,1
2033-12-26,10:53:00,Exxon,-28.9,Orlando FL,32816,5941.56,0
2033-12-27,11:18:00,Kroger,-48.84,Orlando FL,32816,5892.72,0
2033-12-27,08:32:00,Chevron,-14.87,Winter Park FL,32789,5877.85,0
2033-12-27,14:36:00,Publix,-32.8,Oviedo FL,32765,5845.05,0
2033-12-29,12:39:00,CVS,-10.24,Winter Park FL,32789,5834.81,0
2033-12-29,17:56:00,Best Buy,-74.32,Orlando FL,32816,5760.49,0
2033-12-29,17:05:00,Dollar Tree,-15.68,Oviedo FL,32765,5744.81,0
2033-12-30,17:00:00,Starbucks,-33.43,Oviedo FL,32765,5711.38,0
2034-01-01,09:00:00,Rent,-960.0,Oviedo FL,32765,4751.38,0
2034-01-01,09:00:00,Insurance,-197.46,Oviedo FL,32765,4553.92,0
2034-01-01,09:00:00,Car,-300.0,Oviedo FL,32765,4253.92,0
2034-01-01,11:23:00,Subway,-21.25,Winter Park FL,32789,4232.67,0
2034-01-01,05:15:00,IBM,-263.39,Pittsburgh PA,60742,3969.28,1
2034-01-01,15:04:00,Burger King,-22.71,Oviedo FL,32765,4209.96,0
2034-01-02,08:00:00,Paycheck,2000.0,Oviedo FL,32765,6209.96,0
2034-01-02,15:36:00,Onlyfans,-1931.97,Honolulu HI,18260,4277.99,1
2034-01-03,14:34:00,Burger King,-18.39,Oviedo FL,32765,6191.57,0
2034-01-03,19:31:00,Netflix,-107.29,Winter Park FL,32789,6084.28,0
2034-01-03,16:27:00,Movie Theater,-86.1,Oviedo FL,32765,5998.18,0
2034-01-04,19:41:00,Dollar Tree,-27.87,Oviedo FL,32765,5970.31,0
2034-01-05,10:08:00,Best Buy,-127.03,Winter Park FL,32789,5843.28,0
2034-01-05,00:36:00,Impractical Jokers,-813.54,Los Angeles CA,79507,5029.74,1
2034-01-05,16:50:00,Chevron,-29.86,Orlando FL,32816,5813.42,0
2034-01-05,11:21:00,Shell,-22.43,Oviedo FL,32765,5790.99,0
2034-01-06,16:50:00,Starbucks,-32.62,Oviedo FL,32765,5758.37,0
2034-01-06,19:02:00,Shell,-24.03,Orlando FL,32816,5734.34,0
2034-01-06,11:11:00,Burger King,-16.05,Winter Park FL,32789,5718.29,0
2034-01-07,09:00:00,Spotify,-11.99,Oviedo FL,32765,5706.3,0
2034-01-07,09:00:00,Internet,-70.89,Oviedo FL,32765,5635.41,0
2034-01-07,09:00:00,ChatGPT Plus,-20.0,Oviedo FL,32765,5615.41,0
2034-01-07,12:58:00,Publix,-35.21,Orlando FL,32816,5580.2,0
2034-01-07,21:09:00,Concert Tickets,-54.29,Oviedo FL,32765,5525.91,0
2034-01-09,21:15:00,Onlyfans,-2421.26,Anchorage AL,42421,3104.65,1
2034-01-09,18:10:00,Midas,-122.33,Orlando FL,32816,5403.58,0
2034-01-10,19:46:00,Starbucks,-34.94,Oviedo FL,32765,5368.64,0
2034-01-10,17:37:00,Burger King,-14.08,Winter Park FL,32789,5354.56,0
2034-01-10,19:03:00,Fat Joe,-140.61,Pittsburgh PA,26523,5213.95,1
2034-01-11,19:26:00,Monster Energy,-630.65,Tokyo JP,70220,4723.91,1
2034-01-11,19:38:00,Dollar Tree,-39.31,Oviedo FL,32765,5315.25,0
2034-01-12,08:47:00,Whole Foods,-30.67,Winter Park FL,32789,5284.58,0
2034-01-13,08:48:00,McDonald's,-26.19,Winter Park FL,32789,5258.39,0
2034-01-13,11:20:00,CVS,-10.91,Winter Park FL,32789,5247.48,0
2034-01-13,10:08:00,Amazon,-35.11,Oviedo FL,32765,5212.37,0
2034-01-14,21:23:00,Netflix,-13.41,Orlando FL,32816,5198.96,0
2034-01-14,13:35:00,Subway,-30.35,Orlando FL,32816,5168.61,0
2034-01-15,15:10:00,Target,-77.02,Orlando FL,32816,5091.59,0
2034-01-16,08:00:00,Paycheck,2000.0,Oviedo FL,32765,7091.59,0
2034-01-17,10:05:00,Walmart,-254.97,Orlando FL,32816,6836.62,0
2034-01-18,09:09:00,AutoZone,-316.07,Winter Park FL,32789,6520.55,0
2034-01-18,14:07:00,Walgreens,-24.96,Oviedo FL,32765,6495.59,0
2034-01-18,19:26:00,Pawn Stars,-2164.37,New York NY,25659,4331.22,1
2034-01-18,16:55:00,Exxon,-29.84,Orlando FL,32816,6465.75,0
2034-01-19,12:56:00,Trader Joe's,-78.1,Orlando FL,32816,6387.65,0
2034-01-19,20:03:00,Subway,-36.81,Orlando FL,32816,6350.84,0
2034-01-19,15:06:00,McDonald's,-43.14,Winter Park FL,32789,6307.7,0
2034-01-20,11:08:00,Kroger,-96.08,Oviedo FL,32765,6211.62,0
2034-01-20,17:03:00,Concert Tickets,-78.2,Oviedo FL,32765,6133.42,0
2034-01-20,17:57:00,Burger King,-33.19,Winter Park FL,32789,6100.23,0
2034-01-21,16:08:00,Publix,-123.8,Orlando FL,32816,5976.43,0
2034-01-22,12:49:00,Walmart,-104.82,Winter Park FL,32789,5871.61,0
2034-01-22,17:27:00,Target,-38.04,Winter Park FL,32789,5833.57,0
2034-01-24,16:32:00,Movie Theater,-38.22,Orlando FL,32816,5795.35,0
2034-01-24,16:29:00,Jiffy Lube,-41.38,Winter Park FL,32789,5753.97,0
2034-01-25,14:14:00,McDonald's,-12.62,Oviedo FL,32765,5741.35,0
2034-01-25,21:40:00,McDonald's,-32.79,Winter Park FL,32789,5708.56,0
2034-01-26,13:05:00,Starbucks,-21.95,Winter Park FL,32789,5686.61,0
2034-01-27,14:44:00,Starbucks,-31.66,Orlando FL,32816,5654.95,0
2034-01-30,08:00:00,Paycheck,2000.0,Oviedo FL,32765,7654.95,0
2034-01-30,13:08:00,Subway,-41.04,Oviedo FL,32765,7613.91,0
2034-01-30,19:24:00,Burger King,-15.7,Oviedo FL,32765,7598.21,0
2034-01-30,18:31:00,Starbucks,-70.39,Oviedo FL,32765,7527.82,0
2034-01-31,14:39:00,Dollar Tree,-31.42,Oviedo FL,32765,7496.4,0
2034-02-01,09:00:00,Rent,-960.0,Oviedo FL,32765,6536.4,0
2034-02-01,09:00:00,Insurance,-197.46,Oviedo FL,32765,6338.94,0
2034-02-01,09:00:00,Car,-300.0,Oviedo FL,32765,6038.94,0
2034-02-01,14:01:00,Walmart,-40.68,Winter Park FL,32789,5998.26,0
2034-02-01,16:59:00,McDonald's,-34.82,Winter Park FL,32789,5963.44,0
2034-02-02,09:36:00,Walgreens,-42.58,Oviedo FL,32765,5920.86,0
2034-02-03,19:12:00,Amazon,-39.32,Winter Park FL,32789,5881.54,0
2034-02-04,14:49:00,Best Buy,-12.45,Oviedo FL,32765,5869.09,0
2034-02-06,15:53:00,Starbucks,-27.0,Winter Park FL,32789,5842.09,0
2034-02-06,17:40:00,Netflix,-31.95,Winter Park FL,32789,5810.14,0
2034-02-06,18:52:00,Chevron,-10.01,Winter Park FL,32789,5800.13,0
2034-02-07,09:00:00,Spotify,-11.99,Oviedo FL,32765,5788.14,0
2034-02-07,09:00:00,Internet,-70.89,Oviedo FL,32765,5717.25,0
2034-02-07,09:00:00,ChatGPT Plus,-20.0,Oviedo FL,32765,5697.25,0
2034-02-08,20:02:00,Concert Tickets,-46.83,Oviedo FL,32765,5650.42,0
2034-02-08,08:35:00,McDonald's,-18.91,Orlando FL,32816,5631.51,0
2034-02-09,19:37:00,BP,-11.21,Winter Park FL,32789,5620.3,0
2034-02-10,14:11:00,Burger King,-37.61,Winter Park FL,32789,5582.69,0
2034-02-10,21:26:00,Burger King,-37.23,Oviedo FL,32765,5545.46,0
2034-02-10,12:19:00,Amusement Park,-59.43,Winter Park FL,32789,5486.03,0
2034-02-11,15:34:00,Movie Theater,-12.15,Orlando FL,32816,5473.88,0
2034-02-11,21:42:00,McDonald's,-30.0,Orlando FL,32816,5443.88,0
2034-02-11,14:47:00,Burger King,-24.5,Oviedo FL,32765,5419.38,0
2034-02-12,14:59:00,McDonald's,-36.87,Oviedo FL,32765,5382.51,0
2034-02-12,10:51:00,Burger King,-31.16,Orlando FL,32816,5351.35,0
2034-02-13,08:00:00,Paycheck,2000.0,Oviedo FL,32765,7351.35,0
2034-02-13,08:47:00,Trader Joe's,-131.06,Winter Park FL,32789,7220.29,0
2034-02-13,18:02:00,Kroger,-185.7,Orlando FL,32816,7034.59,0
2034-02-13,03:31:00,Fat Joe,-2954.69,Charleston SC,19346,4079.9,1
2034-02-14,17:58:00,Walgreens,-29.31,Winter Park FL,32789,7005.28,0
2034-02-15,10:31:00,Whole Foods,-112.56,Winter Park FL,32789,6892.72,0
2034-02-15,20:55:00,Dollar Tree,-91.24,Oviedo FL,32765,6801.48,0
2034-02-15,15:39:00,CVS,-29.33,Orlando FL,32816,6772.15,0
2034-02-17,09:33:00,Best Buy,-294.16,Orlando FL,32816,6477.99,0
2034-02-17,17:31:00,Walmart,-231.56,Winter Park FL,32789,6246.43,0
2034-02-18,23:51:00,Fraud,-2846.8,Honolulu HI,68737,3399.63,1
2034-02-18,16:00:00,Walgreens,-34.41,Winter Park FL,32789,6212.02,0
2034-02-19,15:21:00,Kroger,-121.22,Winter Park FL,32789,6090.8,0
2034-02-19,20:24:00,Walgreens,-75.36,Oviedo FL,32765,6015.44,0
2034-02-19,10:17:00,Subway,-34.39,Oviedo FL,32765,5981.05,0
2034-02-20,16:33:00,Walgreens,-43.84,Winter Park FL,32789,5937.21,0
2034-02-20,11:55:00,Movie Theater,-20.67,Winter Park FL,32789,5916.54,0
2034-02-21,09:08:00,Chevron,-29.63,Oviedo FL,32765,5886.91,0
2034-02-21,00:27:00,Servicenow,-110.58,New York NY,29587,5776.33,1
2034-02-22,09:17:00,Five Below,-5.51,Orlando FL,32816,5881.4,0
2034-02-22,21:10:00,Walgreens,-32.88,Oviedo FL,32765,5848.52,0
2034-02-22,22:56:00,Impractical Jokers,-238.13,New York NY,80208,5610.39,1
2034-02-22,16:48:00,Publix,-94.45,Orlando FL,32816,5754.07,0
2034-02-25,17:15:00,Shell,-20.09,Winter Park FL,32789,5733.98,0
2034-02-25,15:42:00,CVS,-32.22,Winter Park FL,32789,5701.76,0
2034-02-25,15:05:00,Starbucks,-38.86,Winter Park FL,32789,5662.9,0
2034-02-27,08:00:00,Paycheck,2000.0,Oviedo FL,32765,7662.9,0
2034-02-28,10:20:00,Subway,-28.52,Oviedo FL,32765,7634.38,0
2034-03-01,09:00:00,Rent,-960.0,Oviedo FL,32765,6674.38,0
2034-03-01,09:00:00,Insurance,-197.46,Oviedo FL,32765,6476.92,0
2034-03-01,09:00:00,Car,-300.0,Oviedo FL,32765,6176.92,0
2034-03-02,13:00:00,Netflix,-48.94,Orlando FL,32816,6127.98,0
2034-03-02,08:58:00,Starbucks,-62.48,Orlando FL,32816,6065.5,0
2034-03-03,16:14:00,Starbucks,-63.09,Oviedo FL,32765,6002.41,0
2034-03-04,14:47:00,Trader Joe's,-142.92,Oviedo FL,32765,5859.49,0
2034-03-04,20:14:00,Starbucks,-13.02,Oviedo FL,32765,5846.47,0
2034-03-05,14:58:00,Amazon,-78.26,Winter Park FL,32789,5768.21,0
2034-03-05,09:14:00,Subway,-6.94,Winter Park FL,32789,5761.27,0
2034-03-05,14:13:00,Subway,-20.68,Oviedo FL,32765,5740.59,0
2034-03-07,09:00:00,Spotify,-11.99,Oviedo FL,32765,5728.6,0
2034-03-07,09:00:00,Internet,-70.89,Oviedo FL,32765,5657.71,0
2034-03-07,09:00:00,ChatGPT Plus,-20.0,Oviedo FL,32765,5637.71,0
2034-03-07,15:43:00,Amazon,-56.74,Winter Park FL,32789,5580.97,0
2034-03-07,18:50:00,Target,-56.03,Orlando FL,32816,5524.94,0
2034-03-08,18:40:00,Chevron,-22.58,Oviedo FL,32765,5502.36,0
2034-03-12,18:47:00,Starbucks,-24.69,Winter Park FL,32789,5477.67,0
2034-03-12,19:26:00,Netflix,-11.25,Winter Park FL,32789,5466.42,0
2034-03-12,11:15:00,Subway,-28.29,Winter Park FL,32789,5438.13,0
2034-03-13,08:00:00,Paycheck,2000.0,Oviedo FL,32765,7438.13,0
2034-03-17,09:50:00,Monster Energy,-389.13,Mexico City MC,48111,7049.0,1
2034-03-17,12:38:00,Best Buy,-54.12,Winter Park FL,32789,7384.01,0
2034-03-17,13:10:00,McDonald's,-15.52,Winter Park FL,32789,7368.49,0
2034-03-18,11:20:00,Servicenow,-495.12,London EN,14367,6873.37,1
2034-03-18,17:48:00,Walgreens,-44.85,Oviedo FL,32765,7323.64,0
2034-03-19,10:28:00,CVS,-94.66,Orlando FL,32816,7228.98,0
2034-03-19,19:53:00,Shell,-34.45,Oviedo FL,32765,7194.53,0
2034-03-20,20:21:00,Subway,-76.62,Winter Park FL,32789,7117.91,0
2034-03-20,11:23:00,Subway,-76.33,Oviedo FL,32765,7041.58,0
2034-03-20,12:37:00,Amusement Park,-79.02,Oviedo FL,32765,6962.56,0
2034-03-21,18:38:00,Subway,-56.75,Orlando FL,32816,6905.81,0
2034-03-21,12:19:00,Best Buy,-108.12,Oviedo FL,32765,6797.69,0
2034-03-21,19:17:00,Chevron,-43.18,Oviedo FL,32765,6754.51,0
2034-03-21,21:12:00,Lockheed Martin,-2353.4,Mexico City MC,21450,4401.11,1
2034-03-23,21:40:00,Amusement Park,-44.42,Oviedo FL,32765,6710.09,0
2034-03-23,21:03:00,Five Below,-66.71,Orlando FL,32816,6643.38,0
2034-03-24,09:52:00,Kroger,-152.89,Winter Park FL,32789,6490.49,0
2034-03-25,09:27:00,Dollar Tree,-30.75,Oviedo FL,32765,6459.74,0
2034-03-25,20:36:00,McDonald's,-58.49,Oviedo FL,32765,6401.25,0
2034-03-25,21:54:00,Burger King,-21.8,Oviedo FL,32765,6379.45,0
2034-03-27,08:00:00,Paycheck,2000.0,Oviedo FL,32765,8379.45,0
2034-03-27,16:55:00,Subway,-65.29,Oviedo FL,32765,8314.16,0
2034-03-27,21:44:00,Subway,-65.92,Oviedo FL,32765,8248.24,0
2034-03-28,15:36:00,Target,-283.1,Orlando FL,32816,7965.14,0
2034-03-28,14:58:00,Burger King,-66.92,Orlando FL,32816,7898.22,0
2034-03-28,13:29:00,Amusement Park,-30.04,Orlando FL,32816,7868.18,0
2034-03-31,16:29:00,Publix,-71.0,Orlando FL,32816,7797.18,0
2034-03-31,10:30:00,Jiffy Lube,-192.53,Orlando FL,32816,7604.65,0
2034-04-01,09:00:00,Rent,-960.0,Oviedo FL,32765,6644.65,0
2034-04-01,09:00:00,Insurance,-197.46,Oviedo FL,32765,6447.19,0
2034-04-01,09:00:00,Car,-300.0,Oviedo FL,32765,6147.19,0
2034-04-01,16:54:00,Midas,-177.54,Winter Park FL,32789,5969.65,0
2034-04-01,06:34:00,IBM,-1441.35,Pittsburgh PA,86800,4528.3,1
2034-04-04,10:04:00,Concert Tickets,-52.53,Orlando FL,32816,5917.12,0
2034-04-05,18:54:00,Subway,-26.66,Oviedo FL,32765,5890.46,0
2034-04-05,09:00:00,Amazon,-51.4,Orlando FL,32816,5839.06,0
2034-04-06,22:37:00,Pawn Stars,-166.01,London EN,46738,5673.05,1
2034-04-06,14:20:00,Starbucks,-13.77,Winter Park FL,32789,5825.29,0
2034-04-06,09:17:00,Movie Theater,-35.45,Oviedo FL,32765,5789.84,0
2034-04-06,19:25:00,Burger King,-38.18,Orlando FL,32816,5751.66,0
2034-04-07,09:00:00,Spotify,-11.99,Oviedo FL,32765,5739.67,0
2034-04-07,09:00:00,Internet,-70.89,Oviedo FL,32765,5668.78,0
2034-04-07,09:00:00,ChatGPT Plus,-20.0,Oviedo FL,32765,5648.78,0
2034-04-09,11:56:00,Walgreens,-45.32,Oviedo FL,32765,5603.46,0
2034-04-09,09:39:00,Dollar Tree,-6.96,Winter Park FL,32789,5596.5,0
2034-04-10,08:00:00,Paycheck,2000.0,Oviedo FL,32765,7596.5,0
2034-04-10,12:34:00,Jiffy Lube,-239.94,Oviedo FL,32765,7356.56,0
2034-04-11,16:27:00,Concert Tickets,-80.95,Oviedo FL,32765,7275.61,0
2034-04-11,21:27:00,Walgreens,-40.13,Oviedo FL,32765,7235.48,0
2034-04-11,17:29:00,Starbucks,-27.23,Winter Park FL,32789,7208.25,0
2034-04-11,00:58:00,Onlyfans,-1006.91,Honolulu HI,60635,6201.34,1
2034-04-12,08:45:00,Walmart,-123.52,Orlando FL,32816,7084.73,0
2034-04-12,14:32:00,Walgreens,-75.19,Oviedo FL,32765,7009.54,0
2034-04-12,09:03:00,Subway,-32.87,Orlando FL,32816,6976.67,0
2034-04-14,10:32:00,Exxon,-36.37,Orlando FL,32816,6940.3,0
2034-04-15,11:33:00,Five Below,-73.42,Orlando FL,32816,6866.88,0
2034-04-15,11:44:00,Kroger,-191.59,Winter Park FL,32789,6675.29,0
2034-04-16,09:01:00,Netflix,-93.44,Oviedo FL,32765,6581.85,0
2034-04-16,15:02:00,Subway,-16.8,Orlando FL,32816,6565.05,0
2034-04-16,20:02:00,Target,-174.0,Winter Park FL,32789,6391.05,0
2034-04-17,21:21:00,Best Buy,-273.56,Orlando FL,32816,6117.49,0
2034-04-17,11:16:00,Impractical Jokers,-165.94,Tokyo JP,37794,5951.55,1
2034-04-18,16:34:00,Burger King,-19.69,Oviedo FL,32765,6097.8,0
2034-04-18,17:41:00,Subway,-62.62,Orlando FL,32816,6035.18,0
2034-04-18,08:58:00,Starbucks,-46.5,Winter Park FL,32789,5988.68,0
2034-04-19,11:06:00,Burger King,-25.41,Orlando FL,32816,5963.27,0
2034-04-20,09:56:00,Target,-64.37,Orlando FL,32816,5898.9,0
2034-04-20,15:11:00,CVS,-22.04,Orlando FL,32816,5876.86,0
2034-04-21,08:02:00,Five Below,-31.04,Orlando FL,32816,5845.82,0
2034-04-21,20:10:00,Burger King,-15.64,Winter Park FL,32789,5830.18,0
2034-04-21,19:21:00,Burger King,-24.72,Oviedo FL,32765,5805.46,0
2034-04-24,08:00:00,Paycheck,2000.0,Oviedo FL,32765,7805.46,0
2034-04-24,16:59:00,Walmart,-271.97,Winter Park FL,32789,7533.49,0
2034-04-24,08:59:00,Publix,-85.61,Oviedo FL,32765,7447.88,0
2034-04-25,13:57:00,Publix,-113.08,Orlando FL,32816,7334.8,0
2034-04-25,11:11:00,Walmart,-105.5,Oviedo FL,32765,7229.3,0
2034-04-26,09:49:00,Best Buy,-243.8,Winter Park FL,32789,6985.5,0
2034-04-26,16:23:00,Whole Foods,-131.47,Winter Park FL,32789,6854.03,0
2034-04-28,12:23:00,McDonald's,-66.59,Orlando FL,32816,6787.44,0
2034-04-28,18:58:00,Subway,-62.87,Oviedo FL,32765,6724.57,0
2034-04-29,14:51:00,Publix,-158.42,Winter Park FL,32789,6566.15,0
2034-04-29,13:20:00,Starbucks,-35.74,Orlando FL,32816,6530.41,0
2034-04-29,10:22:00,IBM,-301.92,Pyongyang NK,30371,6228.49,1
2034-04-29,16:20:00,Chevron,-42.39,Orlando FL,32816,6488.02,0
2034-04-30,10:36:00,Target,-139.87,Oviedo FL,32765,6348.15,0
2034-04-30,11:42:00,Impractical Jokers,-930.47,New York NY,86910,5417.68,1
2034-04-30,09:25:00,Netflix,-80.28,Oviedo FL,32765,6267.87,0
2034-04-30,08:13:00,Subway,-71.94,Orlando FL,32816,6195.93,0
2034-05-01,09:00:00,Rent,-960.0,Oviedo FL,32765,5235.93,0
2034-05-01,09:00:00,Insurance,-197.46,Oviedo FL,32765,5038.47,0
2034-05-01,09:00:00,Car,-300.0,Oviedo FL,32765,4738.47,0
2034-05-01,15:10:00,Kroger,-30.08,Winter Park FL,32789,4708.39,0
2034-05-01,11:36:00,Shell,-22.97,Oviedo FL,32765,4685.42,0
2034-05-01,19:31:00,Impractical Jokers,-496.2,New York NY,37097,4189.22,1
2034-05-01,21:19:00,McDonald's,-10.1,Oviedo FL,32765,4675.32,0
2034-05-02,20:54:00,Subway,-38.14,Winter Park FL,32789,4637.18,0
2034-05-02,10:16:00,Walmart,-41.57,Winter Park FL,32789,4595.61,0
2034-05-03,13:45:00,Pep Boys,-65.83,Winter Park FL,32789,4529.78,0
2034-05-04,09:45:00,McDonald's,-9.63,Oviedo FL,32765,4520.15,0
2034-05-05,11:11:00,Accelerators,-1664.15,Honolulu HI,37628,2856.0,1
2034-05-05,12:48:00,Best Buy,-26.83,Orlando FL,32816,4493.32,0
2034-05-05,21:08:00,IBM,-970.73,New York NY,84851,3522.59,1
2034-05-05,11:38:00,Best Buy,-72.2,Orlando FL,32816,4421.12,0
2034-05-06,20:04:00,Monster Energy,-1605.18,Anchorage AL,62113,2815.94,1
2034-05-07,09:00:00,Spotify,-11.99,Oviedo FL,32765,4409.13,0
2034-05-07,09:00:00,Internet,-70.89,Oviedo FL,32765,4338.24,0
2034-05-07,09:00:00,ChatGPT Plus,-20.0,Oviedo FL,32765,4318.24,0
2034-05-07,12:22:00,McDonald's,-38.34,Winter Park FL,32789,4279.9,0
2034-05-07,21:42:00,Best Buy,-110.8,Oviedo FL,32765,4169.1,0
2034-05-07,07:48:00,Monster Energy,-1409.69,New York NY,40319,2759.41,1
2034-05-07,19:29:00,Starbucks,-25.83,Winter Park FL,32789,4143.27,0
2034-05-08,08:00:00,Paycheck,2000.0,Oviedo FL,32765,6143.27,0
2034-05-08,12:26:00,Burger King,-73.65,Oviedo FL,32765,6069.62,0
2034-05-09,18:01:00,Amusement Park,-91.99,Oviedo FL,32765,5977.63,0
2034-05-09,11:56:00,Amazon,-50.45,Orlando FL,32816,5927.18,0
2034-05-09,15:42:00,Burger King,-5.4,Orlando FL,32816,5921.78,0
2034-05-10,12:01:00,Exxon,-16.61,Orlando FL,32816,5905.17,0
2034-05-10,13:16:00,Kroger,-87.95,Orlando FL,32816,5817.22,0
2034-05-12,16:34:00,Dollar Tree,-14.2,Oviedo FL,32765,5803.02,0
2034-05-12,18:13:00,Walmart,-139.38,Oviedo FL,32765,5663.64,0
2034-05-13,16:47:00,Subway,-12.18,Winter Park FL,32789,5651.46,0
2034-05-13,18:39:00,Burger King,-7.22,Oviedo FL,32765,5644.24,0
2034-05-14,12:53:00,Dollar Tree,-41.42,Orlando FL,32816,5602.82,0
2034-05-15,20:20:00,Kroger,-85.59,Winter Park FL,32789,5517.23,0
2034-05-15,14:03:00,McDonald's,-25.21,Oviedo FL,32765,5492.02,0
2034-05-15,11:29:00,Exxon,-28.11,Oviedo FL,32765,5463.91,0
2034-05-16,18:02:00,Burger King,-6.97,Orlando FL,32816,5456.94,0
2034-05-16,10:05:00,Five Below,-47.81,Orlando FL,32816,5409.13,0
2034-05-17,13:16:00,Kroger,-45.74,Orlando FL,32816,5363.39,0
2034-05-17,08:50:00,CVS,-6.8,Orlando FL,32816,5356.59,0
2034-05-17,12:27:00,CVS,-38.95,Orlando FL,32816,5317.64,0
2034-05-17,04:09:00,IBM,-207.99,Honolulu HI,53516,5109.65,1
2034-05-18,12:42:00,CVS,-25.01,Orlando FL,32816,5292.63,0
2034-05-18,00:09:00,Impractical Jokers,-945.01,Pittsburgh PA,24409,4347.62,1
2034-05-18,16:21:00,Subway,-35.9,Oviedo FL,32765,5256.73,0
2034-05-18,08:58:00,Impractical Jokers,-277.1,Pittsburgh PA,65195,4979.63,1
2034-05-20,15:37:00,Walmart,-34.7,Winter Park FL,32789,5222.03,0
2034-05-21,20:49:00,Best Buy,-50.54,Winter Park FL,32789,5171.49,0
2034-05-21,14:07:00,Subway,-18.23,Orlando FL,32816,5153.26,0
2034-05-21,08:49:00,Walgreens,-48.11,Winter Park FL,32789,5105.15,0
2034-05-22,08:00:00,Paycheck,2000.0,Oviedo FL,32765,7105.15,0
2034-05-22,08:59:00,Publix,-160.66,Oviedo FL,32765,6944.49,0
2034-05-22,18:22:00,Amazon,-132.9,Winter Park FL,32789,6811.59,0
2034-05-25,12:53:00,Starbucks,-45.52,Orlando FL,32816,6766.07,0
2034-05-25,16:27:00,Midas,-334.68,Winter Park FL,32789,6431.39,0
2034-05-25,18:20:00,Walmart,-38.03,Orlando FL,32816,6393.36,0
2034-05-27,19:40:00,Burger King,-49.44,Orlando FL,32816,6343.92,0
2034-05-27,03:49:00,Monster Energy,-2737.54,Charleston SC,89700,3606.38,1
2034-05-27,16:56:00,Dollar Tree,-93.46,Winter Park FL,32789,6250.46,0
2034-05-27,20:16:00,Magic the Gathering,-1760.69,Groton CT,51541,4489.77,1
2034-05-28,08:30:00,Starbucks,-70.07,Orlando FL,32816,6180.39,0
2034-05-28,13:21:00,Kroger,-63.27,Orlando FL,32816,6117.12,0
2034-05-28,21:34:00,BP,-52.25,Winter Park FL,32789,6064.87,0
2034-05-29,12:49:00,CVS,-95.7,Orlando FL,32816,5969.17,0
2034-05-30,11:09:00,Paypal,-2869.76,Pyongyang NK,86201,3099.41,1
2034-05-30,10:11:00,Whole Foods,-53.26,Orlando FL,32816,5915.91,0
2034-05-30,21:30:00,Pep Boys,-182.4,Oviedo FL,32765,5733.51,0
2034-05-31,20:38:00,McDonald's,-15.19,Oviedo FL,32765,5718.32,0
2034-06-01,09:00:00,Rent,-960.0,Oviedo FL,32765,4758.32,0
2034-06-01,09:00:00,Insurance,-197.46,Oviedo FL,32765,4560.86,0
2034-06-01,09:00:00,Car,-300.0,Oviedo FL,32765,4260.86,0
2034-06-01,15:14:00,McDonald's,-20.86,Oviedo FL,32765,4240.0,0
2034-06-01,08:04:00,Movie Theater,-59.29,Winter Park FL,32789,4180.71,0
2034-06-01,19:50:00,Accelerators,-676.55,Los Angeles CA,64317,3504.16,1
2034-06-01,19:03:00,Starbucks,-27.92,Oviedo FL,32765,4152.79,0
2034-06-02,08:54:00,McDonald's,-11.26,Winter Park FL,32789,4141.53,0
2034-06-02,09:31:00,McDonald's,-32.17,Oviedo FL,32765,4109.36,0
2034-06-02,19:11:00,McDonald's,-11.44,Winter Park FL,32789,4097.92,0
2034-06-03,18:46:00,Trader Joe's,-88.79,Winter Park FL,32789,4009.13,0
2034-06-04,15:41:00,Shell,-18.32,Oviedo FL,32765,3990.81,0
2034-06-04,09:44:00,McDonald's,-12.22,Winter Park FL,32789,3978.59,0
2034-06-05,08:00:00,Paycheck,2000.0,Oviedo FL,32765,5978.59,0
2034-06-05,15:48:00,Netflix,-48.66,Oviedo FL,32765,5929.93,0
2034-06-05,15:04:00,McDonald's,-9.32,Winter Park FL,32789,5920.61,0
2034-06-05,14:30:00,Burger King,-39.58,Orlando FL,32816,5881.03,0
2034-06-06,18:44:00,Whole Foods,-56.33,Oviedo FL,32765,5824.7,0
2034-06-06,11:32:00,McDonald's,-16.55,Orlando FL,32816,5808.15,0
2034-06-06,20:08:00,Pawn Stars,-444.25,New York NY,81433,5363.9,1
2034-06-07,09:00:00,Spotify,-11.99,Oviedo FL,32765,5796.16,0
2034-06-07,09:00:00,Internet,-70.89,Oviedo FL,32765,5725.27,0
2034-06-07,09:00:00,ChatGPT Plus,-20.0,Oviedo FL,32765,5705.27,0
2034-06-07,11:08:00,Concert Tickets,-42.6,Winter Park FL,32789,5662.67,0
2034-06-07,19:27:00,Pawn Stars,-2213.91,London EN,71663,3448.76,1
2034-06-08,12:55:00,Midas,-48.46,Orlando FL,32816,5614.21,0
2034-06-08,10:56:00,Shell,-21.2,Oviedo FL,32765,5593.01,0
2034-06-08,08:44:00,Chevron,-17.7,Winter Park FL,32789,5575.31,0
2034-06-10,20:25:00,McDonald's,-12.02,Oviedo FL,32765,5563.29,0
2034-06-10,14:07:00,Target,-12.73,Winter Park FL,32789,5550.56,0
2034-06-11,16:59:00,Burger King,-20.57,Winter Park FL,32789,5529.99,0
2034-06-11,13:12:00,Subway,-25.2,Oviedo FL,32765,5504.79,0
2034-06-12,16:47:00,Subway,-15.08,Winter Park FL,32789,5489.71,0
2034-06-13,17:10:00,Whole Foods,-54.33,Oviedo FL,32765,5435.38,0
2034-06-13,20:33:00,Dollar Tree,-44.21,Winter Park FL,32789,5391.17,0
2034-06-13,19:02:00,Starbucks,-6.41,Winter Park FL,32789,5384.76,0
2034-06-15,18:53:00,Publix,-48.36,Orlando FL,32816,5336.4,0
2034-06-17,14:40:00,Publix,-74.83,Oviedo FL,32765,5261.57,0
2034-06-17,20:31:00,Amazon,-122.0,Oviedo FL,32765,5139.57,0
2034-06-17,09:28:00,Shell,-16.51,Orlando FL,32816,5123.06,0
2034-06-18,17:45:00,Best Buy,-135.06,Oviedo FL,32765,4988.0,0
2034-06-18,19:20:00,McDonald's,-23.55,Winter Park FL,32789,4964.45,0
2034-06-19,08:00:00,Paycheck,2000.0,Oviedo FL,32765,6964.45,0
2034-06-19,17:48:00,Whole Foods,-173.76,Orlando FL,32816,6790.69,0
2034-06-21,11:52:00,Amusement Park,-62.97,Oviedo FL,32765,6727.72,0
2034-06-22,11:52:00,Target,-199.28,Winter Park FL,32789,6528.44,0
2034-06-23,20:00:00,CVS,-20.24,Winter Park FL,32789,6508.2,0
2034-06-24,07:17:00,Servicenow,-1446.05,New York NY,39270,5062.15,1
2034-06-24,19:35:00,Five Below,-13.08,Orlando FL,32816,6495.12,0
2034-06-24,15:47:00,Subway,-63.11,Winter Park FL,32789,6432.01,0
2034-06-24,14:22:00,Subway,-22.66,Oviedo FL,32765,6409.35,0
2034-06-25,17:34:00,Exxon,-38.3,Orlando FL,32816,6371.05,0
2034-06-26,08:57:00,Dollar Tree,-35.19,Winter Park FL,32789,6335.86,0
2034-06-26,11:43:00,Burger King,-18.9,Oviedo FL,32765,6316.96,0
2034-06-26,12:45:00,Movie Theater,-77.41,Oviedo FL,32765,6239.55,0
2034-06-28,14:21:00,Walgreens,-96.04,Oviedo FL,32765,6143.51,0
2034-06-28,22:21:00,Fat Joe,-454.36,Los Angeles CA,48806,5689.15,1
2034-06-29,06:10:00,Lockheed Martin,-2531.68,Honolulu HI,16979,3611.83,1
2034-06-29,12:08:00,Concert Tickets,-112.6,Orlando FL,32816,6030.91,0
2034-06-29,16:05:00,Target,-192.71,Winter Park FL,32789,5838.2,0
2034-06-29,17:32:00,Walmart,-48.5,Winter Park FL,32789,5789.7,0
2034-06-30,10:24:00,Amazon,-20.01,Orlando FL,32816,5769.69,0
2034-06-30,19:51:00,Fat Joe,-2263.07,Pittsburgh PA,31916,3506.62,1
2034-07-01,09:00:00,Rent,-960.0,Oviedo FL,32765,4809.69,0
2034-07-01,09:00:00,Insurance,-197.46,Oviedo FL,32765,4612.23,0
2034-07-01,09:00:00,Car,-300.0,Oviedo FL,32765,4312.23,0
2034-07-01,10:43:00,Whole Foods,-42.35,Oviedo FL,32765,4269.88,0
2034-07-01,18:18:00,Starbucks,-5.07,Orlando FL,32816,4264.81,0
2034-07-02,08:16:00,Shell,-27.32,Oviedo FL,32765,4237.49,0
2034-07-03,08:00:00,Paycheck,2000.0,Oviedo FL,32765,6237.49,0
2034-07-03,08:27:00,Best Buy,-76.7,Oviedo FL,32765,6160.79,0
2034-07-03,17:53:00,Magic the Gathering,-2402.89,Honolulu HI,48156,3757.9,1
2034-07-03,20:18:00,Burger King,-32.46,Oviedo FL,32765,6128.33,0
2034-07-03,20:45:00,Netflix,-92.83,Oviedo FL,32765,6035.5,0
2034-07-04,08:24:00,Amusement Park,-107.02,Oviedo FL,32765,5928.48,0
2034-07-05,17:31:00,Amazon,-30.57,Oviedo FL,32765,5897.91,0
2034-07-05,13:04:00,Concert Tickets,-21.0,Orlando FL,32816,5876.91,0
2034-07-05,17:10:00,Walmart,-79.78,Oviedo FL,32765,5797.13,0
2034-07-07,09:00:00,Spotify,-11.99,Oviedo FL,32765,5785.14,0
2034-07-07,09:00:00,Internet,-70.89,Oviedo FL,32765,5714.25,0
2034-07-07,09:00:00,ChatGPT Plus,-20.0,Oviedo FL,32765,5694.25,0
2034-07-08,03:02:00,Paypal,-120.12,Mexico City MC,67537,5574.13,1
2034-07-09,08:10:00,Subway,-22.69,Oviedo FL,32765,5671.56,0
2034-07-09,10:27:00,Subway,-17.34,Orlando FL,32816,5654.22,0
2034-07-09,20:37:00,Walmart,-62.98,Winter Park FL,32789,5591.24,0
2034-07-09,12:56:00,Paypal,-1408.84,Charleston SC,29749,4182.4,1
2034-07-10,12:40:00,Accelerators,-650.84,London EN,27377,4940.4,1
2034-07-10,13:41:00,Netflix,-29.87,Winter Park FL,32789,5561.37,0
2034-07-12,13:39:00,McDonald's,-9.29,Winter Park FL,32789,5552.08,0
2034-07-13,21:04:00,Target,-46.49,Winter Park FL,32789,5505.59,0
2034-07-13,16:54:00,Amazon,-52.97,Orlando FL,32816,5452.62,0
2034-07-13,17:17:00,Starbucks,-19.98,Orlando FL,32816,5432.64,0
2034-07-14,10:24:00,Netflix,-29.73,Winter Park FL,32789,5402.91,0
2034-07-14,23:43:00,Impractical Jokers,-2252.97,Anchorage AL,48113,3149.94,1
2034-07-17,08:00:00,Paycheck,2000.0,Oviedo FL,32765,7402.91,0
2034-07-17,20:21:00,Publix,-122.44,Oviedo FL,32765,7280.47,0
2034-07-17,21:39:00,McDonald's,-37.34,Oviedo FL,32765,7243.13,0
2034-07-19,03:39:00,Accelerators,-1716.37,London EN,43096,5526.76,1
2034-07-19,12:20:00,Publix,-160.6,Orlando FL,32816,7082.53,0
2034-07-19,08:11:00,Netflix,-94.21,Winter Park FL,32789,6988.32,0
2034-07-20,16:14:00,Amazon,-275.35,Oviedo FL,32765,6712.97,0
2034-07-20,15:59:00,Exxon,-33.9,Winter Park FL,32789,6679.07,0
2034-07-20,09:25:00,Walmart,-229.2,Orlando FL,32816,6449.87,0
2034-07-21,11:35:00,Subway,-43.36,Oviedo FL,32765,6406.51,0
2034-07-22,17:56:00,Target,-170.56,Oviedo FL,32765,6235.95,0
2034-07-22,16:51:00,McDonald's,-57.01,Winter Park FL,32789,6178.94,0
2034-07-25,13:08:00,Walmart,-279.07,Winter Park FL,32789,5899.87,0
2034-07-26,03:46:00,Pawn Stars,-2092.24,Anchorage AL,12342,3807.63,1
2034-07-27,17:09:00,Starbucks,-22.8,Winter Park FL,32789,5877.07,0
2034-07-27,11:49:00,Kroger,-60.18,Winter Park FL,32789,5816.89,0
2034-07-28,14:58:00,Burger King,-22.49,Winter Park FL,32789,5794.4,0
2034-07-28,14:51:00,Whole Foods,-92.59,Oviedo FL,32765,5701.81,0
2034-07-29,19:34:00,Movie Theater,-57.37,Oviedo FL,32765,5644.44,0
2034-07-29,14:06:00,Amazon,-71.95,Winter Park FL,32789,5572.49,0
2034-07-30,12:46:00,Kroger,-99.31,Oviedo FL,32765,5473.18,0
2034-07-30,12:30:00,Starbucks,-20.44,Oviedo FL,32765,5452.74,0
2034-07-31,08:00:00,Paycheck,2000.0,Oviedo FL,32765,7452.74,0
2034-07-31,15:34:00,Five Below,-75.09,Oviedo FL,32765,7377.65,0
2034-07-31,21:33:00,Burger King,-25.79,Orlando FL,32816,7351.86,0
2034-07-31,10:48:00,Walmart,-72.73,Orlando FL,32816,7279.13,0
2034-08-01,09:00:00,Rent,-960.0,Oviedo FL,32765,6319.13,0
2034-08-01,09:00:00,Insurance,-197.46,Oviedo FL,32765,6121.67,0
2034-08-01,09:00:00,Car,-300.0,Oviedo FL,32765,5821.67,0
2034-08-01,09:25:00,Burger King,-21.27,Winter Park FL,32789,5800.4,0
2034-08-01,17:34:00,Amusement Park,-37.77,Oviedo FL,32765,5762.63,0
2034-08-01,07:03:00,Onlyfans,-511.12,Los Angeles CA,99423,5251.51,1
2034-08-04,16:45:00,McDonald's,-11.86,Oviedo FL,32765,5750.77,0
2034-08-04,12:46:00,AutoZone,-196.07,Orlando FL,32816,5554.7,0
2034-08-05,21:54:00,BP,-13.75,Oviedo FL,32765,5540.95,0
2034-08-07,09:00:00,Spotify,-11.99,Oviedo FL,32765,5528.96,0
2034-08-07,09:00:00,Internet,-70.89,Oviedo FL,32765,5458.07,0
2034-08-07,09:00:00,ChatGPT Plus,-20.0,Oviedo FL,32765,5438.07,0
2034-08-07,13:37:00,Monster Energy,-1956.55,Tokyo JP,27544,3481.52,1
2034-08-07,12:51:00,Starbucks,-6.91,Orlando FL,32816,5431.16,0
2034-08-07,09:01:00,Starbucks,-38.26,Winter Park FL,32789,5392.9,0
2034-08-07,15:19:00,Walgreens,-19.84,Winter Park FL,32789,5373.06,0
2034-08-09,09:14:00,Concert Tickets,-12.29,Winter Park FL,32789,5360.77,0
2034-08-09,15:08:00,Burger King,-6.24,Winter Park FL,32789,5354.53,0
2034-08-09,12:55:00,Starbucks,-34.4,Oviedo FL,32765,5320.13,0
2034-08-10,19:24:00,Best Buy,-15.96,Winter Park FL,32789,5304.17,0
2034-08-10,10:32:00,Subway,-15.23,Orlando FL,32816,5288.94,0
2034-08-10,08:57:00,CVS,-45.49,Oviedo FL,32765,5243.45,0
2034-08-11,10:47:00,Best Buy,-81.69,Winter Park FL,32789,5161.76,0
2034-08-12,13:14:00,Target,-132.09,Winter Park FL,32789,5029.67,0
2034-08-14,08:00:00,Paycheck,2000.0,Oviedo FL,32765,7029.67,0
2034-08-15,15:09:00,Movie Theater,-71.41,Orlando FL,32816,6958.26,0
2034-08-15,12:58:00,Burger King,-61.93,Oviedo FL,32765,6896.33,0
2034-08-15,11:50:00,Amusement Park,-24.08,Orlando FL,32816,6872.25,0
2034-08-16,12:52:00,McDonald's,-76.41,Orlando FL,32816,6795.84,0
2034-08-16,18:57:00,Concert Tickets,-109.3,Winter Park FL,32789,6686.54,0
2034-08-16,14:27:00,Starbucks,-48.04,Orlando FL,32816,6638.5,0
2034-08-17,12:13:00,McDonald's,-58.86,Oviedo FL,32765,6579.64,0
2034-08-17,12:32:00,Concert Tickets,-86.18,Winter Park FL,32789,6493.46,0
2034-08-18,21:20:00,Exxon,-34.09,Winter Park FL,32789,6459.37,0
2034-08-19,16:40:00,McDonald's,-62.18,Orlando FL,32816,6397.19,0
2034-08-20,12:42:00,Dollar Tree,-18.89,Oviedo FL,32765,6378.3,0
2034-08-20,20:07:00,Starbucks,-22.37,Oviedo FL,32765,6355.93,0
2034-08-20,09:23:00,Paypal,-2815.5,Los Angeles CA,21862,3540.43,1
2034-08-20,08:52:00,Netflix,-93.97,Oviedo FL,32765,6261.96,0
2034-08-21,15:43:00,Burger King,-49.85,Oviedo FL,32765,6212.11,0
2034-08-21,11:28:00,Impractical Jokers,-1270.25,Pyongyang NK,92599,4941.86,1
2034-08-21,17:45:00,Exxon,-35.92,Oviedo FL,32765,6176.19,0
2034-08-22,18:23:00,Fat Joe,-1778.59,Charleston SC,25113,4397.6,1
2034-08-23,10:29:00,Burger King,-50.09,Winter Park FL,32789,6126.1,0
2034-08-25,11:35:00,Five Below,-11.8,Winter Park FL,32789,6114.3,0
2034-08-25,11:05:00,Starbucks,-29.0,Orlando FL,32816,6085.3,0
2034-08-26,16:10:00,Subway,-53.31,Orlando FL,32816,6031.99,0
2034-08-26,13:37:00,Five Below,-64.58,Oviedo FL,32765,5967.41,0
2034-08-26,16:56:00,Walgreens,-37.58,Winter Park FL,32789,5929.83,0
2034-08-27,17:02:00,Chevron,-26.02,Oviedo FL,32765,5903.81,0
2034-08-28,08:00:00,Paycheck,2000.0,Oviedo FL,32765,7903.81,0
2034-08-28,20:59:00,Amusement Park,-93.91,Orlando FL,32816,7809.9,0
2034-08-29,11:02:00,Publix,-110.24,Oviedo FL,32765,7699.66,0
2034-08-29,12:45:00,Dollar Tree,-14.09,Oviedo FL,32765,7685.57,0
2034-08-29,15:35:00,Whole Foods,-129.09,Oviedo FL,32765,7556.48,0
2034-08-31,11:46:00,Subway,-71.43,Orlando FL,32816,7485.05,0
2034-08-31,12:28:00,Burger King,-59.04,Winter Park FL,32789,7426.01,0
2034-08-31,09:13:00,Starbucks,-40.58,Oviedo FL,32765,7385.43,0
2034-09-01,09:00:00,Rent,-960.0,Oviedo FL,32765,6425.43,0
2034-09-01,09:00:00,Insurance,-197.46,Oviedo FL,32765,6227.97,0
2034-09-01,09:00:00,Car,-300.0,Oviedo FL,32765,5927.97,0
2034-09-01,08:00:00,Target,-84.32,Oviedo FL,32765,5843.65,0
2034-09-01,09:34:00,McDonald's,-32.51,Winter Park FL,32789,5811.14,0
2034-09-01,06:40:00,Paypal,-433.07,Honolulu HI,52589,5378.07,1
2034-09-01,08:40:00,Subway,-32.26,Oviedo FL,32765,5778.88,0
2034-09-02,16:43:00,McDonald's,-33.54,Orlando FL,32816,5745.34,0
2034-09-03,16:44:00,Exxon,-22.45,Oviedo FL,32765,5722.89,0
2034-09-03,10:43:00,McDonald's,-24.61,Oviedo FL,32765,5698.28,0
2034-09-03,17:05:00,CVS,-42.21,Oviedo FL,32765,5656.07,0
2034-09-04,19:05:00,Target,-75.77,Oviedo FL,32765,5580.3,0
2034-09-04,13:50:00,Trader Joe's,-34.83,Winter Park FL,32789,5545.47,0
2034-09-04,21:08:00,Starbucks,-39.61,Winter Park FL,32789,5505.86,0
2034-09-05,21:06:00,CVS,-7.25,Winter Park FL,32789,5498.61,0
2034-09-05,12:52:00,Movie Theater,-24.87,Orlando FL,32816,5473.74,0
2034-09-06,10:14:00,BP,-29.38,Orlando FL,32816,5444.36,0
2034-09-07,09:00:00,Spotify,-11.99,Oviedo FL,32765,5432.37,0
2034-09-07,09:00:00,Internet,-70.89,Oviedo FL,32765,5361.48,0
2034-09-07,09:00:00,ChatGPT Plus,-20.0,Oviedo FL,32765,5341.48,0
2034-09-07,09:39:00,McDonald's,-20.18,Winter Park FL,32789,5321.3,0
2034-09-07,15:57:00,Dollar Tree,-35.14,Oviedo FL,32765,5286.16,0
2034-09-07,11:07:00,Lockheed Martin,-694.56,Charleston SC,36479,4591.6,1
2034-09-08,18:45:00,Movie Theater,-34.16,Oviedo FL,32765,5252.0,0
2034-09-08,14:54:00,Burger King,-30.04,Orlando FL,32816,5221.96,0
2034-09-08,15:00:00,Fraud,-1732.22,Groton CT,47944,3489.74,1
2034-09-08,15:00:00,Pep Boys,-165.94,Oviedo FL,32765,5056.02,0
2034-09-09,14:40:00,Midas,-176.09,Oviedo FL,32765,4879.93,0
2034-09-09,09:37:00,Burger King,-25.94,Oviedo FL,32765,4853.99,0
2034-09-09,14:41:00,Subway,-16.84,Orlando FL,32816,4837.15,0
2034-09-10,07:33:00,Servicenow,-2636.35,Los Angeles CA,71164,2200.8,1
2034-09-11,08:00:00,Paycheck,2000.0,Oviedo FL,32765,6837.15,0
2034-09-11,16:40:00,Burger King,-41.41,Winter Park FL,32789,6795.74,0
2034-09-12,19:24:00,Walmart,-230.7,Winter Park FL,32789,6565.04,0
2034-09-12,20:37:00,Dollar Tree,-20.14,Oviedo FL,32765,6544.9,0
2034-09-13,13:33:00,Best Buy,-278.48,Winter Park FL,32789,6266.42,0
2034-09-14,17:20:00,BP,-35.8,Orlando FL,32816,6230.62,0
2034-09-15,12:13:00,Burger King,-67.59,Orlando FL,32816,6163.03,0
2034-09-15,17:01:00,Amusement Park,-68.07,Oviedo FL,32765,6094.96,0
2034-09-15,10:49:00,Walgreens,-59.72,Oviedo FL,32765,6035.24,0
2034-09-16,06:38:00,Accelerators,-2312.9,Charleston SC,48676,3722.34,1
2034-09-16,13:16:00,Amazon,-20.46,Winter Park FL,32789,6014.78,0
2034-09-16,16:38:00,Walmart,-269.31,Orlando FL,32816,5745.47,0
2034-09-17,16:11:00,McDonald's,-18.93,Winter Park FL,32789,5726.54,0
2034-09-19,18:11:00,Subway,-21.5,Winter Park FL,32789,5705.04,0
2034-09-19,21:27:00,CVS,-21.94,Winter Park FL,32789,5683.1,0
2034-09-19,17:38:00,Amazon,-83.54,Winter Park FL,32789,5599.56,0
2034-09-20,20:36:00,Kroger,-38.69,Orlando FL,32816,5560.87,0
2034-09-20,13:52:00,Lockheed Martin,-2530.76,Tokyo JP,83892,3030.11,1
2034-09-21,17:23:00,Subway,-5.03,Oviedo FL,32765,5555.84,0
2034-09-21,18:25:00,Starbucks,-38.88,Oviedo FL,32765,5516.96,0
2034-09-22,10:32:00,Subway,-27.89,Oviedo FL,32765,5489.07,0
2034-09-22,17:14:00,Starbucks,-15.18,Oviedo FL,32765,5473.89,0
2034-09-23,15:47:00,Movie Theater,-57.21,Winter Park FL,32789,5416.68,0
2034-09-24,04:20:00,Lockheed Martin,-345.23,Pyongyang NK,40501,5071.45,1
2034-09-24,20:34:00,Five Below,-41.9,Winter Park FL,32789,5374.78,0
2034-09-25,08:00:00,Paycheck,2000.0,Oviedo FL,32765,7374.78,0
2034-09-25,14:51:00,Concert Tickets,-36.94,Orlando FL,32816,7337.84,0
2034-09-25,14:50:00,Trader Joe's,-153.91,Oviedo FL,32765,7183.93,0
2034-09-25,21:32:00,Walmart,-68.99,Winter Park FL,32789,7114.94,0
2034-09-26,02:08:00,Impractical Jokers,-1230.77,Pyongyang NK,52918,5884.17,1
2034-09-27,19:58:00,Publix,-82.86,Oviedo FL,32765,7032.08,0
2034-09-27,16:40:00,Midas,-275.08,Winter Park FL,32789,6757.0,0
2034-09-27,15:12:00,Subway,-74.77,Oviedo FL,32765,6682.23,0
2034-09-27,05:56:00,Monster Energy,-653.46,Pyongyang NK,43911,6028.77,1
2034-09-28,17:25:00,Movie Theater,-67.3,Orlando FL,32816,6614.93,0
2034-09-28,10:13:00,Best Buy,-281.0,Orlando FL,32816,6333.93,0
2034-09-29,20:18:00,Exxon,-38.79,Oviedo FL,32765,6295.14,0
2034-09-29,10:59:00,Amusement Park,-52.62,Oviedo FL,32765,6242.52,0
2034-10-01,09:00:00,Rent,-960.0,Oviedo FL,32765,5282.52,0
2034-10-01,09:00:00,Insurance,-197.46,Oviedo FL,32765,5085.06,0
2034-10-01,09:00:00,Car,-300.0,Oviedo FL,32765,4785.06,0
2034-10-01,07:57:00,Fat Joe,-2372.62,Los Angeles CA,23238,2412.44,1
2034-10-01,16:56:00,Concert Tickets,-42.08,Oviedo FL,32765,4742.98,0
2034-10-01,09:22:00,Starbucks,-13.31,Orlando FL,32816,4729.67,0
2034-10-01,12:02:00,Jiffy Lube,-76.32,Winter Park FL,32789,4653.35,0
2034-10-02,12:48:00,McDonald's,-32.67,Oviedo FL,32765,4620.68,0
2034-10-02,19:38:00,McDonald's,-39.64,Winter Park FL,32789,4581.04,0
2034-10-02,12:05:00,Amusement Park,-51.74,Orlando FL,32816,4529.3,0
2034-10-03,18:43:00,Best Buy,-35.79,Orlando FL,32816,4493.51,0
2034-10-04,16:04:00,Amazon,-16.23,Winter Park FL,32789,4477.28,0
2034-10-04,15:56:00,Subway,-27.73,Winter Park FL,32789,4449.55,0
2034-10-05,12:44:00,Jiffy Lube,-116.33,Winter Park FL,32789,4333.22,0
2034-10-06,14:07:00,Amusement Park,-14.05,Oviedo FL,32765,4319.17,0
2034-10-06,12:51:00,Subway,-34.13,Oviedo FL,32765,4285.04,0
2034-10-07,09:00:00,Spotify,-11.99,Oviedo FL,32765,4273.05,0
2034-10-07,09:00:00,Internet,-70.89,Oviedo FL,32765,4202.16,0
2034-10-07,09:00:00,ChatGPT Plus,-20.0,Oviedo FL,32765,4182.16,0
2034-10-07,09:43:00,Amazon,-91.16,Orlando FL,32816,4091.0,0
2034-10-07,13:59:00,Fraud,-2550.5,Honolulu HI,77172,1540.5,1
2034-10-08,13:01:00,McDonald's,-8.82,Orlando FL,32816,4082.18,0
2034-10-08,12:00:00,Movie Theater,-17.0,Winter Park FL,32789,4065.18,0
2034-10-08,08:39:00,McDonald's,-26.93,Oviedo FL,32765,4038.25,0
2034-10-09,08:00:00,Paycheck,2000.0,Oviedo FL,32765,6038.25,0
2034-10-09,04:15:00,Monster Energy,-1936.45,Mexico City MC,66563,4101.8,1
2034-10-09,20:36:00,Chevron,-52.94,Orlando FL,32816,5985.31,0
2034-10-10,01:39:00,Impractical Jokers,-2036.72,Groton CT,11685,3948.59,1
2034-10-10,19:20:00,Starbucks,-16.76,Orlando FL,32816,5968.55,0
2034-10-10,02:55:00,Fraud,-2470.87,Los Angeles CA,71506,3497.68,1
2034-10-11,09:48:00,Fat Joe,-488.18,Tokyo JP,64146,5480.37,1
2034-10-12,16:32:00,Starbucks,-38.91,Orlando FL,32816,5929.64,0
2034-10-12,13:47:00,Walgreens,-15.09,Oviedo FL,32765,5914.55,0
2034-10-14,10:33:00,McDonald's,-8.77,Oviedo FL,32765,5905.78,0
2034-10-14,10:50:00,AutoZone,-185.98,Oviedo FL,32765,5719.8,0
2034-10-15,12:52:00,AutoZone,-41.25,Orlando FL,32816,5678.55,0
2034-10-15,20:39:00,Whole Foods,-67.18,Orlando FL,32816,5611.37,0
2034-10-20,09:31:00,Target,-122.19,Winter Park FL,32789,5489.18,0
2034-10-20,09:33:00,CVS,-39.97,Orlando FL,32816,5449.21,0
2034-10-20,18:44:00,McDonald's,-8.52,Oviedo FL,32765,5440.69,0
2034-10-21,20:54:00,Starbucks,-17.1,Oviedo FL,32765,5423.59,0
2034-10-21,09:35:00,McDonald's,-34.31,Winter Park FL,32789,5389.28,0
2034-10-21,17:26:00,Magic the Gathering,-1419.15,Honolulu HI,37986,3970.13,1
2034-10-21,12:21:00,Midas,-93.3,Orlando FL,32816,5295.98,0
2034-10-22,09:04:00,Concert Tickets,-41.39,Orlando FL,32816,5254.59,0
2034-10-22,20:27:00,Dollar Tree,-7.33,Oviedo FL,32765,5247.26,0
2034-10-22,10:53:00,Burger King,-25.4,Winter Park FL,32789,5221.86,0
2034-10-23,08:00:00,Paycheck,2000.0,Oviedo FL,32765,7221.86,0
2034-10-23,11:49:00,Subway,-11.19,Oviedo FL,32765,7210.67,0
2034-10-23,12:16:00,Walgreens,-85.4,Oviedo FL,32765,7125.27,0
2034-10-23,21:02:00,Chevron,-21.29,Orlando FL,32816,7103.98,0
2034-10-24,11:10:00,Pep Boys,-376.43,Orlando FL,32816,6727.55,0
2034-10-24,08:43:00,McDonald's,-15.72,Orlando FL,32816,6711.83,0
2034-10-25,21:40:00,Pep Boys,-222.2,Oviedo FL,32765,6489.63,0
2034-10-25,07:29:00,Accelerators,-1014.45,Pittsburgh PA,59888,5475.18,1
2034-10-25,10:21:00,BP,-57.44,Oviedo FL,32765,6432.19,0
2034-10-25,08:26:00,Impractical Jokers,-1369.4,London EN,41714,5062.79,1
2034-10-25,21:06:00,Amazon,-53.25,Oviedo FL,32765,6378.94,0
2034-10-26,14:22:00,Amazon,-201.88,Winter Park FL,32789,6177.06,0
2034-10-26,14:59:00,Starbucks,-58.82,Oviedo FL,32765,6118.24,0
2034-10-26,16:43:00,Whole Foods,-136.68,Winter Park FL,32789,5981.56,0
2034-10-26,02:05:00,Onlyfans,-2182.98,Charleston SC,81298,3798.58,1
2034-10-27,18:07:00,Five Below,-8.13,Winter Park FL,32789,5973.43,0
2034-10-27,17:13:00,Five Below,-44.55,Winter Park FL,32789,5928.88,0
2034-10-27,06:51:00,IBM,-1550.99,Anchorage AL,34363,4377.89,1
2034-10-28,21:22:00,Trader Joe's,-48.52,Oviedo FL,32765,5880.36,0
2034-10-28,14:10:00,CVS,-19.9,Orlando FL,32816,5860.46,0
2034-10-28,08:35:00,Concert Tickets,-31.54,Winter Park FL,32789,5828.92,0
2034-10-29,21:34:00,Burger King,-27.57,Winter Park FL,32789,5801.35,0
2034-10-29,13:27:00,Exxon,-21.34,Orlando FL,32816,5780.01,0
2034-10-30,08:39:00,Five Below,-20.92,Orlando FL,32816,5759.09,0
2034-10-30,08:03:00,Dollar Tree,-27.75,Oviedo FL,32765,5731.34,0
2034-10-30,10:37:00,Burger King,-5.52,Orlando FL,32816,5725.82,0
2034-10-31,20:05:00,Amusement Park,-37.55,Winter Park FL,32789,5688.27,0
2034-10-31,10:10:00,Subway,-27.71,Orlando FL,32816,5660.56,0
2034-10-31,16:58:00,Lockheed Martin,-1733.49,Groton CT,61260,3927.07,1
2034-10-31,08:08:00,Best Buy,-80.58,Winter Park FL,32789,5579.98,0
2034-11-01,09:00:00,Rent,-960.0,Oviedo FL,32765,4619.98,0
2034-11-01,09:00:00,Insurance,-197.46,Oviedo FL,32765,4422.52,0
2034-11-01,09:00:00,Car,-300.0,Oviedo FL,32765,4122.52,0
2034-11-01,14:42:00,Exxon,-19.56,Winter Park FL,32789,4102.96,0
2034-11-01,10:25:00,Five Below,-19.27,Orlando FL,32816,4083.69,0
2034-11-01,13:06:00,Subway,-20.58,Winter Park FL,32789,4063.11,0
2034-11-02,14:51:00,Pawn Stars,-2353.18,Los Angeles CA,93251,1709.93,1
2034-11-03,20:59:00,Subway,-30.84,Oviedo FL,32765,4032.27,0
2034-11-04,20:11:00,Dollar Tree,-32.88,Winter Park FL,32789,3999.39,0
2034-11-04,15:31:00,Best Buy,-122.11,Oviedo FL,32765,3877.28,0
2034-11-05,16:30:00,McDonald's,-15.8,Orlando FL,32816,3861.48,0
2034-11-06,08:00:00,Paycheck,2000.0,Oviedo FL,32765,5861.48,0
2034-11-06,12:58:00,McDonald's,-18.36,Oviedo FL,32765,5843.12,0
2034-11-06,13:40:00,Amazon,-79.78,Winter Park FL,32789,5763.34,0
2034-11-06,17:45:00,Starbucks,-32.92,Oviedo FL,32765,5730.42,0
2034-11-07,09:00:00,Spotify,-11.99,Oviedo FL,32765,5718.43,0
2034-11-07,09:00:00,Internet,-70.89,Oviedo FL,32765,5647.54,0
2034-11-07,09:00:00,ChatGPT Plus,-20.0,Oviedo FL,32765,5627.54,0
2034-11-07,18:04:00,CVS,-39.83,Orlando FL,32816,5587.71,0
2034-11-09,08:57:00,Best Buy,-26.79,Orlando FL,32816,5560.92,0
2034-11-09,09:06:00,McDonald's,-34.32,Orlando FL,32816,5526.6,0
2034-11-11,13:22:00,Burger King,-31.8,Orlando FL,32816,5494.8,0
2034-11-11,22:20:00,IBM,-2216.96,Pyongyang NK,46864,3277.84,1
2034-11-12,12:26:00,CVS,-18.12,Orlando FL,32816,5476.68,0
2034-11-12,10:06:00,McDonald's,-30.97,Orlando FL,32816,5445.71,0
2034-11-14,20:10:00,Best Buy,-102.31,Oviedo FL,32765,5343.4,0
2034-11-14,13:07:00,Walgreens,-28.11,Winter Park FL,32789,5315.29,0
2034-11-15,16:46:00,Publix,-36.29,Orlando FL,32816,5279.0,0
2034-11-15,16:40:00,Kroger,-54.42,Winter Park FL,32789,5224.58,0
2034-11-15,12:35:00,Subway,-12.98,Winter Park FL,32789,5211.6,0
2034-11-16,08:28:00,Starbucks,-22.44,Orlando FL,32816,5189.16,0
2034-11-17,12:25:00,Amazon,-17.69,Winter Park FL,32789,5171.47,0
2034-11-19,18:19:00,McDonald's,-32.53,Oviedo FL,32765,5138.94,0
2034-11-19,10:57:00,Dollar Tree,-40.29,Oviedo FL,32765,5098.65,0
2034-11-19,09:56:00,Amusement Park,-36.79,Orlando FL,32816,5061.86,0
2034-11-20,08:00:00,Paycheck,2000.0,Oviedo FL,32765,7061.86,0
2034-11-20,11:18:00,Target,-246.31,Oviedo FL,32765,6815.55,0
2034-11-20,10:28:00,Exxon,-35.04,Orlando FL,32816,6780.51,0
2034-11-21,20:24:00,Five Below,-19.51,Oviedo FL,32765,6761.0,0
2034-11-21,21:50:00,Burger King,-61.51,Oviedo FL,32765,6699.49,0
2034-11-21,11:14:00,Midas,-152.05,Oviedo FL,32765,6547.44,0
2034-11-22,08:40:00,Whole Foods,-157.04,Oviedo FL,32765,6390.4,0
2034-11-22,20:06:00,Five Below,-77.33,Oviedo FL,32765,6313.07,0
2034-11-22,19:36:00,Amazon,-80.34,Oviedo FL,32765,6232.73,0
2034-11-23,20:19:00,Dollar Tree,-53.92,Winter Park FL,32789,6178.81,0
2034-11-23,14:57:00,Amazon,-37.4,Oviedo FL,32765,6141.41,0
2034-11-23,09:20:00,Trader Joe's,-146.66,Orlando FL,32816,5994.75,0
2034-11-23,09:57:00,Monster Energy,-1915.6,Charleston SC,29202,4079.15,1
2034-11-24,18:00:00,Amazon,-115.79,Winter Park FL,32789,5878.96,0
2034-11-24,21:42:00,Chevron,-13.25,Orlando FL,32816,5865.71,0
2034-11-24,16:29:00,Subway,-26.31,Winter Park FL,32789,5839.4,0
2034-11-25,17:59:00,Publix,-33.71,Oviedo FL,32765,5805.69,0
2034-11-26,03:47:00,Onlyfans,-1382.5,Pyongyang NK,35736,4423.19,1
2034-11-26,11:16:00,Exxon,-29.9,Winter Park FL,32789,5775.79,0
2034-11-27,16:08:00,Concert Tickets,-49.16,Oviedo FL,32765,5726.63,0
2034-11-27,21:02:00,Starbucks,-31.85,Orlando FL,32816,5694.78,0
2034-11-28,08:12:00,Publix,-58.58,Orlando FL,32816,5636.2,0
2034-11-29,20:05:00,CVS,-23.06,Orlando FL,32816,5613.14,0
2034-11-29,18:31:00,Monster Energy,-997.12,Charleston SC,58389,4616.02,1
2034-11-29,21:52:00,Starbucks,-9.6,Oviedo FL,32765,5603.54,0
2034-11-29,16:20:00,Chevron,-10.91,Oviedo FL,32765,5592.63,0
2034-11-29,16:36:00,Pawn Stars,-1783.58,Honolulu HI,63181,3809.05,1
2034-11-30,10:27:00,Chevron,-10.36,Oviedo FL,32765,5582.27,0
2034-11-30,15:19:00,Subway,-29.45,Oviedo FL,32765,5552.82,0
2034-11-30,19:39:00,Amazon,-138.38,Orlando FL,32816,5414.44,0
2034-12-01,09:00:00,Rent,-960.0,Oviedo FL,32765,4454.44,0
2034-12-01,09:00:00,Insurance,-197.46,Oviedo FL,32765,4256.98,0
2034-12-01,09:00:00,Car,-300.0,Oviedo FL,32765,3956.98,0
2034-12-02,21:56:00,Five Below,-11.28,Orlando FL,32816,3945.7,0
2034-12-02,16:44:00,Subway,-38.79,Orlando FL,32816,3906.91,0
2034-12-03,09:18:00,Trader Joe's,-63.76,Winter Park FL,32789,3843.15,0
2034-12-04,08:00:00,Paycheck,2000.0,Oviedo FL,32765,5843.15,0
2034-12-04,03:34:00,Pawn Stars,-1546.31,Mexico City MC,12883,4296.84,1
2034-12-04,10:07:00,Trader Joe's,-76.35,Winter Park FL,32789,5766.8,0
2034-12-05,16:43:00,Chevron,-28.16,Oviedo FL,32765,5738.64,0
2034-12-06,21:32:00,Netflix,-30.83,Winter Park FL,32789,5707.81,0
2034-12-06,13:06:00,Exxon,-22.28,Winter Park FL,32789,5685.53,0
2034-12-07,09:00:00,Spotify,-11.99,Oviedo FL,32765,5673.54,0
2034-12-07,09:00:00,Internet,-70.89,Oviedo FL,32765,5602.65,0
2034-12-07,09:00:00,ChatGPT Plus,-20.0,Oviedo FL,32765,5582.65,0
2034-12-07,10:21:00,Target,-107.13,Orlando FL,32816,5475.52,0
2034-12-07,15:07:00,Five Below,-25.97,Oviedo FL,32765,5449.55,0
2034-12-08,08:56:00,Target,-96.91,Winter Park FL,32789,5352.64,0
2034-12-09,17:50:00,Fat Joe,-2134.15,London EN,27473,3218.49,1
2034-12-09,16:39:00,Amusement Park,-12.22,Oviedo FL,32765,5340.42,0
2034-12-09,19:54:00,Dollar Tree,-36.83,Winter Park FL,32789,5303.59,0
2034-12-10,15:17:00,Amazon,-145.22,Winter Park FL,32789,5158.37,0
2034-12-10,19:13:00,Starbucks,-27.65,Orlando FL,32816,5130.72,0
2034-12-12,18:08:00,Burger King,-36.89,Winter Park FL,32789,5093.83,0
2034-12-12,09:06:00,Subway,-35.43,Orlando FL,32816,5058.4,0
2034-12-12,11:56:00,Exxon,-28.93,Winter Park FL,32789,5029.47,0
2034-12-12,18:07:00,Impractical Jokers,-471.82,Anchorage AL,83290,4557.65,1
2034-12-13,12:25:00,Fraud,-2100.76,Groton CT,68208,2928.71,1
2034-12-13,14:30:00,Amusement Park,-20.29,Winter Park FL,32789,5009.18,0
2034-12-13,08:05:00,McDonald's,-21.96,Winter Park FL,32789,4987.22,0
2034-12-14,12:58:00,Publix,-54.1,Winter Park FL,32789,4933.12,0
2034-12-14,21:55:00,Magic the Gathering,-1087.06,Los Angeles CA,69687,3846.06,1
2034-12-16,13:18:00,Concert Tickets,-42.25,Oviedo FL,32765,4890.87,0
2034-12-17,17:02:00,Burger King,-8.98,Oviedo FL,32765,4881.89,0
2034-12-17,14:16:00,Amazon,-54.49,Oviedo FL,32765,4827.4,0
2034-12-18,08:00:00,Paycheck,2000.0,Oviedo FL,32765,6827.4,0
2034-12-19,14:40:00,Accelerators,-2899.2,Tokyo JP,24356,3928.2,1
2034-12-21,12:08:00,Accelerators,-498.71,Groton CT,36655,6328.69,1
2034-12-21,18:43:00,Publix,-73.65,Orlando FL,32816,6753.75,0
2034-12-21,11:23:00,Concert Tickets,-97.79,Winter Park FL,32789,6655.96,0
2034-12-23,20:36:00,Whole Foods,-149.06,Orlando FL,32816,6506.9,0
2034-12-23,20:58:00,Subway,-58.76,Oviedo FL,32765,6448.14,0
2034-12-24,10:15:00,Walgreens,-75.58,Orlando FL,32816,6372.56,0
2034-12-24,14:10:00,Chevron,-33.84,Oviedo FL,32765,6338.72,0
2034-12-24,14:53:00,Movie Theater,-90.57,Orlando FL,32816,6248.15,0
2034-12-25,15:39:00,Best Buy,-255.64,Oviedo FL,32765,5992.51,0
2034-12-25,12:53:00,Amusement Park,-36.72,Winter Park FL,32789,5955.79,0
2034-12-25,18:14:00,Subway,-18.66,Winter Park FL,32789,5937.13,0
2034-12-25,04:09:00,Pawn Stars,-957.69,Pyongyang NK,20887,4979.44,1
2034-12-26,20:44:00,Subway,-15.06,Orlando FL,32816,5922.07,0
2034-12-26,21:38:00,Walgreens,-33.37,Winter Park FL,32789,5888.7,0
2034-12-27,14:06:00,Subway,-37.01,Winter Park FL,32789,5851.69,0
2034-12-27,23:17:00,Impractical Jokers,-1717.1,Charleston SC,58282,4134.59,1
2034-12-27,14:29:00,Amazon,-139.88,Oviedo FL,32765,5711.81,0
2034-12-28,12:52:00,Impractical Jokers,-820.25,Pyongyang NK,32453,4891.56,1
2034-12-29,19:14:00,Walmart,-24.29,Winter Park FL,32789,5687.52,0
2034-12-30,13:33:00,Trader Joe's,-51.32,Winter Park FL,32789,5636.2,0
2034-12-31,15:27:00,McDonald's,-7.03,Winter Park FL,32789,5629.17,0
2035-01-01,08:00:00,Paycheck,2000.0,Oviedo FL,32765,7629.17,0
2035-01-01,09:00:00,Rent,-960.0,Oviedo FL,32765,6669.17,0
2035-01-01,09:00:00,Insurance,-197.46,Oviedo FL,32765,6471.71,0
2035-01-01,09:00:00,Car,-300.0,Oviedo FL,32765,6171.71,0
2035-01-01,08:01:00,CVS,-97.69,Orlando FL,32816,6074.02,0
2035-01-01,12:40:00,Trader Joe's,-69.72,Oviedo FL,32765,6004.3,0
2035-01-02,13:15:00,Trader Joe's,-109.22,Orlando FL,32816,5895.08,0
2035-01-03,20:32:00,Best Buy,-110.08,Oviedo FL,32765,5785.0,0
2035-01-03,18:31:00,McDonald's,-8.91,Winter Park FL,32789,5776.09,0
2035-01-03,09:03:00,Exxon,-18.61,Oviedo FL,32765,5757.48,0
2035-01-05,17:51:00,Movie Theater,-25.82,Oviedo FL,32765,5731.66,0
2035-01-05,15:12:00,Starbucks,-24.25,Winter Park FL,32789,5707.41,0
2035-01-05,08:13:00,Chevron,-28.86,Oviedo FL,32765,5678.55,0
2035-01-06,13:00:00,Exxon,-12.56,Oviedo FL,32765,5665.99,0
2035-01-06,08:52:00,Burger King,-8.01,Orlando FL,32816,5657.98,0
2035-01-07,09:00:00,Spotify,-11.99,Oviedo FL,32765,5645.99,0
2035-01-07,09:00:00,Internet,-70.89,Oviedo FL,32765,5575.1,0
2035-01-07,09:00:00,ChatGPT Plus,-20.0,Oviedo FL,32765,5555.1,0
2035-01-07,15:10:00,Target,-54.45,Oviedo FL,32765,5500.65,0
2035-01-07,16:40:00,McDonald's,-12.93,Orlando FL,32816,5487.72,0
2035-01-07,21:02:00,Accelerators,-1244.72,Los Angeles CA,14687,4243.0,1
2035-01-07,13:40:00,Best Buy,-45.88,Oviedo FL,32765,5441.84,0
2035-01-08,13:06:00,McDonald's,-25.02,Oviedo FL,32765,5416.82,0
2035-01-08,17:34:00,Starbucks,-26.02,Orlando FL,32816,5390.8,0
2035-01-08,17:31:00,McDonald's,-24.0,Orlando FL,32816,5366.8,0
2035-01-09,10:37:00,Trader Joe's,-36.28,Winter Park FL,32789,5330.52,0
2035-01-09,18:57:00,Concert Tickets,-50.8,Orlando FL,32816,5279.72,0
2035-01-14,17:00:00,Target,-52.0,Winter Park FL,32789,5227.72,0
2035-01-15,08:00:00,Paycheck,2000.0,Oviedo FL,32765,7227.72,0
2035-01-15,08:03:00,Shell,-47.86,Orlando FL,32816,7179.86,0
2035-01-15,13:51:00,IBM,-1914.75,Charleston SC,53706,5265.11,1
2035-01-15,19:11:00,Best Buy,-246.71,Orlando FL,32816,6933.15,0
2035-01-15,19:32:00,Burger King,-56.16,Winter Park FL,32789,6876.99,0
2035-01-16,21:16:00,Amazon,-211.75,Winter Park FL,32789,6665.24,0
2035-01-16,18:11:00,Amazon,-269.96,Oviedo FL,32765,6395.28,0
2035-01-17,20:17:00,McDonald's,-50.01,Winter Park FL,32789,6345.27,0
2035-01-17,20:28:00,IBM,-183.61,Los Angeles CA,51598,6161.66,1
2035-01-17,19:04:00,Movie Theater,-36.16,Winter Park FL,32789,6309.11,0
2035-01-18,17:12:00,Walmart,-170.87,Oviedo FL,32765,6138.24,0
2035-01-18,18:37:00,Amazon,-141.7,Winter Park FL,32789,5996.54,0
2035-01-19,12:10:00,Shell,-24.89,Oviedo FL,32765,5971.65,0
2035-01-19,10:16:00,McDonald's,-34.01,Winter Park FL,32789,5937.64,0
2035-01-19,21:11:00,Kroger,-50.7,Oviedo FL,32765,5886.94,0
2035-01-21,18:22:00,McDonald's,-34.97,Winter Park FL,32789,5851.97,0
2035-01-21,09:32:00,Amusement Park,-39.43,Orlando FL,32816,5812.54,0
2035-01-21,08:00:00,McDonald's,-13.33,Oviedo FL,32765,5799.21,0
2035-01-22,15:32:00,Amazon,-86.87,Oviedo FL,32765,5712.34,0
2035-01-24,21:56:00,Servicenow,-2306.45,Los Angeles CA,38302,3405.89,1
2035-01-24,12:30:00,Whole Foods,-98.61,Oviedo FL,32765,5613.73,0
2035-01-24,09:38:00,Shell,-10.37,Oviedo FL,32765,5603.36,0
2035-01-25,17:48:00,Exxon,-20.86,Orlando FL,32816,5582.5,0
2035-01-25,12:33:00,Accelerators,-744.73,Tokyo JP,74274,4837.77,1
2035-01-25,14:58:00,McDonald's,-7.8,Orlando FL,32816,5574.7,0
2035-01-25,20:28:00,Pawn Stars,-1634.78,Pittsburgh PA,34276,3939.92,1
2035-01-26,09:04:00,Trader Joe's,-86.12,Oviedo FL,32765,5488.58,0
2035-01-27,17:54:00,Subway,-25.11,Orlando FL,32816,5463.47,0
2035-01-27,08:00:00,Walmart,-56.75,Winter Park FL,32789,5406.72,0
2035-01-28,11:29:00,Movie Theater,-35.46,Oviedo FL,32765,5371.26,0
2035-01-28,15:09:00,Jiffy Lube,-85.57,Orlando FL,32816,5285.69,0
2035-01-29,08:00:00,Paycheck,2000.0,Oviedo FL,32765,7285.69,0
2035-01-29,23:13:00,Pawn Stars,-120.79,Groton CT,91047,7164.9,1
2035-01-30,09:46:00,Starbucks,-13.28,Winter Park FL,32789,7272.41,0
2035-01-30,03:19:00,Fraud,-2618.07,Los Angeles CA,27187,4654.34,1
2035-01-30,14:29:00,Amusement Park,-29.8,Oviedo FL,32765,7242.61,0
2035-02-01,09:00:00,Rent,-960.0,Oviedo FL,32765,6282.61,0
2035-02-01,09:00:00,Insurance,-197.46,Oviedo FL,32765,6085.15,0
2035-02-01,09:00:00,Car,-300.0,Oviedo FL,32765,5785.15,0
2035-02-03,11:04:00,Exxon,-20.21,Winter Park FL,32789,5764.94,0
2035-02-03,08:30:00,McDonald's,-35.81,Orlando FL,32816,5729.13,0
2035-02-03,21:17:00,Netflix,-20.37,Oviedo FL,32765,5708.76,0
2035-02-04,16:28:00,Walmart,-125.11,Oviedo FL,32765,5583.65,0
2035-02-04,21:00:00,Subway,-14.26,Winter Park FL,32789,5569.39,0
2035-02-04,17:46:00,Kroger,-99.23,Winter Park FL,32789,5470.16,0
2035-02-06,03:09:00,Lockheed Martin,-1043.53,Los Angeles CA,17044,4426.63,1
2035-02-06,10:18:00,Subway,-11.34,Oviedo FL,32765,5458.82,0
2035-02-07,09:00:00,Spotify,-11.99,Oviedo FL,32765,5446.83,0
2035-02-07,09:00:00,Internet,-70.89,Oviedo FL,32765,5375.94,0
2035-02-07,09:00:00,ChatGPT Plus,-20.0,Oviedo FL,32765,5355.94,0
2035-02-08,19:09:00,Subway,-30.82,Oviedo FL,32765,5325.12,0
2035-02-08,11:42:00,Amusement Park,-23.25,Winter Park FL,32789,5301.87,0
2035-02-09,10:48:00,Starbucks,-9.16,Oviedo FL,32765,5292.71,0
2035-02-09,15:48:00,Amusement Park,-51.52,Oviedo FL,32765,5241.19,0
2035-02-09,18:40:00,Walmart,-102.49,Winter Park FL,32789,5138.7,0
2035-02-09,11:46:00,Paypal,-2503.89,Pittsburgh PA,59361,2634.81,1
2035-02-10,12:53:00,Starbucks,-18.24,Winter Park FL,32789,5120.46,0
2035-02-10,21:48:00,Pawn Stars,-1190.38,Pyongyang NK,59791,3930.08,1
2035-02-10,09:02:00,Starbucks,-29.06,Winter Park FL,32789,5091.4,0
2035-02-10,13:37:00,BP,-23.38,Orlando FL,32816,5068.02,0
2035-02-12,08:00:00,Paycheck,2000.0,Oviedo FL,32765,7068.02,0
2035-02-12,14:17:00,Accelerators,-1897.96,Anchorage AL,76924,5170.06,1
2035-02-12,13:31:00,Netflix,-92.87,Winter Park FL,32789,6975.15,0
2035-02-14,10:42:00,Starbucks,-11.94,Oviedo FL,32765,6963.21,0
2035-02-14,10:34:00,McDonald's,-37.24,Winter Park FL,32789,6925.97,0
2035-02-14,11:53:00,Amazon,-31.16,Oviedo FL,32765,6894.81,0
2035-02-16,09:36:00,Amazon,-138.37,Winter Park FL,32789,6756.44,0
2035-02-16,16:13:00,Exxon,-50.99,Winter Park FL,32789,6705.45,0
2035-02-16,15:52:00,Starbucks,-67.63,Oviedo FL,32765,6637.82,0
2035-02-17,00:28:00,Fraud,-2879.55,Mexico City MC,85130,3758.27,1
2035-02-18,09:20:00,Accelerators,-512.21,New York NY,96881,6125.61,1
2035-02-18,21:02:00,Walgreens,-78.08,Oviedo FL,32765,6559.74,0
2035-02-18,20:07:00,BP,-35.25,Oviedo FL,32765,6524.49,0
2035-02-18,10:31:00,Starbucks,-61.04,Oviedo FL,32765,6463.45,0
2035-02-20,21:06:00,Midas,-219.21,Orlando FL,32816,6244.24,0
2035-02-20,16:31:00,Amazon,-281.31,Oviedo FL,32765,5962.93,0
2035-02-20,20:55:00,Chevron,-26.49,Oviedo FL,32765,5936.44,0
2035-02-21,10:21:00,Burger King,-26.7,Oviedo FL,32765,5909.74,0
2035-02-21,15:14:00,Starbucks,-13.54,Orlando FL,32816,5896.2,0
2035-02-23,02:53:00,Magic the Gathering,-2747.75,Groton CT,85488,3148.45,1
2035-02-24,12:49:00,Five Below,-44.49,Winter Park FL,32789,5851.71,0
2035-02-24,11:18:00,Starbucks,-29.15,Winter Park FL,32789,5822.56,0
2035-02-25,18:25:00,Five Below,-28.78,Winter Park FL,32789,5793.78,0
2035-02-25,18:40:00,Exxon,-24.59,Winter Park FL,32789,5769.19,0
2035-02-26,08:00:00,Paycheck,2000.0,Oviedo FL,32765,7769.19,0
2035-02-26,21:53:00,CVS,-69.84,Orlando FL,32816,7699.35,0
2035-02-26,11:41:00,Onlyfans,-2277.21,Honolulu HI,88711,5422.14,1
2035-02-26,19:19:00,Starbucks,-48.43,Winter Park FL,32789,7650.92,0
2035-02-27,18:48:00,Amazon,-277.1,Orlando FL,32816,7373.82,0
2035-02-27,09:09:00,Amazon,-275.59,Orlando FL,32816,7098.23,0
2035-02-27,14:28:00,Publix,-151.44,Orlando FL,32816,6946.79,0
2035-02-28,15:58:00,Best Buy,-202.5,Orlando FL,32816,6744.29,0
2035-03-01,09:00:00,Rent,-960.0,Oviedo FL,32765,5784.29,0
2035-03-01,09:00:00,Insurance,-197.46,Oviedo FL,32765,5586.83,0
2035-03-01,09:00:00,Car,-300.0,Oviedo FL,32765,5286.83,0
2035-03-01,18:46:00,IBM,-448.94,Los Angeles CA,59511,4837.89,1
2035-03-01,17:57:00,Burger King,-36.11,Oviedo FL,32765,5250.72,0
2035-03-01,16:07:00,Trader Joe's,-93.33,Orlando FL,32816,5157.39,0
2035-03-01,05:54:00,Monster Energy,-2514.65,Groton CT,86236,2642.74,1
2035-03-01,16:00:00,Whole Foods,-50.6,Winter Park FL,32789,5106.79,0
2035-03-02,10:53:00,Best Buy,-24.64,Oviedo FL,32765,5082.15,0
2035-03-02,14:20:00,Servicenow,-2450.67,Tokyo JP,38572,2631.48,1
2035-03-02,17:20:00,McDonald's,-30.59,Orlando FL,32816,5051.56,0
2035-03-03,13:10:00,Burger King,-21.13,Oviedo FL,32765,5030.43,0
2035-03-03,15:12:00,Starbucks,-10.46,Oviedo FL,32765,5019.97,0
2035-03-03,09:05:00,Shell,-10.79,Winter Park FL,32789,5009.18,0
2035-03-03,07:06:00,Servicenow,-1127.84,Tokyo JP,63129,3881.34,1
2035-03-04,17:02:00,Target,-28.52,Winter Park FL,32789,4980.66,0
2035-03-04,16:16:00,Fat Joe,-1699.03,Groton CT,50911,3281.63,1
2035-03-04,14:24:00,Amazon,-89.72,Orlando FL,32816,4890.94,0
2035-03-04,20:28:00,Trader Joe's,-52.46,Winter Park FL,32789,4838.48,0
2035-03-05,12:02:00,Walmart,-124.39,Oviedo FL,32765,4714.09,0
2035-03-07,09:00:00,Spotify,-11.99,Oviedo FL,32765,4702.1,0
2035-03-07,09:00:00,Internet,-70.89,Oviedo FL,32765,4631.21,0
2035-03-07,09:00:00,ChatGPT Plus,-20.0,Oviedo FL,32765,4611.21,0
2035-03-07,13:20:00,Five Below,-39.97,Oviedo FL,32765,4571.24,0
2035-03-09,21:52:00,Starbucks,-12.21,Orlando FL,32816,4559.03,0
2035-03-09,10:19:00,Pep Boys,-163.83,Orlando FL,32816,4395.2,0
2035-03-09,18:53:00,Whole Foods,-59.01,Oviedo FL,32765,4336.19,0
2035-03-10,09:48:00,Walmart,-28.02,Orlando FL,32816,4308.17,0
2035-03-10,11:28:00,Walgreens,-30.84,Winter Park FL,32789,4277.33,0
2035-03-12,08:00:00,Paycheck,2000.0,Oviedo FL,32765,6277.33,0
2035-03-12,12:41:00,Publix,-187.04,Oviedo FL,32765,6090.29,0
2035-03-12,12:02:00,Burger King,-30.12,Oviedo FL,32765,6060.17,0
2035-03-14,21:16:00,McDonald's,-77.31,Winter Park FL,32789,5982.86,0
2035-03-14,11:52:00,Starbucks,-35.62,Winter Park FL,32789,5947.24,0
2035-03-15,23:36:00,Impractical Jokers,-120.11,Los Angeles CA,51722,5827.13,1
2035-03-16,09:35:00,Jiffy Lube,-139.52,Winter Park FL,32789,5807.72,0
2035-03-16,12:49:00,Whole Foods,-44.31,Oviedo FL,32765,5763.41,0
2035-03-18,19:42:00,Starbucks,-34.5,Winter Park FL,32789,5728.91,0
2035-03-19,10:48:00,Walgreens,-41.94,Winter Park FL,32789,5686.97,0
2035-03-19,13:51:00,Shell,-18.06,Orlando FL,32816,5668.91,0
2035-03-20,15:32:00,Chevron,-18.57,Winter Park FL,32789,5650.34,0
2035-03-20,13:01:00,Amusement Park,-43.65,Orlando FL,32816,5606.69,0
2035-03-20,12:28:00,Starbucks,-6.83,Winter Park FL,32789,5599.86,0
2035-03-20,00:12:00,Monster Energy,-1898.23,Mexico City MC,53505,3701.63,1
2035-03-21,08:43:00,Walmart,-126.55,Orlando FL,32816,5473.31,0
2035-03-21,06:38:00,Magic the Gathering,-766.39,New York NY,61213,4706.92,1
2035-03-21,21:45:00,Movie Theater,-55.96,Winter Park FL,32789,5417.35,0
2035-03-21,13:41:00,Kroger,-96.1,Orlando FL,32816,5321.25,0
2035-03-21,15:55:00,Lockheed Martin,-2907.16,Anchorage AL,47810,2414.09,1
2035-03-22,13:52:00,McDonald's,-29.84,Winter Park FL,32789,5291.41,0
2035-03-22,10:36:00,Whole Foods,-40.27,Winter Park FL,32789,5251.14,0
2035-03-22,15:16:00,Amazon,-20.98,Orlando FL,32816,5230.16,0
2035-03-22,00:32:00,Lockheed Martin,-2170.19,Mexico City MC,63432,3059.97,1
2035-03-26,08:00:00,Paycheck,2000.0,Oviedo FL,32765,7230.16,0
2035-03-26,08:38:00,Netflix,-36.02,Oviedo FL,32765,7194.14,0
2035-03-26,20:17:00,AutoZone,-251.25,Orlando FL,32816,6942.89,0
2035-03-29,15:34:00,Jiffy Lube,-376.52,Orlando FL,32816,6566.37,0
2035-03-29,08:35:00,Subway,-56.71,Orlando FL,32816,6509.66,0
2035-03-29,19:26:00,Trader Joe's,-107.35,Winter Park FL,32789,6402.31,0
2035-03-30,11:49:00,Burger King,-36.37,Oviedo FL,32765,6365.94,0
2035-03-30,14:51:00,Five Below,-16.23,Winter Park FL,32789,6349.71,0
2035-03-30,02:50:00,Magic the Gathering,-2664.49,Groton CT,25599,3685.22,1
2035-03-30,10:46:00,Amazon,-78.02,Orlando FL,32816,6271.69,0
2035-03-30,10:04:00,Lockheed Martin,-126.98,Honolulu HI,81606,6144.71,1
2035-04-01,09:00:00,Rent,-960.0,Oviedo FL,32765,5311.69,0
2035-04-01,09:00:00,Insurance,-197.46,Oviedo FL,32765,5114.23,0
2035-04-01,09:00:00,Car,-300.0,Oviedo FL,32765,4814.23,0
2035-04-01,11:39:00,Walmart,-10.26,Orlando FL,32816,4803.97,0
2035-04-03,15:57:00,Subway,-39.71,Oviedo FL,32765,4764.26,0
2035-04-05,16:00:00,Midas,-120.59,Oviedo FL,32765,4643.67,0
2035-04-05,13:38:00,Dollar Tree,-6.01,Orlando FL,32816,4637.66,0
2035-04-05,20:33:00,Subway,-27.64,Oviedo FL,32765,4610.02,0
2035-04-06,11:28:00,Magic the Gathering,-2307.31,Tokyo JP,20025,2302.71,1
2035-04-06,12:41:00,Best Buy,-140.79,Oviedo FL,32765,4469.23,0
2035-04-06,20:34:00,Subway,-13.5,Oviedo FL,32765,4455.73,0
2035-04-06,13:01:00,Publix,-73.14,Orlando FL,32816,4382.59,0
2035-04-07,09:00:00,Spotify,-11.99,Oviedo FL,32765,4370.6,0
2035-04-07,09:00:00,Internet,-70.89,Oviedo FL,32765,4299.71,0
2035-04-07,09:00:00,ChatGPT Plus,-20.0,Oviedo FL,32765,4279.71,0
2035-04-08,21:04:00,Kroger,-77.12,Oviedo FL,32765,4202.59,0
2035-04-08,08:06:00,Concert Tickets,-58.59,Oviedo FL,32765,4144.0,0
2035-04-09,08:00:00,Paycheck,2000.0,Oviedo FL,32765,6144.0,0
2035-04-09,14:52:00,Whole Foods,-139.2,Oviedo FL,32765,6004.8,0
2035-04-09,20:11:00,Burger King,-53.29,Oviedo FL,32765,5951.51,0
2035-04-11,17:50:00,Magic the Gathering,-451.99,Pittsburgh PA,44704,5499.52,1
2035-04-13,14:55:00,Starbucks,-27.04,Orlando FL,32816,5924.47,0
2035-04-13,16:28:00,Starbucks,-27.23,Oviedo FL,32765,5897.24,0
2035-04-14,15:39:00,Best Buy,-136.24,Winter Park FL,32789,5761.0,0
2035-04-14,16:39:00,Pawn Stars,-1816.65,Tokyo JP,29917,3944.35,1
2035-04-14,20:34:00,Subway,-14.31,Orlando FL,32816,5746.69,0
2035-04-14,13:24:00,Burger King,-33.8,Winter Park FL,32789,5712.89,0
2035-04-15,15:58:00,Burger King,-26.76,Oviedo FL,32765,5686.13,0
2035-04-17,08:11:00,Five Below,-36.52,Oviedo FL,32765,5649.61,0
2035-04-17,13:33:00,Burger King,-32.38,Orlando FL,32816,5617.23,0
2035-04-17,20:11:00,IBM,-1294.42,Mexico City MC,39001,4322.81,1
2035-04-18,10:16:00,Burger King,-22.34,Winter Park FL,32789,5594.89,0
2035-04-18,21:56:00,Netflix,-44.64,Winter Park FL,32789,5550.25,0
2035-04-19,15:07:00,Walmart,-97.04,Oviedo FL,32765,5453.21,0
2035-04-19,18:03:00,BP,-24.41,Oviedo FL,32765,5428.8,0
2035-04-19,09:39:00,Starbucks,-16.95,Orlando FL,32816,5411.85,0
2035-04-19,11:21:00,Pawn Stars,-107.91,Groton CT,28192,5303.94,1
2035-04-21,15:39:00,Walmart,-66.73,Winter Park FL,32789,5345.12,0
2035-04-21,08:35:00,Subway,-23.49,Orlando FL,32816,5321.63,0
2035-04-21,13:48:00,IBM,-626.0,Groton CT,29958,4695.63,1
2035-04-23,08:00:00,Paycheck,2000.0,Oviedo FL,32765,7321.63,0
2035-04-24,21:22:00,Dollar Tree,-54.47,Oviedo FL,32765,7267.16,0
2035-04-25,16:43:00,Concert Tickets,-61.16,Oviedo FL,32765,7206.0,0
2035-04-25,14:54:00,Kroger,-118.68,Orlando FL,32816,7087.32,0
2035-04-26,16:00:00,McDonald's,-56.3,Oviedo FL,32765,7031.02,0
2035-04-27,18:49:00,Exxon,-40.82,Oviedo FL,32765,6990.2,0
2035-04-27,16:16:00,Walmart,-75.38,Oviedo FL,32765,6914.82,0
2035-04-29,13:59:00,Starbucks,-77.88,Oviedo FL,32765,6836.94,0
2035-04-29,13:32:00,Walmart,-22.58,Orlando FL,32816,6814.36,0
2035-04-30,13:33:00,Starbucks,-57.46,Winter Park FL,32789,6756.9,0
2035-04-30,13:01:00,Monster Energy,-2692.5,Groton CT,45680,4064.4,1
2035-05-01,09:00:00,Rent,-960.0,Oviedo FL,32765,5796.9,0
2035-05-01,09:00:00,Insurance,-197.46,Oviedo FL,32765,5599.44,0
2035-05-01,09:00:00,Car,-300.0,Oviedo FL,32765,5299.44,0
2035-05-01,18:12:00,AutoZone,-150.23,Orlando FL,32816,5149.21,0
2035-05-01,16:09:00,Burger King,-12.45,Orlando FL,32816,5136.76,0
2035-05-01,09:16:00,McDonald's,-26.63,Orlando FL,32816,5110.13,0
2035-05-02,16:45:00,Starbucks,-8.31,Oviedo FL,32765,5101.82,0
2035-05-02,18:26:00,Walmart,-144.79,Orlando FL,32816,4957.03,0
2035-05-03,16:31:00,Amusement Park,-42.98,Winter Park FL,32789,4914.05,0
2035-05-03,18:18:00,Starbucks,-19.63,Oviedo FL,32765,4894.42,0
2035-05-03,15:57:00,Amazon,-135.93,Orlando FL,32816,4758.49,0
2035-05-04,21:17:00,Shell,-29.49,Oviedo FL,32765,4729.0,0
2035-05-04,18:46:00,Walgreens,-11.87,Orlando FL,32816,4717.13,0
2035-05-04,15:03:00,Chevron,-29.56,Oviedo FL,32765,4687.57,0
2035-05-06,16:02:00,Netflix,-19.59,Orlando FL,32816,4667.98,0
2035-05-06,12:30:00,Subway,-23.47,Oviedo FL,32765,4644.51,0
2035-05-06,04:24:00,Fat Joe,-2806.3,Charleston SC,76481,1838.21,1
2035-05-06,15:40:00,Starbucks,-26.11,Winter Park FL,32789,4618.4,0
2035-05-07,08:00:00,Paycheck,2000.0,Oviedo FL,32765,6618.4,0
2035-05-07,09:00:00,Spotify,-11.99,Oviedo FL,32765,6606.41,0
2035-05-07,09:00:00,Internet,-70.89,Oviedo FL,32765,6535.52,0
2035-05-07,09:00:00,ChatGPT Plus,-20.0,Oviedo FL,32765,6515.52,0
2035-05-07,22:09:00,Fat Joe,-891.16,Mexico City MC,51061,5624.36,1
2035-05-07,10:08:00,Kroger,-164.68,Orlando FL,32816,6350.84,0
2035-05-08,20:30:00,Exxon,-24.98,Orlando FL,32816,6325.86,0
2035-05-08,18:07:00,Netflix,-87.05,Orlando FL,32816,6238.81,0
2035-05-09,15:00:00,Subway,-56.95,Orlando FL,32816,6181.86,0
2035-05-09,10:48:00,Starbucks,-77.25,Winter Park FL,32789,6104.61,0
2035-05-09,19:10:00,Five Below,-69.54,Winter Park FL,32789,6035.07,0
2035-05-09,16:08:00,Pawn Stars,-2187.9,Charleston SC,89156,3847.17,1
2035-05-11,08:32:00,Concert Tickets,-77.7,Orlando FL,32816,5957.37,0
2035-05-12,19:43:00,Publix,-87.64,Oviedo FL,32765,5869.73,0
2035-05-13,09:32:00,Starbucks,-22.79,Orlando FL,32816,5846.94,0
2035-05-13,20:03:00,Amazon,-98.76,Orlando FL,32816,5748.18,0
2035-05-14,14:21:00,Subway,-11.29,Oviedo FL,32765,5736.89,0
2035-05-14,17:14:00,Kroger,-81.86,Oviedo FL,32765,5655.03,0
2035-05-14,15:57:00,Best Buy,-75.59,Winter Park FL,32789,5579.44,0
2035-05-15,08:08:00,Concert Tickets,-15.01,Orlando FL,32816,5564.43,0
2035-05-15,15:42:00,Trader Joe's,-69.23,Orlando FL,32816,5495.2,0
2035-05-17,15:24:00,Starbucks,-12.9,Orlando FL,32816,5482.3,0
2035-05-17,08:35:00,Lockheed Martin,-1735.35,London EN,76689,3746.95,1
2035-05-17,16:22:00,Best Buy,-96.67,Winter Park FL,32789,5385.63,0
2035-05-17,10:06:00,Starbucks,-16.72,Orlando FL,32816,5368.91,0
2035-05-18,15:27:00,Target,-92.49,Winter Park FL,32789,5276.42,0
2035-05-18,18:13:00,Subway,-9.05,Winter Park FL,32789,5267.37,0
2035-05-18,12:32:00,CVS,-19.36,Winter Park FL,32789,5248.01,0
2035-05-19,20:02:00,AutoZone,-44.22,Oviedo FL,32765,5203.79,0
2035-05-21,08:00:00,Paycheck,2000.0,Oviedo FL,32765,7203.79,0
2035-05-21,20:10:00,Movie Theater,-48.14,Orlando FL,32816,7155.65,0
2035-05-23,12:34:00,Pawn Stars,-2232.55,Mexico City MC,34726,4923.1,1
2035-05-23,14:25:00,Walmart,-124.17,Winter Park FL,32789,7031.48,0
2035-05-23,13:10:00,Kroger,-60.28,Oviedo FL,32765,6971.2,0
2035-05-25,11:59:00,Pep Boys,-217.42,Oviedo FL,32765,6753.78,0
2035-05-25,10:12:00,McDonald's,-30.3,Oviedo FL,32765,6723.48,0
2035-05-26,21:20:00,McDonald's,-62.64,Oviedo FL,32765,6660.84,0
2035-05-27,11:48:00,Shell,-20.5,Orlando FL,32816,6640.34,0
2035-05-28,20:44:00,Amazon,-246.94,Winter Park FL,32789,6393.4,0
2035-05-28,11:15:00,Whole Foods,-102.63,Oviedo FL,32765,6290.77,0
2035-05-28,11:44:00,Burger King,-65.82,Oviedo FL,32765,6224.95,0
2035-05-29,20:16:00,Starbucks,-22.33,Winter Park FL,32789,6202.62,0
2035-05-29,15:13:00,Subway,-10.05,Winter Park FL,32789,6192.57,0
2035-05-29,15:55:00,Walgreens,-73.91,Oviedo FL,32765,6118.66,0
2035-05-31,21:06:00,Whole Foods,-96.0,Oviedo FL,32765,6022.66,0
2035-05-31,15:16:00,Amusement Park,-63.29,Winter Park FL,32789,5959.37,0
2035-05-31,12:49:00,Five Below,-46.85,Winter Park FL,32789,5912.52,0
2035-06-01,09:00:00,Rent,-960.0,Oviedo FL,32765,4952.52,0
2035-06-01,09:00:00,Insurance,-197.46,Oviedo FL,32765,4755.06,0
2035-06-01,09:00:00,Car,-300.0,Oviedo FL,32765,4455.06,0
2035-06-02,20:49:00,Concert Tickets,-32.85,Winter Park FL,32789,4422.21,0
2035-06-03,21:44:00,Concert Tickets,-40.2,Winter Park FL,32789,4382.01,0
2035-06-04,08:00:00,Paycheck,2000.0,Oviedo FL,32765,6382.01,0
2035-06-04,21:28:00,Kroger,-138.2,Winter Park FL,32789,6243.81,0
2035-06-04,19:42:00,Burger King,-64.94,Winter Park FL,32789,6178.87,0
2035-06-05,14:59:00,Trader Joe's,-113.69,Winter Park FL,32789,6065.18,0
2035-06-07,09:00:00,Spotify,-11.99,Oviedo FL,32765,6053.19,0
2035-06-07,09:00:00,Internet,-70.89,Oviedo FL,32765,5982.3,0
2035-06-07,09:00:00,ChatGPT Plus,-20.0,Oviedo FL,32765,5962.3,0
2035-06-07,16:34:00,Kroger,-85.04,Winter Park FL,32789,5877.26,0
2035-06-07,09:28:00,Walgreens,-24.53,Oviedo FL,32765,5852.73,0
2035-06-08,17:15:00,Best Buy,-134.04,Orlando FL,32816,5718.69,0
2035-06-08,19:13:00,Exxon,-29.7,Winter Park FL,32789,5688.99,0
2035-06-09,15:20:00,Fat Joe,-2021.42,Groton CT,27172,3667.57,1
2035-06-10,22:33:00,Magic the Gathering,-2717.34,Charleston SC,34018,2971.65,1
2035-06-11,13:35:00,CVS,-6.5,Orlando FL,32816,5682.49,0
2035-06-11,14:22:00,Walgreens,-16.99,Orlando FL,32816,5665.5,0
2035-06-12,11:27:00,Trader Joe's,-42.38,Oviedo FL,32765,5623.12,0
2035-06-12,12:57:00,McDonald's,-23.88,Oviedo FL,32765,5599.24,0
2035-06-13,15:01:00,Dollar Tree,-23.67,Winter Park FL,32789,5575.57,0
2035-06-13,12:57:00,Target,-120.97,Orlando FL,32816,5454.6,0
2035-06-15,09:59:00,McDonald's,-31.17,Winter Park FL,32789,5423.43,0
2035-06-18,08:00:00,Paycheck,2000.0,Oviedo FL,32765,7423.43,0
2035-06-18,18:26:00,Concert Tickets,-89.31,Orlando FL,32816,7334.12,0
2035-06-18,12:49:00,Walmart,-106.49,Winter Park FL,32789,7227.63,0
2035-06-18,11:28:00,Subway,-15.48,Winter Park FL,32789,7212.15,0
2035-06-20,11:23:00,Midas,-254.09,Orlando FL,32816,6958.06,0
2035-06-20,17:30:00,Shell,-56.34,Orlando FL,32816,6901.72,0
2035-06-20,17:51:00,AutoZone,-214.41,Orlando FL,32816,6687.31,0
2035-06-21,14:46:00,Amazon,-69.34,Orlando FL,32816,6617.97,0
2035-06-21,09:05:00,Walgreens,-53.21,Orlando FL,32816,6564.76,0
2035-06-21,01:20:00,Accelerators,-844.43,Pittsburgh PA,69332,5720.33,1
2035-06-22,19:11:00,Trader Joe's,-135.99,Oviedo FL,32765,6428.77,0
2035-06-22,11:40:00,Pawn Stars,-171.81,Tokyo JP,92501,6256.96,1
2035-06-22,19:37:00,Amazon,-165.15,Winter Park FL,32789,6263.62,0
2035-06-22,18:32:00,BP,-53.67,Winter Park FL,32789,6209.95,0
2035-06-23,18:08:00,Netflix,-30.2,Oviedo FL,32765,6179.75,0
2035-06-24,20:40:00,Concert Tickets,-52.45,Winter Park FL,32789,6127.3,0
2035-06-24,23:05:00,Paypal,-1963.79,London EN,64669,4163.51,1
2035-06-24,11:01:00,Burger King,-48.51,Winter Park FL,32789,6078.79,0
2035-06-24,19:19:00,Fat Joe,-2910.23,Tokyo JP,78156,3168.56,1
2035-06-24,14:54:00,Subway,-29.15,Winter Park FL,32789,6049.64,0
2035-06-25,16:40:00,Five Below,-69.86,Oviedo FL,32765,5979.78,0
2035-06-25,11:29:00,Publix,-65.75,Orlando FL,32816,5914.03,0
2035-06-26,20:11:00,Target,-22.7,Winter Park FL,32789,5891.33,0
2035-06-27,21:07:00,CVS,-5.21,Oviedo FL,32765,5886.12,0
2035-06-27,16:51:00,Burger King,-13.69,Orlando FL,32816,5872.43,0
2035-06-27,11:23:00,Subway,-8.15,Winter Park FL,32789,5864.28,0
2035-06-29,21:20:00,Movie Theater,-34.41,Oviedo FL,32765,5829.87,0
2035-06-29,12:42:00,Pawn Stars,-2575.22,New York NY,38629,3254.65,1
2035-06-29,15:14:00,Publix,-86.8,Orlando FL,32816,5743.07,0
2035-06-29,00:14:00,Impractical Jokers,-1117.28,Pittsburgh PA,92046,4625.79,1
2035-06-29,09:34:00,Burger King,-22.57,Oviedo FL,32765,5720.5,0
2035-06-30,19:45:00,Starbucks,-34.82,Winter Park FL,32789,5685.68,0
2035-07-01,09:00:00,Rent,-960.0,Oviedo FL,32765,4725.68,0
2035-07-01,09:00:00,Insurance,-197.46,Oviedo FL,32765,4528.22,0
2035-07-01,09:00:00,Car,-300.0,Oviedo FL,32765,4228.22,0
2035-07-02,08:00:00,Paycheck,2000.0,Oviedo FL,32765,6228.22,0
2035-07-02,11:09:00,Fraud,-1252.53,New York NY,93933,4975.69,1
2035-07-02,16:47:00,Subway,-21.95,Winter Park FL,32789,6206.27,0
2035-07-02,14:22:00,Midas,-200.05,Winter Park FL,32789,6006.22,0
2035-07-02,04:31:00,Fraud,-422.26,London EN,89273,5583.96,1
2035-07-02,10:04:00,Chevron,-33.99,Winter Park FL,32789,5972.23,0
2035-07-02,13:13:00,Pawn Stars,-2681.05,Honolulu HI,96837,3291.18,1
2035-07-03,08:29:00,Accelerators,-2164.83,Pyongyang NK,17527,3807.4,1
2035-07-03,12:48:00,McDonald's,-22.72,Winter Park FL,32789,5949.51,0
2035-07-05,18:43:00,Trader Joe's,-74.59,Winter Park FL,32789,5874.92,0
2035-07-05,10:26:00,Monster Energy,-1826.69,Los Angeles CA,43084,4048.23,1
2035-07-05,19:02:00,Movie Theater,-14.65,Oviedo FL,32765,5860.27,0
2035-07-05,08:34:00,Starbucks,-6.09,Oviedo FL,32765,5854.18,0
2035-07-07,09:00:00,Spotify,-11.99,Oviedo FL,32765,5842.19,0
2035-07-07,09:00:00,Internet,-70.89,Oviedo FL,32765,5771.3,0
2035-07-07,09:00:00,ChatGPT Plus,-20.0,Oviedo FL,32765,5751.3,0
2035-07-08,11:25:00,Pep Boys,-145.51,Orlando FL,32816,5605.79,0
2035-07-08,08:16:00,Burger King,-33.62,Oviedo FL,32765,5572.17,0
2035-07-08,21:33:00,Magic the Gathering,-682.38,New York NY,55673,4889.79,1
2035-07-08,08:52:00,Burger King,-39.49,Orlando FL,32816,5532.68,0
2035-07-09,10:58:00,BP,-19.63,Oviedo FL,32765,5513.05,0
2035-07-09,10:34:00,McDonald's,-16.8,Orlando FL,32816,5496.25,0
2035-07-09,10:08:00,Five Below,-34.38,Winter Park FL,32789,5461.87,0
2035-07-10,13:10:00,Movie Theater,-36.03,Winter Park FL,32789,5425.84,0
2035-07-11,10:15:00,Movie Theater,-39.35,Winter Park FL,32789,5386.49,0
2035-07-11,20:46:00,McDonald's,-6.96,Orlando FL,32816,5379.53,0
2035-07-11,18:10:00,Kroger,-46.82,Oviedo FL,32765,5332.71,0
2035-07-12,20:55:00,Pep Boys,-64.82,Winter Park FL,32789,5267.89,0
2035-07-12,08:07:00,CVS,-29.33,Oviedo FL,32765,5238.56,0
2035-07-12,09:56:00,CVS,-43.05,Winter Park FL,32789,5195.51,0
2035-07-13,17:44:00,Netflix,-48.8,Oviedo FL,32765,5146.71,0
2035-07-13,15:06:00,Midas,-148.59,Winter Park FL,32789,4998.12,0
2035-07-14,17:51:00,Burger King,-7.55,Orlando FL,32816,4990.57,0
2035-07-14,11:33:00,Dollar Tree,-22.68,Orlando FL,32816,4967.89,0
2035-07-15,15:44:00,Burger King,-26.39,Winter Park FL,32789,4941.5,0
2035-07-15,17:26:00,Magic the Gathering,-839.96,Tokyo JP,53198,4101.54,1
2035-07-16,08:00:00,Paycheck,2000.0,Oviedo FL,32765,6941.5,0
2035-07-16,19:22:00,McDonald's,-16.56,Oviedo FL,32765,6924.94,0
2035-07-17,12:26:00,Walmart,-177.68,Oviedo FL,32765,6747.26,0
2035-07-17,17:17:00,Pep Boys,-356.32,Orlando FL,32816,6390.94,0
2035-07-18,03:17:00,Lockheed Martin,-2035.49,Los Angeles CA,94024,4355.45,1
2035-07-19,13:34:00,Starbucks,-56.07,Oviedo FL,32765,6334.87,0
2035-07-19,20:38:00,Accelerators,-1834.9,London EN,85414,4499.97,1
2035-07-19,09:11:00,Best Buy,-149.76,Oviedo FL,32765,6185.11,0
2035-07-19,16:09:00,AutoZone,-112.33,Orlando FL,32816,6072.78,0
2035-07-20,18:07:00,Subway,-37.04,Oviedo FL,32765,6035.74,0
2035-07-20,12:38:00,Netflix,-95.41,Oviedo FL,32765,5940.33,0
2035-07-21,09:14:00,Publix,-75.03,Winter Park FL,32789,5865.3,0
2035-07-24,19:34:00,Shell,-19.08,Orlando FL,32816,5846.22,0
2035-07-24,20:37:00,Five Below,-34.43,Orlando FL,32816,5811.79,0
2035-07-24,15:03:00,Pawn Stars,-682.78,Los Angeles CA,14081,5129.01,1
2035-07-25,02:55:00,Servicenow,-932.9,Charleston SC,33878,4878.89,1
2035-07-25,10:51:00,Walgreens,-29.92,Winter Park FL,32789,5781.87,0
2035-07-25,08:16:00,Burger King,-26.9,Oviedo FL,32765,5754.97,0
2035-07-25,18:13:00,Walgreens,-15.29,Winter Park FL,32789,5739.68,0
2035-07-26,10:33:00,Amazon,-145.91,Oviedo FL,32765,5593.77,0
2035-07-26,14:20:00,Amazon,-105.6,Oviedo FL,32765,5488.17,0
2035-07-26,09:13:00,CVS,-37.36,Oviedo FL,32765,5450.81,0
2035-07-27,16:56:00,Burger King,-10.98,Oviedo FL,32765,5439.83,0
2035-07-27,18:19:00,Burger King,-12.68,Oviedo FL,32765,5427.15,0
2035-07-27,18:25:00,Subway,-21.87,Oviedo FL,32765,5405.28,0
2035-07-28,05:52:00,Accelerators,-1163.48,Anchorage AL,44632,4241.8,1
2035-07-28,10:58:00,Jiffy Lube,-52.14,Winter Park FL,32789,5353.14,0
2035-07-28,21:14:00,Dollar Tree,-20.42,Orlando FL,32816,5332.72,0
2035-07-29,21:01:00,McDonald's,-34.38,Winter Park FL,32789,5298.34,0
2035-07-30,08:00:00,Paycheck,2000.0,Oviedo FL,32765,7298.34,0
2035-07-30,21:12:00,Netflix,-46.27,Orlando FL,32816,7252.07,0
2035-07-31,18:50:00,Starbucks,-70.19,Winter Park FL,32789,7181.88,0
2035-07-31,16:46:00,Concert Tickets,-90.31,Winter Park FL,32789,7091.57,0
2035-07-31,16:32:00,Best Buy,-71.94,Winter Park FL,32789,7019.63,0
2035-08-01,09:00:00,Rent,-960.0,Oviedo FL,32765,6059.63,0
2035-08-01,09:00:00,Insurance,-197.46,Oviedo FL,32765,5862.17,0
2035-08-01,09:00:00,Car,-300.0,Oviedo FL,32765,5562.17,0
2035-08-01,13:01:00,Concert Tickets,-46.86,Orlando FL,32816,5515.31,0
2035-08-04,12:20:00,Paypal,-1175.05,Mexico City MC,38511,4340.26,1
2035-08-04,14:47:00,Subway,-19.87,Oviedo FL,32765,5495.44,0
2035-08-05,18:03:00,Walmart,-131.48,Winter Park FL,32789,5363.96,0
2035-08-05,17:09:00,McDonald's,-18.68,Oviedo FL,32765,5345.28,0
2035-08-06,14:42:00,Starbucks,-9.39,Winter Park FL,32789,5335.89,0
2035-08-06,11:49:00,Amazon,-119.99,Winter Park FL,32789,5215.9,0
2035-08-07,09:00:00,Spotify,-11.99,Oviedo FL,32765,5203.91,0
2035-08-07,09:00:00,Internet,-70.89,Oviedo FL,32765,5133.02,0
2035-08-07,09:00:00,ChatGPT Plus,-20.0,Oviedo FL,32765,5113.02,0
2035-08-08,12:57:00,McDonald's,-27.55,Winter Park FL,32789,5085.47,0
2035-08-08,19:39:00,Subway,-14.96,Oviedo FL,32765,5070.51,0
2035-08-10,11:36:00,Jiffy Lube,-154.94,Oviedo FL,32765,4915.57,0
2035-08-10,15:59:00,Walgreens,-44.86,Orlando FL,32816,4870.71,0
2035-08-11,05:44:00,Fraud,-2915.08,London EN,72587,1955.63,1
2035-08-11,14:05:00,Best Buy,-96.51,Oviedo FL,32765,4774.2,0
2035-08-11,18:03:00,Burger King,-9.42,Orlando FL,32816,4764.78,0
2035-08-12,12:40:00,Pawn Stars,-1651.43,London EN,64543,3113.35,1
2035-08-12,19:58:00,Amusement Park,-13.21,Oviedo FL,32765,4751.57,0
2035-08-12,08:54:00,Subway,-9.27,Oviedo FL,32765,4742.3,0
2035-08-12,16:50:00,Walmart,-140.29,Orlando FL,32816,4602.01,0
2035-08-13,08:00:00,Paycheck,2000.0,Oviedo FL,32765,6602.01,0
2035-08-13,18:13:00,Movie Theater,-54.89,Oviedo FL,32765,6547.12,0
2035-08-14,10:22:00,Amazon,-107.9,Orlando FL,32816,6439.22,0
2035-08-14,20:04:00,Dollar Tree,-87.99,Oviedo FL,32765,6351.23,0
2035-08-14,10:00:00,Trader Joe's,-72.12,Orlando FL,32816,6279.11,0
2035-08-15,20:10:00,Burger King,-33.54,Oviedo FL,32765,6245.57,0
2035-08-15,10:20:00,Walgreens,-83.17,Winter Park FL,32789,6162.4,0
2035-08-16,14:55:00,Target,-100.01,Orlando FL,32816,6062.39,0
2035-08-16,10:15:00,AutoZone,-190.41,Winter Park FL,32789,5871.98,0
2035-08-18,12:58:00,Five Below,-48.41,Oviedo FL,32765,5823.57,0
2035-08-18,17:31:00,Chevron,-10.99,Oviedo FL,32765,5812.58,0
2035-08-18,21:02:00,Walmart,-133.86,Winter Park FL,32789,5678.72,0
2035-08-19,09:50:00,Exxon,-12.55,Orlando FL,32816,5666.17,0
2035-08-19,19:50:00,Walmart,-77.86,Oviedo FL,32765,5588.31,0
2035-08-19,15:55:00,Amusement Park,-55.37,Winter Park FL,32789,5532.94,0
2035-08-20,18:20:00,McDonald's,-31.43,Winter Park FL,32789,5501.51,0
2035-08-21,19:35:00,Best Buy,-93.54,Winter Park FL,32789,5407.97,0
2035-08-21,12:38:00,Walmart,-103.04,Orlando FL,32816,5304.93,0
2035-08-22,14:22:00,Exxon,-29.74,Winter Park FL,32789,5275.19,0
2035-08-22,16:04:00,Kroger,-67.03,Winter Park FL,32789,5208.16,0
2035-08-22,14:45:00,Starbucks,-38.86,Orlando FL,32816,5169.3,0
2035-08-23,14:44:00,Starbucks,-30.11,Orlando FL,32816,5139.19,0
2035-08-23,12:42:00,Best Buy,-121.52,Winter Park FL,32789,5017.67,0
2035-08-23,21:53:00,BP,-26.91,Winter Park FL,32789,4990.76,0
2035-08-24,09:36:00,McDonald's,-22.58,Orlando FL,32816,4968.18,0
2035-08-25,13:05:00,Chevron,-18.55,Oviedo FL,32765,4949.63,0
2035-08-25,21:55:00,Walmart,-21.29,Winter Park FL,32789,4928.34,0
2035-08-25,12:21:00,Whole Foods,-40.25,Oviedo FL,32765,4888.09,0
2035-08-26,20:44:00,Walgreens,-40.48,Oviedo FL,32765,4847.61,0
2035-08-26,21:11:00,Dollar Tree,-6.96,Oviedo FL,32765,4840.65,0
2035-08-26,13:08:00,Walgreens,-14.02,Oviedo FL,32765,4826.63,0
2035-08-27,08:00:00,Paycheck,2000.0,Oviedo FL,32765,6826.63,0
2035-08-28,18:56:00,CVS,-50.32,Orlando FL,32816,6776.31,0
2035-08-29,18:10:00,Lockheed Martin,-2235.59,Pyongyang NK,36665,4540.72,1
2035-08-30,09:28:00,McDonald's,-60.87,Oviedo FL,32765,6715.44,0
2035-08-30,20:54:00,Concert Tickets,-75.15,Winter Park FL,32789,6640.29,0
2035-08-30,16:39:00,McDonald's,-66.89,Winter Park FL,32789,6573.4,0
2035-09-01,09:00:00,Rent,-960.0,Oviedo FL,32765,5613.4,0
2035-09-01,09:00:00,Insurance,-197.46,Oviedo FL,32765,5415.94,0
2035-09-01,09:00:00,Car,-300.0,Oviedo FL,32765,5115.94,0
2035-09-01,16:24:00,Movie Theater,-59.34,Oviedo FL,32765,5056.6,0
2035-09-01,20:07:00,Trader Joe's,-38.72,Oviedo FL,32765,5017.88,0
2035-09-01,21:45:00,Subway,-36.6,Oviedo FL,32765,4981.28,0
2035-09-02,13:26:00,McDonald's,-15.92,Orlando FL,32816,4965.36,0
2035-09-02,09:45:00,Walgreens,-28.76,Oviedo FL,32765,4936.6,0
2035-09-02,08:34:00,Onlyfans,-1287.55,Honolulu HI,40125,3649.05,1
2035-09-02,12:08:00,Movie Theater,-10.83,Winter Park FL,32789,4925.77,0
2035-09-03,08:06:00,Onlyfans,-768.76,Anchorage AL,24852,4157.01,1
2035-09-03,17:12:00,BP,-22.74,Orlando FL,32816,4903.03,0
2035-09-03,17:11:00,Walmart,-103.24,Orlando FL,32816,4799.79,0
2035-09-03,10:12:00,Shell,-10.31,Winter Park FL,32789,4789.48,0
2035-09-04,08:50:00,Kroger,-65.93,Winter Park FL,32789,4723.55,0
2035-09-04,16:41:00,Concert Tickets,-10.53,Oviedo FL,32765,4713.02,0
2035-09-04,18:05:00,Best Buy,-24.79,Oviedo FL,32765,4688.23,0
2035-09-07,09:00:00,Spotify,-11.99,Oviedo FL,32765,4676.24,0
2035-09-07,09:00:00,Internet,-70.89,Oviedo FL,32765,4605.35,0
2035-09-07,09:00:00,ChatGPT Plus,-20.0,Oviedo FL,32765,4585.35,0
2035-09-07,19:03:00,Chevron,-13.25,Winter Park FL,32789,4572.1,0
2035-09-07,13:31:00,McDonald's,-22.62,Oviedo FL,32765,4549.48,0
2035-09-07,14:45:00,McDonald's,-18.31,Orlando FL,32816,4531.17,0
2035-09-08,12:42:00,Chevron,-24.31,Oviedo FL,32765,4506.86,0
2035-09-09,16:35:00,Best Buy,-96.5,Oviedo FL,32765,4410.36,0
2035-09-09,18:38:00,Starbucks,-12.4,Orlando FL,32816,4397.96,0
2035-09-09,09:03:00,Walgreens,-46.96,Winter Park FL,32789,4351.0,0
2035-09-10,08:00:00,Paycheck,2000.0,Oviedo FL,32765,6351.0,0
2035-09-10,11:42:00,Impractical Jokers,-2662.54,Pyongyang NK,12715,3688.46,1
2035-09-11,11:28:00,Walmart,-195.68,Winter Park FL,32789,6155.32,0
2035-09-11,11:54:00,Subway,-44.7,Winter Park FL,32789,6110.62,0
2035-09-12,10:21:00,Best Buy,-71.92,Winter Park FL,32789,6038.7,0
2035-09-14,15:29:00,Walmart,-114.77,Winter Park FL,32789,5923.93,0
2035-09-15,09:40:00,CVS,-15.63,Oviedo FL,32765,5908.3,0
2035-09-15,16:10:00,BP,-12.67,Oviedo FL,32765,5895.63,0
2035-09-15,11:56:00,Amazon,-72.94,Winter Park FL,32789,5822.69,0
2035-09-16,19:27:00,Subway,-37.01,Orlando FL,32816,5785.68,0
2035-09-16,14:18:00,Dollar Tree,-38.43,Winter Park FL,32789,5747.25,0
2035-09-17,17:59:00,Five Below,-27.67,Winter Park FL,32789,5719.58,0
2035-09-19,18:19:00,McDonald's,-21.32,Winter Park FL,32789,5698.26,0
2035-09-19,02:05:00,IBM,-1242.66,Charleston SC,87850,4455.6,1
2035-09-21,11:04:00,Movie Theater,-49.3,Winter Park FL,32789,5648.96,0
2035-09-21,18:09:00,Starbucks,-5.59,Orlando FL,32816,5643.37,0
2035-09-22,13:46:00,McDonald's,-11.76,Oviedo FL,32765,5631.61,0
2035-09-22,21:39:00,Target,-102.94,Winter Park FL,32789,5528.67,0
2035-09-22,10:32:00,Midas,-196.74,Winter Park FL,32789,5331.93,0
2035-09-23,10:28:00,Trader Joe's,-46.43,Oviedo FL,32765,5285.5,0
2035-09-23,11:14:00,Movie Theater,-42.33,Winter Park FL,32789,5243.17,0
2035-09-24,08:00:00,Paycheck,2000.0,Oviedo FL,32765,7243.17,0
2035-09-24,12:58:00,Whole Foods,-90.69,Orlando FL,32816,7152.48,0
2035-09-24,21:22:00,Subway,-33.82,Winter Park FL,32789,7118.66,0
2035-09-25,10:25:00,Walgreens,-90.3,Orlando FL,32816,7028.36,0
2035-09-25,11:34:00,Dollar Tree,-59.69,Winter Park FL,32789,6968.67,0
2035-09-25,11:04:00,Kroger,-135.52,Oviedo FL,32765,6833.15,0
2035-09-26,12:54:00,Starbucks,-15.52,Winter Park FL,32789,6817.63,0
2035-09-27,11:27:00,Chevron,-24.73,Orlando FL,32816,6792.9,0
2035-09-27,11:18:00,Amusement Park,-99.8,Oviedo FL,32765,6693.1,0
2035-09-27,17:12:00,McDonald's,-60.47,Orlando FL,32816,6632.63,0
2035-09-29,08:36:00,Movie Theater,-59.41,Oviedo FL,32765,6573.22,0
2035-09-29,08:28:00,Walgreens,-76.74,Oviedo FL,32765,6496.48,0
2035-09-30,14:06:00,Whole Foods,-140.54,Oviedo FL,32765,6355.94,0
2035-09-30,20:35:00,Subway,-57.27,Oviedo FL,32765,6298.67,0
2035-10-01,09:00:00,Rent,-960.0,Oviedo FL,32765,5338.67,0
2035-10-01,09:00:00,Insurance,-197.46,Oviedo FL,32765,5141.21,0
2035-10-01,09:00:00,Car,-300.0,Oviedo FL,32765,4841.21,0
2035-10-01,12:58:00,Shell,-19.27,Oviedo FL,32765,4821.94,0
2035-10-02,16:24:00,Starbucks,-29.65,Winter Park FL,32789,4792.29,0
2035-10-02,14:38:00,McDonald's,-25.91,Oviedo FL,32765,4766.38,0
2035-10-02,01:23:00,Servicenow,-2945.94,London EN,43272,1820.44,1
2035-10-02,19:05:00,Kroger,-63.73,Winter Park FL,32789,4702.65,0
2035-10-03,08:48:00,Monster Energy,-933.02,Charleston SC,12422,3769.63,1
2035-10-04,20:04:00,Pep Boys,-60.95,Oviedo FL,32765,4641.7,0
2035-10-05,14:05:00,Starbucks,-26.71,Winter Park FL,32789,4614.99,0
2035-10-05,16:09:00,Paypal,-644.13,Charleston SC,52058,3970.86,1
2035-10-07,09:00:00,Spotify,-11.99,Oviedo FL,32765,4603.0,0
2035-10-07,09:00:00,Internet,-70.89,Oviedo FL,32765,4532.11,0
2035-10-07,09:00:00,ChatGPT Plus,-20.0,Oviedo FL,32765,4512.11,0
2035-10-07,12:05:00,Trader Joe's,-94.56,Oviedo FL,32765,4417.55,0
2035-10-07,08:31:00,BP,-28.35,Winter Park FL,32789,4389.2,0
2035-10-08,08:00:00,Paycheck,2000.0,Oviedo FL,32765,6389.2,0
2035-10-08,00:15:00,Onlyfans,-2434.09,Groton CT,43520,3955.11,1
2035-10-09,08:38:00,Publix,-121.28,Oviedo FL,32765,6267.92,0
2035-10-09,12:16:00,Shell,-25.18,Orlando FL,32816,6242.74,0
2035-10-09,10:38:00,Subway,-43.95,Orlando FL,32816,6198.79,0
2035-10-10,21:58:00,Amusement Park,-48.39,Oviedo FL,32765,6150.4,0
2035-10-10,20:34:00,McDonald's,-76.01,Oviedo FL,32765,6074.39,0
2035-10-10,08:18:00,Amazon,-193.1,Orlando FL,32816,5881.29,0
2035-10-11,12:04:00,Subway,-11.49,Winter Park FL,32789,5869.8,0
2035-10-11,12:30:00,Monster Energy,-2174.86,Pyongyang NK,92046,3694.94,1
2035-10-11,14:45:00,Target,-147.3,Oviedo FL,32765,5722.5,0
2035-10-13,14:06:00,Walgreens,-25.42,Orlando FL,32816,5697.08,0
2035-10-16,13:22:00,Burger King,-18.47,Winter Park FL,32789,5678.61,0
2035-10-16,14:12:00,Kroger,-34.29,Oviedo FL,32765,5644.32,0
2035-10-17,08:39:00,Concert Tickets,-10.64,Winter Park FL,32789,5633.68,0
2035-10-17,18:59:00,Walmart,-11.86,Orlando FL,32816,5621.82,0
2035-10-18,20:50:00,Amusement Park,-59.51,Oviedo FL,32765,5562.31,0
2035-10-18,14:43:00,Chevron,-21.91,Orlando FL,32816,5540.4,0
2035-10-19,08:56:00,McDonald's,-14.9,Oviedo FL,32765,5525.5,0
2035-10-19,19:18:00,Subway,-27.64,Orlando FL,32816,5497.86,0
2035-10-19,20:09:00,Five Below,-34.58,Winter Park FL,32789,5463.28,0
2035-10-20,08:25:00,BP,-17.2,Oviedo FL,32765,5446.08,0
2035-10-20,20:30:00,Burger King,-33.15,Orlando FL,32816,5412.93,0
2035-10-20,12:02:00,Amazon,-101.71,Orlando FL,32816,5311.22,0
2035-10-22,08:00:00,Paycheck,2000.0,Oviedo FL,32765,7311.22,0
2035-10-22,20:14:00,Kroger,-97.38,Orlando FL,32816,7213.84,0
2035-10-22,10:18:00,Subway,-76.9,Oviedo FL,32765,7136.94,0
2035-10-23,15:57:00,Starbucks,-25.59,Winter Park FL,32789,7111.35,0
2035-10-23,19:52:00,Walmart,-222.71,Orlando FL,32816,6888.64,0
2035-10-25,19:18:00,Trader Joe's,-121.77,Orlando FL,32816,6766.87,0
2035-10-25,09:35:00,Dollar Tree,-78.9,Winter Park FL,32789,6687.97,0
2035-10-25,21:08:00,Movie Theater,-34.25,Oviedo FL,32765,6653.72,0
2035-10-26,08:08:00,Subway,-55.93,Oviedo FL,32765,6597.79,0
2035-10-26,13:02:00,Chevron,-35.29,Oviedo FL,32765,6562.5,0
2035-10-27,15:10:00,Five Below,-51.8,Orlando FL,32816,6510.7,0
2035-10-27,17:00:00,Target,-26.7,Oviedo FL,32765,6484.0,0
2035-10-28,17:27:00,Jiffy Lube,-297.95,Orlando FL,32816,6186.05,0
2035-10-28,10:22:00,Pawn Stars,-1169.71,Groton CT,49958,5016.34,1
2035-10-28,12:06:00,Burger King,-50.03,Winter Park FL,32789,6136.02,0
2035-10-29,08:49:00,Amusement Park,-83.63,Orlando FL,32816,6052.39,0
2035-10-29,23:49:00,Fat Joe,-448.55,New York NY,92869,5603.84,1
2035-10-30,08:00:00,Dollar Tree,-21.9,Oviedo FL,32765,6030.49,0
2035-10-31,16:01:00,Best Buy,-154.37,Oviedo FL,32765,5876.12,0
2035-10-31,13:44:00,Netflix,-18.22,Orlando FL,32816,5857.9,0
2035-10-31,15:15:00,Burger King,-18.71,Orlando FL,32816,5839.19,0
2035-11-01,09:00:00,Rent,-960.0,Oviedo FL,32765,4879.19,0
2035-11-01,09:00:00,Insurance,-197.46,Oviedo FL,32765,4681.73,0
2035-11-01,09:00:00,Car,-300.0,Oviedo FL,32765,4381.73,0
2035-11-01,12:25:00,Starbucks,-18.18,Winter Park FL,32789,4363.55,0
2035-11-02,20:55:00,Jiffy Lube,-94.3,Orlando FL,32816,4269.25,0
2035-11-02,15:39:00,Dollar Tree,-34.52,Orlando FL,32816,4234.73,0
2035-11-02,09:59:00,CVS,-14.67,Oviedo FL,32765,4220.06,0
2035-11-04,17:05:00,Kroger,-97.33,Orlando FL,32816,4122.73,0
2035-11-04,17:20:00,Burger King,-37.76,Orlando FL,32816,4084.97,0
2035-11-05,08:00:00,Paycheck,2000.0,Oviedo FL,32765,6084.97,0
2035-11-05,16:20:00,Burger King,-78.43,Winter Park FL,32789,6006.54,0
2035-11-06,20:22:00,BP,-26.1,Winter Park FL,32789,5980.44,0
2035-11-06,12:25:00,Best Buy,-107.96,Oviedo FL,32765,5872.48,0
2035-11-06,13:33:00,Walgreens,-39.05,Oviedo FL,32765,5833.43,0
2035-11-07,09:00:00,Spotify,-11.99,Oviedo FL,32765,5821.44,0
2035-11-07,09:00:00,Internet,-70.89,Oviedo FL,32765,5750.55,0
2035-11-07,09:00:00,ChatGPT Plus,-20.0,Oviedo FL,32765,5730.55,0
2035-11-09,09:42:00,Burger King,-26.03,Oviedo FL,32765,5704.52,0
2035-11-09,14:32:00,Concert Tickets,-49.98,Orlando FL,32816,5654.54,0
2035-11-09,17:36:00,Dollar Tree,-30.31,Oviedo FL,32765,5624.23,0
2035-11-09,22:18:00,Impractical Jokers,-2088.1,Charleston SC,27401,3536.13,1
2035-11-10,19:19:00,Walmart,-52.44,Oviedo FL,32765,5571.79,0
2035-11-10,15:21:00,CVS,-44.73,Orlando FL,32816,5527.06,0
2035-11-11,12:31:00,Walmart,-16.96,Oviedo FL,32765,5510.1,0
2035-11-11,15:37:00,Starbucks,-12.49,Oviedo FL,32765,5497.61,0
2035-11-11,12:15:00,Impractical Jokers,-967.51,New York NY,38676,4530.1,1
2035-11-12,21:24:00,Walmart,-10.81,Orlando FL,32816,5486.8,0
2035-11-12,18:11:00,Kroger,-33.78,Oviedo FL,32765,5453.02,0
2035-11-12,18:38:00,Pawn Stars,-324.05,London EN,71602,5128.97,1
2035-11-13,11:26:00,AutoZone,-135.84,Orlando FL,32816,5317.18,0
2035-11-14,17:48:00,Walmart,-46.54,Winter Park FL,32789,5270.64,0
2035-11-14,16:12:00,Walgreens,-22.86,Winter Park FL,32789,5247.78,0
2035-11-16,12:24:00,Kroger,-48.84,Winter Park FL,32789,5198.94,0
2035-11-16,11:48:00,Best Buy,-124.25,Orlando FL,32816,5074.69,0
2035-11-17,15:39:00,Netflix,-16.98,Oviedo FL,32765,5057.71,0
2035-11-17,17:05:00,Amazon,-51.3,Orlando FL,32816,5006.41,0
2035-11-17,19:09:00,Subway,-6.8,Winter Park FL,32789,4999.61,0
2035-11-17,02:00:00,Impractical Jokers,-1922.6,Pyongyang NK,88643,3077.01,1
2035-11-19,08:00:00,Paycheck,2000.0,Oviedo FL,32765,6999.61,0
2035-11-20,13:39:00,Best Buy,-75.03,Winter Park FL,32789,6924.58,0
2035-11-20,08:12:00,Starbucks,-29.8,Orlando FL,32816,6894.78,0
2035-11-20,22:56:00,Paypal,-2588.62,London EN,72855,4306.16,1
2035-11-23,16:07:00,Exxon,-49.3,Oviedo FL,32765,6845.48,0
2035-11-23,16:56:00,Target,-211.48,Orlando FL,32816,6634.0,0
2035-11-24,16:19:00,Paypal,-614.07,New York NY,43947,6019.93,1
2035-11-27,19:03:00,Best Buy,-191.1,Orlando FL,32816,6442.9,0
2035-11-27,10:36:00,Burger King,-69.32,Winter Park FL,32789,6373.58,0
2035-11-27,14:39:00,Trader Joe's,-99.82,Winter Park FL,32789,6273.76,0
2035-12-01,09:00:00,Rent,-960.0,Oviedo FL,32765,5313.76,0
2035-12-01,09:00:00,Insurance,-197.46,Oviedo FL,32765,5116.3,0
2035-12-01,09:00:00,Car,-300.0,Oviedo FL,32765,4816.3,0
2035-12-02,09:14:00,Midas,-118.9,Oviedo FL,32765,4697.4,0
2035-12-02,13:28:00,Burger King,-9.03,Orlando FL,32816,4688.37,0
2035-12-03,08:00:00,Paycheck,2000.0,Oviedo FL,32765,6688.37,0
2035-12-04,08:42:00,Amazon,-73.18,Oviedo FL,32765,6615.19,0
2035-12-04,17:42:00,Movie Theater,-31.77,Winter Park FL,32789,6583.42,0
2035-12-05,17:19:00,Servicenow,-136.57,Mexico City MC,57506,6446.85,1
2035-12-05,18:35:00,Target,-265.04,Orlando FL,32816,6318.38,0
2035-12-05,11:46:00,McDonald's,-27.3,Oviedo FL,32765,6291.08,0
2035-12-05,18:17:00,Burger King,-47.04,Winter Park FL,32789,6244.04,0
2035-12-06,06:46:00,Pawn Stars,-548.98,Anchorage AL,81456,5695.06,1
2035-12-07,09:00:00,Spotify,-11.99,Oviedo FL,32765,6232.05,0
2035-12-07,09:00:00,Internet,-70.89,Oviedo FL,32765,6161.16,0
2035-12-07,09:00:00,ChatGPT Plus,-20.0,Oviedo FL,32765,6141.16,0
2035-12-07,17:37:00,Starbucks,-41.7,Orlando FL,32816,6099.46,0
2035-12-08,19:45:00,Subway,-41.33,Orlando FL,32816,6058.13,0
2035-12-08,12:14:00,Dollar Tree,-13.89,Winter Park FL,32789,6044.24,0
2035-12-09,17:30:00,Starbucks,-24.24,Oviedo FL,32765,6020.0,0
2035-12-10,13:15:00,Netflix,-36.57,Orlando FL,32816,5983.43,0
2035-12-10,09:45:00,Amazon,-70.62,Orlando FL,32816,5912.81,0
2035-12-11,11:43:00,Starbucks,-13.53,Winter Park FL,32789,5899.28,0
2035-12-11,21:20:00,Dollar Tree,-14.9,Oviedo FL,32765,5884.38,0
2035-12-11,09:13:00,Dollar Tree,-12.68,Winter Park FL,32789,5871.7,0
2035-12-12,10:16:00,Subway,-23.47,Winter Park FL,32789,5848.23,0
2035-12-12,14:00:00,Amusement Park,-46.13,Winter Park FL,32789,5802.1,0
2035-12-12,18:56:00,Movie Theater,-32.22,Winter Park FL,32789,5769.88,0
2035-12-12,09:50:00,IBM,-1033.68,New York NY,87567,4736.2,1
2035-12-14,00:50:00,IBM,-2258.84,Pittsburgh PA,93885,3511.04,1
2035-12-15,13:23:00,Concert Tickets,-12.96,Oviedo FL,32765,5756.92,0
2035-12-15,20:47:00,Starbucks,-24.11,Orlando FL,32816,5732.81,0
2035-12-16,19:36:00,Burger King,-19.42,Orlando FL,32816,5713.39,0
2035-12-17,08:00:00,Paycheck,2000.0,Oviedo FL,32765,7713.39,0
2035-12-17,08:51:00,Exxon,-54.69,Oviedo FL,32765,7658.7,0
2035-12-17,18:30:00,Starbucks,-59.7,Orlando FL,32816,7599.0,0
2035-12-17,20:19:00,Paypal,-770.64,Honolulu HI,54581,6828.36,1
2035-12-17,13:25:00,Whole Foods,-73.61,Orlando FL,32816,7525.39,0
2035-12-20,21:10:00,Walmart,-65.9,Winter Park FL,32789,7459.49,0
2035-12-20,15:59:00,Subway,-20.1,Oviedo FL,32765,7439.39,0
2035-12-20,13:30:00,Movie Theater,-105.27,Orlando FL,32816,7334.12,0
2035-12-21,09:00:00,Subway,-33.34,Orlando FL,32816,7300.78,0
2035-12-21,10:43:00,Trader Joe's,-172.88,Orlando FL,32816,7127.9,0
2035-12-21,10:06:00,Amazon,-202.52,Orlando FL,32816,6925.38,0
2035-12-21,14:55:00,Accelerators,-768.84,Tokyo JP,78501,6156.54,1
2035-12-22,15:11:00,Burger King,-11.37,Winter Park FL,32789,6914.01,0
2035-12-22,11:09:00,AutoZone,-227.29,Orlando FL,32816,6686.72,0
2035-12-23,13:59:00,Netflix,-47.69,Orlando FL,32816,6639.03,0
2035-12-23,12:58:00,Servicenow,-759.34,Charleston SC,74354,5879.69,1
2035-12-24,19:22:00,Burger King,-59.33,Orlando FL,32816,6579.7,0
2035-12-24,18:07:00,Best Buy,-221.25,Orlando FL,32816,6358.45,0
2035-12-24,07:07:00,Lockheed Martin,-419.42,Groton CT,63494,5939.03,1
2035-12-25,08:52:00,Dollar Tree,-24.45,Orlando FL,32816,6334.0,0
2035-12-25,17:08:00,Subway,-61.59,Winter Park FL,32789,6272.41,0
2035-12-26,18:17:00,Shell,-27.66,Winter Park FL,32789,6244.75,0
2035-12-26,15:06:00,Burger King,-78.33,Orlando FL,32816,6166.42,0
2035-12-26,13:07:00,Walmart,-240.79,Orlando FL,32816,5925.63,0
2035-12-27,16:28:00,Trader Joe's,-73.92,Winter Park FL,32789,5851.71,0
2035-12-29,16:35:00,Publix,-97.03,Winter Park FL,32789,5754.68,0
2035-12-29,14:13:00,Starbucks,-25.49,Oviedo FL,32765,5729.19,0
2035-12-30,09:31:00,Kroger,-97.53,Orlando FL,32816,5631.66,0
2035-12-30,20:23:00,Pawn Stars,-1154.74,Tokyo JP,48672,4476.92,1
2035-12-30,10:06:00,Burger King,-15.32,Oviedo FL,32765,5616.34,0
2035-12-30,12:41:00,Subway,-30.23,Orlando FL,32816,5586.11,0
2035-12-31,08:00:00,Paycheck,2000.0,Oviedo FL,32765,7586.11,0
2035-12-31,00:11:00,Magic the Gathering,-2043.39,Charleston SC,92728,5542.72,1
2035-12-31,18:15:00,Dollar Tree,-97.28,Winter Park FL,32789,7488.83,0
2035-12-31,11:14:00,Walgreens,-86.44,Winter Park FL,32789,7402.39,0
2035-12-31,15:53:00,Whole Foods,-164.6,Winter Park FL,32789,7237.79,0
2036-01-01,09:00:00,Rent,-960.0,Oviedo FL,32765,6277.79,0
2036-01-01,09:00:00,Insurance,-197.46,Oviedo FL,32765,6080.33,0
2036-01-01,09:00:00,Car,-300.0,Oviedo FL,32765,5780.33,0
2036-01-01,20:57:00,Walgreens,-8.1,Orlando FL,32816,5772.23,0
2036-01-01,14:20:00,Burger King,-29.08,Orlando FL,32816,5743.15,0
2036-01-02,08:12:00,Amazon,-99.85,Winter Park FL,32789,5643.3,0
2036-01-03,10:00:00,Chevron,-24.63,Orlando FL,32816,5618.67,0
2036-01-03,11:27:00,McDonald's,-17.05,Winter Park FL,32789,5601.62,0
2036-01-03,13:16:00,Jiffy Lube,-124.46,Oviedo FL,32765,5477.16,0
2036-01-04,13:53:00,Five Below,-13.46,Oviedo FL,32765,5463.7,0
2036-01-04,10:34:00,Whole Foods,-50.28,Winter Park FL,32789,5413.42,0
2036-01-05,09:54:00,Starbucks,-16.36,Winter Park FL,32789,5397.06,0
2036-01-06,09:03:00,McDonald's,-31.64,Orlando FL,32816,5365.42,0
2036-01-07,09:00:00,Spotify,-11.99,Oviedo FL,32765,5353.43,0
2036-01-07,09:00:00,Internet,-70.89,Oviedo FL,32765,5282.54,0
2036-01-07,09:00:00,ChatGPT Plus,-20.0,Oviedo FL,32765,5262.54,0
2036-01-07,10:10:00,Walmart,-78.6,Orlando FL,32816,5183.94,0
2036-01-07,07:29:00,Magic the Gathering,-2865.32,London EN,63059,2318.62,1
2036-01-07,21:15:00,Chevron,-20.31,Winter Park FL,32789,5163.63,0
2036-01-09,08:15:00,Lockheed Martin,-793.97,Honolulu HI,62904,4369.66,1
2036-01-09,12:24:00,Best Buy,-118.56,Oviedo FL,32765,5045.07,0
2036-01-10,12:21:00,Best Buy,-17.7,Orlando FL,32816,5027.37,0
2036-01-11,17:22:00,Amazon,-145.79,Orlando FL,32816,4881.58,0
2036-01-11,08:00:00,Walgreens,-16.35,Oviedo FL,32765,4865.23,0
2036-01-11,21:57:00,Subway,-15.3,Oviedo FL,32765,4849.93,0
2036-01-12,18:12:00,Chevron,-11.74,Winter Park FL,32789,4838.19,0
2036-01-12,10:17:00,McDonald's,-9.45,Oviedo FL,32765,4828.74,0
2036-01-12,13:41:00,CVS,-45.53,Winter Park FL,32789,4783.21,0
2036-01-13,17:11:00,Subway,-21.52,Orlando FL,32816,4761.69,0
2036-01-13,14:05:00,Walgreens,-16.32,Winter Park FL,32789,4745.37,0
2036-01-14,08:00:00,Paycheck,2000.0,Oviedo FL,32765,6745.37,0
2036-01-14,10:08:00,Walmart,-24.79,Winter Park FL,32789,6720.58,0
2036-01-14,12:43:00,Walgreens,-75.05,Orlando FL,32816,6645.53,0
2036-01-16,14:46:00,Subway,-28.29,Orlando FL,32816,6617.24,0
2036-01-16,19:46:00,Shell,-44.03,Oviedo FL,32765,6573.21,0
2036-01-17,14:42:00,Dollar Tree,-82.19,Winter Park FL,32789,6491.02,0
2036-01-17,09:46:00,Chevron,-52.82,Oviedo FL,32765,6438.2,0
2036-01-17,10:20:00,McDonald's,-68.81,Oviedo FL,32765,6369.39,0
2036-01-18,17:28:00,Shell,-37.48,Oviedo FL,32765,6331.91,0
2036-01-20,16:07:00,Dollar Tree,-86.93,Winter Park FL,32789,6244.98,0
2036-01-20,21:00:00,Netflix,-59.37,Winter Park FL,32789,6185.61,0
2036-01-21,10:53:00,Monster Energy,-1614.91,Mexico City MC,44397,4570.7,1
2036-01-21,08:42:00,Trader Joe's,-152.46,Winter Park FL,32789,6033.15,0
2036-01-24,15:22:00,Netflix,-48.2,Winter Park FL,32789,5984.95,0
2036-01-26,21:55:00,Amusement Park,-33.76,Oviedo FL,32765,5951.19,0
2036-01-26,12:38:00,CVS,-32.33,Winter Park FL,32789,5918.86,0
2036-01-26,17:33:00,Trader Joe's,-30.6,Winter Park FL,32789,5888.26,0
2036-01-27,14:42:00,Amusement Park,-26.16,Oviedo FL,32765,5862.1,0
2036-01-27,12:54:00,Dollar Tree,-35.53,Orlando FL,32816,5826.57,0
2036-01-27,14:14:00,Whole Foods,-43.09,Orlando FL,32816,5783.48,0
2036-01-28,08:00:00,Paycheck,2000.0,Oviedo FL,32765,7783.48,0
2036-01-28,11:35:00,Exxon,-31.36,Winter Park FL,32789,7752.12,0
2036-01-28,20:51:00,Dollar Tree,-85.73,Oviedo FL,32765,7666.39,0
2036-01-29,15:52:00,McDonald's,-53.21,Oviedo FL,32765,7613.18,0
2036-01-29,13:42:00,Amazon,-64.9,Winter Park FL,32789,7548.28,0
2036-01-30,08:29:00,Target,-115.73,Winter Park FL,32789,7432.55,0
2036-01-30,12:39:00,Burger King,-56.68,Winter Park FL,32789,7375.87,0
2036-01-31,11:32:00,Onlyfans,-1872.47,Honolulu HI,78931,5503.4,1
2036-01-31,12:52:00,CVS,-55.79,Oviedo FL,32765,7320.08,0
2036-02-01,09:00:00,Rent,-960.0,Oviedo FL,32765,6360.08,0
2036-02-01,09:00:00,Insurance,-197.46,Oviedo FL,32765,6162.62,0
2036-02-01,09:00:00,Car,-300.0,Oviedo FL,32765,5862.62,0
2036-02-01,14:14:00,Chevron,-19.29,Orlando FL,32816,5843.33,0
2036-02-01,14:29:00,Walgreens,-17.96,Winter Park FL,32789,5825.37,0
2036-02-01,12:42:00,Amazon,-70.67,Winter Park FL,32789,5754.7,0
2036-02-02,17:03:00,Walgreens,-26.15,Oviedo FL,32765,5728.55,0
2036-02-02,16:56:00,Subway,-31.71,Orlando FL,32816,5696.84,0
2036-02-02,16:58:00,Movie Theater,-34.5,Oviedo FL,32765,5662.34,0
2036-02-04,14:08:00,Whole Foods,-96.03,Orlando FL,32816,5566.31,0
2036-02-04,17:11:00,Starbucks,-30.27,Oviedo FL,32765,5536.04,0
2036-02-06,09:01:00,Burger King,-19.18,Orlando FL,32816,5516.86,0
2036-02-06,15:05:00,Amazon,-30.73,Orlando FL,32816,5486.13,0
2036-02-06,18:17:00,Lockheed Martin,-1106.04,Charleston SC,84862,4380.09,1
2036-02-07,09:00:00,Spotify,-11.99,Oviedo FL,32765,5474.14,0
2036-02-07,09:00:00,Internet,-70.89,Oviedo FL,32765,5403.25,0
2036-02-07,09:00:00,ChatGPT Plus,-20.0,Oviedo FL,32765,5383.25,0
2036-02-08,20:38:00,Whole Foods,-61.38,Oviedo FL,32765,5321.87,0
2036-02-08,15:27:00,Whole Foods,-95.31,Oviedo FL,32765,5226.56,0
2036-02-09,08:09:00,Dollar Tree,-11.27,Orlando FL,32816,5215.29,0
2036-02-09,08:20:00,Accelerators,-2260.27,Los Angeles CA,36235,2955.02,1
2036-02-09,08:15:00,Publix,-51.94,Winter Park FL,32789,5163.35,0
2036-02-09,17:06:00,Best Buy,-139.14,Oviedo FL,32765,5024.21,0
2036-02-10,17:00:00,Fraud,-1050.62,London EN,70952,3973.59,1
2036-02-10,08:16:00,Whole Foods,-77.33,Orlando FL,32816,4946.88,0
2036-02-10,05:20:00,Pawn Stars,-2164.99,Los Angeles CA,91790,2781.89,1
2036-02-10,17:46:00,Movie Theater,-11.69,Winter Park FL,32789,4935.19,0
2036-02-10,09:11:00,Shell,-24.13,Orlando FL,32816,4911.06,0
2036-02-11,08:00:00,Paycheck,2000.0,Oviedo FL,32765,6911.06,0
2036-02-11,15:57:00,Best Buy,-245.17,Oviedo FL,32765,6665.89,0
2036-02-12,14:12:00,Walmart,-78.2,Winter Park FL,32789,6587.69,0
2036-02-12,19:30:00,Movie Theater,-27.07,Winter Park FL,32789,6560.62,0
2036-02-12,16:04:00,Amazon,-110.52,Winter Park FL,32789,6450.1,0
2036-02-14,15:47:00,McDonald's,-50.07,Orlando FL,32816,6400.03,0
2036-02-14,12:16:00,Target,-60.71,Orlando FL,32816,6339.32,0
2036-02-16,09:04:00,Subway,-65.76,Oviedo FL,32765,6273.56,0
2036-02-17,19:02:00,Publix,-127.83,Oviedo FL,32765,6145.73,0
2036-02-17,18:05:00,Movie Theater,-56.22,Winter Park FL,32789,6089.51,0
2036-02-17,17:26:00,Burger King,-35.39,Orlando FL,32816,6054.12,0
2036-02-18,08:00:00,Walgreens,-15.38,Winter Park FL,32789,6038.74,0
2036-02-18,16:04:00,McDonald's,-43.12,Orlando FL,32816,5995.62,0
2036-02-18,19:57:00,McDonald's,-19.39,Orlando FL,32816,5976.23,0
2036-02-19,18:30:00,CVS,-37.6,Winter Park FL,32789,5938.63,0
2036-02-19,17:00:00,Burger King,-8.93,Orlando FL,32816,5929.7,0
2036-02-19,04:57:00,Magic the Gathering,-1872.63,Mexico City MC,43537,4057.07,1
2036-02-19,18:56:00,Amusement Park,-47.47,Orlando FL,32816,5882.23,0
2036-02-21,20:54:00,McDonald's,-24.72,Winter Park FL,32789,5857.51,0
2036-02-21,21:28:00,Chevron,-21.71,Winter Park FL,32789,5835.8,0
2036-02-22,08:20:00,AutoZone,-86.82,Winter Park FL,32789,5748.98,0
2036-02-22,19:05:00,McDonald's,-22.42,Oviedo FL,32765,5726.56,0
2036-02-22,19:26:00,Kroger,-43.12,Orlando FL,32816,5683.44,0
2036-02-23,18:45:00,Trader Joe's,-95.74,Orlando FL,32816,5587.7,0
2036-02-23,14:40:00,Pawn Stars,-1338.38,Pyongyang NK,12888,4249.32,1
2036-02-24,13:26:00,McDonald's,-7.1,Oviedo FL,32765,5580.6,0
2036-02-25,08:00:00,Paycheck,2000.0,Oviedo FL,32765,7580.6,0
2036-02-25,13:02:00,CVS,-55.0,Oviedo FL,32765,7525.6,0
2036-02-26,10:55:00,Starbucks,-14.62,Orlando FL,32816,7510.98,0
2036-02-29,15:30:00,McDonald's,-53.49,Oviedo FL,32765,7457.49,0
2036-03-01,09:00:00,Rent,-960.0,Oviedo FL,32765,6497.49,0
2036-03-01,09:00:00,Insurance,-197.46,Oviedo FL,32765,6300.03,0
2036-03-01,09:00:00,Car,-300.0,Oviedo FL,32765,6000.03,0
2036-03-01,20:32:00,Burger King,-43.77,Oviedo FL,32765,5956.26,0
2036-03-01,22:30:00,Magic the Gathering,-1634.51,Anchorage AL,89134,4321.75,1
2036-03-01,19:20:00,Subway,-27.56,Orlando FL,32816,5928.7,0
2036-03-01,11:45:00,CVS,-27.53,Winter Park FL,32789,5901.17,0
2036-03-02,16:39:00,Starbucks,-18.96,Winter Park FL,32789,5882.21,0
2036-03-02,16:19:00,Five Below,-27.31,Winter Park FL,32789,5854.9,0
2036-03-04,09:17:00,Whole Foods,-55.13,Oviedo FL,32765,5799.77,0
2036-03-05,21:38:00,Subway,-35.03,Winter Park FL,32789,5764.74,0
2036-03-05,20:33:00,Pep Boys,-188.36,Oviedo FL,32765,5576.38,0
2036-03-07,09:00:00,Spotify,-11.99,Oviedo FL,32765,5564.39,0
2036-03-07,09:00:00,Internet,-70.89,Oviedo FL,32765,5493.5,0
2036-03-07,09:00:00,ChatGPT Plus,-20.0,Oviedo FL,32765,5473.5,0
2036-03-07,10:09:00,Burger King,-8.9,Oviedo FL,32765,5464.6,0
2036-03-08,15:52:00,Whole Foods,-30.68,Orlando FL,32816,5433.92,0
2036-03-08,18:32:00,Shell,-17.46,Orlando FL,32816,5416.46,0
2036-03-08,14:06:00,Amazon,-33.8,Winter Park FL,32789,5382.66,0
2036-03-09,07:58:00,Lockheed Martin,-430.89,Tokyo JP,68976,4951.77,1
2036-03-10,08:00:00,Paycheck,2000.0,Oviedo FL,32765,7382.66,0
2036-03-10,13:37:00,Burger King,-46.9,Winter Park FL,32789,7335.76,0
2036-03-11,08:49:00,McDonald's,-67.79,Oviedo FL,32765,7267.97,0
2036-03-11,15:51:00,Amusement Park,-50.5,Winter Park FL,32789,7217.47,0
2036-03-12,13:38:00,Five Below,-83.06,Winter Park FL,32789,7134.41,0
2036-03-12,17:43:00,Amusement Park,-74.4,Oviedo FL,32765,7060.01,0
2036-03-14,09:19:00,Publix,-108.14,Orlando FL,32816,6951.87,0
2036-03-14,08:39:00,Pep Boys,-162.02,Oviedo FL,32765,6789.85,0
2036-03-14,09:52:00,Walmart,-263.06,Oviedo FL,32765,6526.79,0
2036-03-15,21:53:00,McDonald's,-29.57,Oviedo FL,32765,6497.22,0
2036-03-15,14:56:00,Subway,-48.63,Winter Park FL,32789,6448.59,0
2036-03-16,21:08:00,Netflix,-60.69,Winter Park FL,32789,6387.9,0
2036-03-16,17:23:00,Starbucks,-73.69,Oviedo FL,32765,6314.21,0
2036-03-20,21:52:00,Starbucks,-35.72,Orlando FL,32816,6278.49,0
2036-03-20,11:01:00,Walmart,-275.55,Orlando FL,32816,6002.94,0
2036-03-20,16:42:00,Concert Tickets,-117.01,Orlando FL,32816,5885.93,0
2036-03-21,12:49:00,Amazon,-135.63,Oviedo FL,32765,5750.3,0
2036-03-23,10:46:00,CVS,-24.4,Oviedo FL,32765,5725.9,0
2036-03-24,08:00:00,Paycheck,2000.0,Oviedo FL,32765,7725.9,0
2036-03-25,13:20:00,Subway,-44.01,Orlando FL,32816,7681.89,0
2036-03-29,09:38:00,McDonald's,-62.6,Orlando FL,32816,7619.29,0
2036-04-01,09:00:00,Rent,-960.0,Oviedo FL,32765,6659.29,0
2036-04-01,09:00:00,Insurance,-197.46,Oviedo FL,32765,6461.83,0
2036-04-01,09:00:00,Car,-300.0,Oviedo FL,32765,6161.83,0
2036-04-01,15:35:00,Pep Boys,-91.53,Orlando FL,32816,6070.3,0
2036-04-01,16:45:00,Amusement Park,-95.7,Winter Park FL,32789,5974.6,0
2036-04-01,20:14:00,Target,-129.18,Orlando FL,32816,5845.42,0
2036-04-03,05:47:00,Magic the Gathering,-2774.94,Honolulu HI,37737,3070.48,1
2036-04-03,14:05:00,Dollar Tree,-18.03,Oviedo FL,32765,5827.39,0
2036-04-06,15:19:00,Subway,-7.76,Orlando FL,32816,5819.63,0
2036-04-06,03:27:00,Lockheed Martin,-663.72,Charleston SC,65529,5155.91,1
2036-04-06,16:47:00,McDonald's,-16.61,Oviedo FL,32765,5803.02,0
2036-04-06,20:30:00,Onlyfans,-1492.09,New York NY,37901,4310.93,1
2036-04-07,08:00:00,Paycheck,2000.0,Oviedo FL,32765,7803.02,0
2036-04-07,09:00:00,Spotify,-11.99,Oviedo FL,32765,7791.03,0
2036-04-07,09:00:00,Internet,-70.89,Oviedo FL,32765,7720.14,0
2036-04-07,09:00:00,ChatGPT Plus,-20.0,Oviedo FL,32765,7700.14,0
2036-04-07,11:13:00,Subway,-54.85,Winter Park FL,32789,7645.29,0
2036-04-07,15:42:00,Best Buy,-235.83,Winter Park FL,32789,7409.46,0
2036-04-07,19:24:00,Starbucks,-23.65,Winter Park FL,32789,7385.81,0
2036-04-08,11:08:00,Subway,-15.13,Oviedo FL,32765,7370.68,0
2036-04-08,13:50:00,McDonald's,-39.5,Winter Park FL,32789,7331.18,0
2036-04-08,09:57:00,Kroger,-121.97,Winter Park FL,32789,7209.21,0
2036-04-08,13:08:00,Onlyfans,-2134.12,New York NY,93050,5075.09,1
2036-04-10,16:13:00,AutoZone,-92.56,Orlando FL,32816,7116.65,0
2036-04-11,21:51:00,Subway,-59.06,Oviedo FL,32765,7057.59,0
2036-04-12,17:26:00,Starbucks,-74.16,Winter Park FL,32789,6983.43,0
2036-04-12,09:40:00,Jiffy Lube,-132.65,Winter Park FL,32789,6850.78,0
2036-04-12,10:33:00,Starbucks,-51.21,Orlando FL,32816,6799.57,0
2036-04-14,09:30:00,Amazon,-164.52,Orlando FL,32816,6635.05,0
2036-04-14,15:19:00,Jiffy Lube,-115.32,Oviedo FL,32765,6519.73,0
2036-04-15,17:03:00,Subway,-66.79,Oviedo FL,32765,6452.94,0
2036-04-15,20:24:00,Five Below,-96.85,Orlando FL,32816,6356.09,0
2036-04-17,18:00:00,McDonald's,-34.21,Orlando FL,32816,6321.88,0
2036-04-17,17:52:00,McDonald's,-68.12,Winter Park FL,32789,6253.76,0
2036-04-18,11:26:00,Best Buy,-123.11,Winter Park FL,32789,6130.65,0
2036-04-18,21:00:00,Burger King,-43.73,Orlando FL,32816,6086.92,0
2036-04-20,21:41:00,Dollar Tree,-46.94,Oviedo FL,32765,6039.98,0
2036-04-20,15:42:00,Walgreens,-52.92,Orlando FL,32816,5987.06,0
2036-04-21,08:00:00,Paycheck,2000.0,Oviedo FL,32765,7987.06,0
2036-04-21,14:49:00,Shell,-42.33,Oviedo FL,32765,7944.73,0
2036-04-21,20:32:00,Kroger,-185.23,Orlando FL,32816,7759.5,0
2036-04-23,12:55:00,Starbucks,-77.29,Orlando FL,32816,7682.21,0
2036-04-23,16:26:00,Magic the Gathering,-1564.04,Pittsburgh PA,69820,6118.17,1
2036-04-24,19:22:00,McDonald's,-74.44,Oviedo FL,32765,7607.77,0
2036-04-25,14:03:00,Chevron,-26.4,Winter Park FL,32789,7581.37,0
2036-04-25,08:07:00,BP,-44.22,Orlando FL,32816,7537.15,0
2036-04-25,00:55:00,Monster Energy,-1949.53,Anchorage AL,19499,5587.62,1
2036-04-26,03:42:00,Paypal,-945.45,Honolulu HI,18952,6591.7,1
2036-04-26,12:59:00,McDonald's,-25.75,Oviedo FL,32765,7511.4,0
2036-04-26,02:37:00,Fraud,-2023.86,Groton CT,25175,5487.54,1
2036-04-26,09:48:00,Walmart,-153.84,Orlando FL,32816,7357.56,0
2036-04-26,21:05:00,Exxon,-24.47,Orlando FL,32816,7333.09,0
2036-04-27,06:48:00,Servicenow,-544.79,Honolulu HI,26600,6788.3,1
2036-04-29,15:07:00,Chevron,-20.12,Oviedo FL,32765,7312.97,0
2036-04-30,14:18:00,McDonald's,-27.5,Winter Park FL,32789,7285.47,0
2036-04-30,15:07:00,Lockheed Martin,-250.58,Charleston SC,18170,7034.89,1
2036-04-30,18:23:00,BP,-52.72,Orlando FL,32816,7232.75,0
2036-04-30,15:21:00,Five Below,-39.3,Winter Park FL,32789,7193.45,0
2036-04-30,08:32:00,Servicenow,-1223.26,London EN,46117,5970.19,1
2036-05-01,09:00:00,Rent,-960.0,Oviedo FL,32765,6233.45,0
2036-05-01,09:00:00,Insurance,-197.46,Oviedo FL,32765,6035.99,0
2036-05-01,09:00:00,Car,-300.0,Oviedo FL,32765,5735.99,0
2036-05-03,20:05:00,Walmart,-54.45,Oviedo FL,32765,5681.54,0
2036-05-03,17:29:00,Target,-43.16,Orlando FL,32816,5638.38,0
2036-05-03,11:56:00,Best Buy,-120.2,Winter Park FL,32789,5518.18,0
2036-05-03,04:26:00,Onlyfans,-634.94,London EN,35412,4883.24,1
2036-05-04,12:44:00,Walgreens,-24.67,Orlando FL,32816,5493.51,0
2036-05-04,08:03:00,Kroger,-92.61,Orlando FL,32816,5400.9,0
2036-05-05,08:00:00,Paycheck,2000.0,Oviedo FL,32765,7400.9,0
2036-05-05,16:18:00,Dollar Tree,-79.89,Oviedo FL,32765,7321.01,0
2036-05-06,12:47:00,Best Buy,-70.72,Orlando FL,32816,7250.29,0
2036-05-06,12:08:00,Kroger,-114.39,Oviedo FL,32765,7135.9,0
2036-05-06,01:27:00,Onlyfans,-2593.21,Pittsburgh PA,74636,4542.69,1
2036-05-07,09:00:00,Spotify,-11.99,Oviedo FL,32765,7123.91,0
2036-05-07,09:00:00,Internet,-70.89,Oviedo FL,32765,7053.02,0
2036-05-07,09:00:00,ChatGPT Plus,-20.0,Oviedo FL,32765,7033.02,0
2036-05-07,10:56:00,CVS,-97.02,Oviedo FL,32765,6936.0,0
2036-05-07,14:51:00,Starbucks,-48.53,Winter Park FL,32789,6887.47,0
2036-05-07,08:21:00,Starbucks,-59.55,Orlando FL,32816,6827.92,0
2036-05-08,16:59:00,Pep Boys,-192.02,Winter Park FL,32789,6635.9,0
2036-05-09,18:53:00,Jiffy Lube,-293.86,Orlando FL,32816,6342.04,0
2036-05-09,21:28:00,McDonald's,-43.87,Winter Park FL,32789,6298.17,0
2036-05-11,11:59:00,IBM,-897.02,Tokyo JP,80156,5401.15,1
2036-05-11,11:08:00,Dollar Tree,-64.37,Oviedo FL,32765,6233.8,0
2036-05-11,08:18:00,Burger King,-48.37,Oviedo FL,32765,6185.43,0
2036-05-11,16:02:00,Trader Joe's,-91.08,Orlando FL,32816,6094.35,0
2036-05-13,12:24:00,Starbucks,-58.58,Orlando FL,32816,6035.77,0
2036-05-13,18:16:00,Fraud,-2741.58,Tokyo JP,24620,3294.19,1
2036-05-14,20:42:00,CVS,-78.02,Orlando FL,32816,5957.75,0
2036-05-15,18:50:00,Subway,-5.94,Winter Park FL,32789,5951.81,0
2036-05-16,12:56:00,Impractical Jokers,-1415.17,Pittsburgh PA,85366,4536.64,1
2036-05-16,17:06:00,Amusement Park,-42.18,Oviedo FL,32765,5909.63,0
2036-05-16,21:27:00,Netflix,-56.86,Oviedo FL,32765,5852.77,0
2036-05-17,10:04:00,Burger King,-39.56,Winter Park FL,32789,5813.21,0
2036-05-18,15:38:00,Subway,-14.17,Oviedo FL,32765,5799.04,0
2036-05-19,08:00:00,Paycheck,2000.0,Oviedo FL,32765,7799.04,0
2036-05-19,11:36:00,Publix,-137.49,Oviedo FL,32765,7661.55,0
2036-05-19,17:54:00,Starbucks,-13.22,Winter Park FL,32789,7648.33,0
2036-05-20,21:53:00,Starbucks,-56.09,Oviedo FL,32765,7592.24,0
2036-05-20,15:01:00,BP,-29.49,Winter Park FL,32789,7562.75,0
2036-05-22,21:20:00,Amazon,-194.3,Orlando FL,32816,7368.45,0
2036-05-22,11:41:00,Subway,-39.54,Orlando FL,32816,7328.91,0
2036-05-23,21:18:00,Whole Foods,-70.98,Orlando FL,32816,7257.93,0
2036-05-23,13:43:00,Impractical Jokers,-1861.19,London EN,96977,5396.74,1
2036-05-23,16:11:00,Best Buy,-265.26,Orlando FL,32816,6992.67,0
2036-05-25,19:33:00,Magic the Gathering,-1973.92,Tokyo JP,49847,5018.75,1
2036-05-25,11:42:00,McDonald's,-40.5,Oviedo FL,32765,6952.17,0
2036-05-26,10:28:00,Publix,-195.32,Orlando FL,32816,6756.85,0
2036-05-26,19:59:00,Subway,-35.69,Orlando FL,32816,6721.16,0
2036-05-26,08:52:00,Burger King,-12.04,Orlando FL,32816,6709.12,0
2036-05-27,23:55:00,Servicenow,-430.49,Groton CT,57622,6278.63,1
2036-05-27,21:18:00,BP,-23.1,Orlando FL,32816,6686.02,0
2036-05-27,13:51:00,Starbucks,-46.13,Oviedo FL,32765,6639.89,0
2036-05-27,06:02:00,Fat Joe,-1001.44,Pittsburgh PA,81891,5638.45,1
2036-05-27,10:53:00,Best Buy,-76.8,Orlando FL,32816,6563.09,0
2036-05-29,08:32:00,Walmart,-57.42,Oviedo FL,32765,6505.67,0
2036-05-30,12:08:00,Whole Foods,-125.84,Winter Park FL,32789,6379.83,0
2036-05-30,14:05:00,Whole Foods,-102.28,Winter Park FL,32789,6277.55,0
2036-05-31,11:53:00,McDonald's,-61.16,Orlando FL,32816,6216.39,0
2036-05-31,13:09:00,Best Buy,-224.28,Winter Park FL,32789,5992.11,0
2036-06-01,09:00:00,Rent,-960.0,Oviedo FL,32765,5032.11,0
2036-06-01,09:00:00,Insurance,-197.46,Oviedo FL,32765,4834.65,0
2036-06-01,09:00:00,Car,-300.0,Oviedo FL,32765,4534.65,0
2036-06-01,16:42:00,Burger King,-27.23,Winter Park FL,32789,4507.42,0
2036-06-01,17:32:00,Best Buy,-138.42,Winter Park FL,32789,4369.0,0
2036-06-02,08:00:00,Paycheck,2000.0,Oviedo FL,32765,6369.0,0
2036-06-02,11:30:00,Walgreens,-80.54,Winter Park FL,32789,6288.46,0
2036-06-02,14:59:00,Exxon,-50.46,Oviedo FL,32765,6238.0,0
2036-06-02,16:51:00,McDonald's,-14.12,Orlando FL,32816,6223.88,0
2036-06-03,18:47:00,Walgreens,-34.23,Winter Park FL,32789,6189.65,0
2036-06-03,11:10:00,Burger King,-26.7,Orlando FL,32816,6162.95,0
2036-06-04,20:27:00,Best Buy,-158.6,Oviedo FL,32765,6004.35,0
2036-06-04,13:14:00,Kroger,-95.88,Orlando FL,32816,5908.47,0
2036-06-05,12:22:00,Netflix,-50.74,Oviedo FL,32765,5857.73,0
2036-06-06,14:04:00,Monster Energy,-1849.84,Pittsburgh PA,99529,4007.89,1
2036-06-07,09:00:00,Spotify,-11.99,Oviedo FL,32765,5845.74,0
2036-06-07,09:00:00,Internet,-70.89,Oviedo FL,32765,5774.85,0
2036-06-07,09:00:00,ChatGPT Plus,-20.0,Oviedo FL,32765,5754.85,0
2036-06-07,15:33:00,Best Buy,-89.18,Winter Park FL,32789,5665.67,0
2036-06-09,08:24:00,BP,-13.29,Oviedo FL,32765,5652.38,0
2036-06-09,19:53:00,Servicenow,-1674.92,Groton CT,78775,3977.46,1
2036-06-10,16:46:00,Exxon,-27.46,Oviedo FL,32765,5624.92,0
2036-06-10,02:03:00,Fat Joe,-876.39,Anchorage AL,88386,4748.53,1
2036-06-10,15:24:00,Netflix,-52.71,Winter Park FL,32789,5572.21,0
2036-06-10,18:24:00,Publix,-78.45,Oviedo FL,32765,5493.76,0
2036-06-11,07:58:00,Servicenow,-378.26,Tokyo JP,29713,5115.5,1
2036-06-11,12:19:00,Subway,-20.44,Orlando FL,32816,5473.32,0
2036-06-11,01:06:00,Paypal,-745.24,Los Angeles CA,17094,4728.08,1
2036-06-13,18:53:00,Exxon,-29.83,Winter Park FL,32789,5443.49,0
2036-06-13,13:29:00,Movie Theater,-30.22,Oviedo FL,32765,5413.27,0
2036-06-13,16:15:00,Five Below,-5.72,Winter Park FL,32789,5407.55,0
2036-06-15,10:45:00,McDonald's,-18.99,Winter Park FL,32789,5388.56,0
2036-06-15,11:08:00,Dollar Tree,-49.96,Winter Park FL,32789,5338.6,0
2036-06-15,10:43:00,Burger King,-14.35,Orlando FL,32816,5324.25,0
2036-06-15,18:16:00,Fraud,-1028.3,Pittsburgh PA,84716,4295.95,1
2036-06-16,08:00:00,Paycheck,2000.0,Oviedo FL,32765,7324.25,0
2036-06-16,19:18:00,Amusement Park,-20.44,Winter Park FL,32789,7303.81,0
2036-06-17,14:13:00,Lockheed Martin,-1803.09,Charleston SC,96581,5500.72,1
2036-06-17,16:29:00,Walgreens,-66.63,Orlando FL,32816,7237.18,0
2036-06-17,14:52:00,Target,-122.22,Oviedo FL,32765,7114.96,0
2036-06-18,17:19:00,Subway,-59.43,Winter Park FL,32789,7055.53,0
2036-06-18,15:58:00,CVS,-53.69,Orlando FL,32816,7001.84,0
2036-06-22,13:13:00,Kroger,-139.08,Oviedo FL,32765,6862.76,0
2036-06-23,16:49:00,Shell,-43.14,Orlando FL,32816,6819.62,0
2036-06-23,12:09:00,McDonald's,-77.88,Orlando FL,32816,6741.74,0
2036-06-23,10:53:00,Kroger,-106.43,Oviedo FL,32765,6635.31,0
2036-06-24,09:32:00,Concert Tickets,-113.02,Orlando FL,32816,6522.29,0
2036-06-24,17:39:00,Movie Theater,-72.33,Winter Park FL,32789,6449.96,0
2036-06-25,19:03:00,Starbucks,-30.87,Orlando FL,32816,6419.09,0
2036-06-26,20:39:00,Concert Tickets,-108.12,Oviedo FL,32765,6310.97,0
2036-06-26,17:25:00,Five Below,-86.2,Orlando FL,32816,6224.77,0
2036-06-27,18:33:00,Walgreens,-43.67,Oviedo FL,32765,6181.1,0
2036-06-28,14:55:00,Dollar Tree,-25.36,Oviedo FL,32765,6155.74,0
2036-06-28,20:59:00,Midas,-376.84,Winter Park FL,32789,5778.9,0
2036-06-29,22:15:00,Fat Joe,-2634.33,Pyongyang NK,96892,3144.57,1
2036-06-29,19:30:00,Netflix,-47.7,Winter Park FL,32789,5731.2,0
2036-06-30,08:00:00,Paycheck,2000.0,Oviedo FL,32765,7731.2,0
2036-06-30,08:58:00,Five Below,-78.94,Oviedo FL,32765,7652.26,0
2036-07-01,09:00:00,Rent,-960.0,Oviedo FL,32765,6692.26,0
2036-07-01,09:00:00,Insurance,-197.46,Oviedo FL,32765,6494.8,0
2036-07-01,09:00:00,Car,-300.0,Oviedo FL,32765,6194.8,0
2036-07-01,21:53:00,Best Buy,-167.39,Winter Park FL,32789,6027.41,0
2036-07-01,11:59:00,Five Below,-33.13,Oviedo FL,32765,5994.28,0
2036-07-01,15:34:00,Chevron,-22.45,Oviedo FL,32765,5971.83,0
2036-07-02,12:28:00,Publix,-91.45,Winter Park FL,32789,5880.38,0
2036-07-04,09:52:00,Pawn Stars,-516.59,Anchorage AL,14313,5363.79,1
2036-07-04,17:04:00,Whole Foods,-84.63,Winter Park FL,32789,5795.75,0
2036-07-05,10:24:00,McDonald's,-26.19,Oviedo FL,32765,5769.56,0
2036-07-05,20:39:00,Subway,-18.67,Orlando FL,32816,5750.89,0
2036-07-06,12:29:00,Starbucks,-31.82,Winter Park FL,32789,5719.07,0
2036-07-07,09:00:00,Spotify,-11.99,Oviedo FL,32765,5707.08,0
2036-07-07,09:00:00,Internet,-70.89,Oviedo FL,32765,5636.19,0
2036-07-07,09:00:00,ChatGPT Plus,-20.0,Oviedo FL,32765,5616.19,0
2036-07-07,13:04:00,McDonald's,-12.15,Winter Park FL,32789,5604.04,0
2036-07-08,13:57:00,Pep Boys,-63.58,Orlando FL,32816,5540.46,0
2036-07-09,17:34:00,Starbucks,-21.84,Orlando FL,32816,5518.62,0
2036-07-11,19:25:00,Burger King,-21.3,Orlando FL,32816,5497.32,0
2036-07-11,15:28:00,Dollar Tree,-34.25,Oviedo FL,32765,5463.07,0
2036-07-11,13:53:00,Shell,-17.04,Oviedo FL,32765,5446.03,0
2036-07-14,08:00:00,Paycheck,2000.0,Oviedo FL,32765,7446.03,0
2036-07-15,18:06:00,Dollar Tree,-53.84,Oviedo FL,32765,7392.19,0
2036-07-16,18:40:00,Accelerators,-1518.59,Los Angeles CA,12074,5873.6,1
2036-07-16,12:34:00,BP,-25.42,Orlando FL,32816,7366.77,0
2036-07-17,17:39:00,McDonald's,-41.98,Orlando FL,32816,7324.79,0
2036-07-18,10:52:00,Walmart,-219.82,Oviedo FL,32765,7104.97,0
2036-07-18,08:29:00,Trader Joe's,-175.51,Orlando FL,32816,6929.46,0
2036-07-19,17:51:00,Amusement Park,-92.5,Winter Park FL,32789,6836.96,0
2036-07-19,11:35:00,Onlyfans,-1933.87,Tokyo JP,95934,4903.09,1
2036-07-19,12:10:00,Exxon,-21.86,Winter Park FL,32789,6815.1,0
2036-07-19,12:08:00,Accelerators,-2141.42,New York NY,89762,4673.68,1
2036-07-19,20:28:00,Starbucks,-72.14,Orlando FL,32816,6742.96,0
2036-07-19,07:35:00,Pawn Stars,-878.1,Anchorage AL,98241,5864.86,1
2036-07-21,21:56:00,Shell,-33.82,Oviedo FL,32765,6709.14,0
2036-07-21,16:18:00,Starbucks,-44.58,Orlando FL,32816,6664.56,0
2036-07-21,11:18:00,Burger King,-28.03,Orlando FL,32816,6636.53,0
2036-07-22,18:58:00,Amazon,-83.21,Orlando FL,32816,6553.32,0
2036-07-24,11:37:00,Movie Theater,-30.96,Orlando FL,32816,6522.36,0
2036-07-24,15:01:00,Target,-215.67,Orlando FL,32816,6306.69,0
2036-07-26,20:37:00,McDonald's,-63.74,Winter Park FL,32789,6242.95,0
2036-07-27,19:03:00,Starbucks,-74.22,Orlando FL,32816,6168.73,0
2036-07-28,08:00:00,Paycheck,2000.0,Oviedo FL,32765,8168.73,0
2036-07-28,13:53:00,Netflix,-43.61,Oviedo FL,32765,8125.12,0
2036-07-28,21:38:00,McDonald's,-56.44,Orlando FL,32816,8068.68,0
2036-07-28,16:24:00,Fraud,-629.86,Charleston SC,65496,7438.82,1
2036-08-01,09:00:00,Rent,-960.0,Oviedo FL,32765,7108.68,0
2036-08-01,09:00:00,Insurance,-197.46,Oviedo FL,32765,6911.22,0
2036-08-01,09:00:00,Car,-300.0,Oviedo FL,32765,6611.22,0
2036-08-01,12:16:00,Amusement Park,-56.62,Orlando FL,32816,6554.6,0
2036-08-01,08:42:00,Starbucks,-10.64,Orlando FL,32816,6543.96,0
2036-08-01,16:21:00,Walmart,-282.85,Winter Park FL,32789,6261.11,0
2036-08-02,16:47:00,Walmart,-174.49,Oviedo FL,32765,6086.62,0
2036-08-02,13:51:00,Target,-48.57,Oviedo FL,32765,6038.05,0
2036-08-02,16:27:00,Burger King,-37.34,Oviedo FL,32765,6000.71,0
2036-08-02,22:12:00,Magic the Gathering,-2100.83,Anchorage AL,92328,3899.88,1
2036-08-03,11:07:00,McDonald's,-18.33,Winter Park FL,32789,5982.38,0
2036-08-03,21:45:00,Midas,-105.12,Orlando FL,32816,5877.26,0
2036-08-03,13:24:00,Onlyfans,-1017.29,Honolulu HI,68194,4859.97,1
2036-08-03,21:13:00,Walgreens,-41.13,Oviedo FL,32765,5836.13,0
2036-08-03,03:34:00,Paypal,-603.35,Groton CT,71208,5232.78,1
2036-08-05,17:00:00,Midas,-133.65,Winter Park FL,32789,5702.48,0
2036-08-05,18:04:00,Subway,-15.89,Oviedo FL,32765,5686.59,0
2036-08-06,19:14:00,Amusement Park,-11.31,Orlando FL,32816,5675.28,0
2036-08-07,09:00:00,Spotify,-11.99,Oviedo FL,32765,5663.29,0
2036-08-07,09:00:00,Internet,-70.89,Oviedo FL,32765,5592.4,0
2036-08-07,09:00:00,ChatGPT Plus,-20.0,Oviedo FL,32765,5572.4,0
2036-08-08,19:27:00,Pep Boys,-146.58,Oviedo FL,32765,5425.82,0
2036-08-08,09:19:00,Target,-120.09,Oviedo FL,32765,5305.73,0
2036-08-08,19:56:00,Chevron,-24.47,Orlando FL,32816,5281.26,0
2036-08-09,09:37:00,Onlyfans,-328.94,New York NY,52689,4952.32,1
2036-08-09,15:02:00,Subway,-30.04,Orlando FL,32816,5251.22,0
2036-08-09,10:50:00,Subway,-21.26,Winter Park FL,32789,5229.96,0
2036-08-10,09:33:00,Subway,-35.51,Orlando FL,32816,5194.45,0
2036-08-10,14:11:00,Amusement Park,-34.37,Winter Park FL,32789,5160.08,0
2036-08-10,13:27:00,Netflix,-10.17,Winter Park FL,32789,5149.91,0
2036-08-11,08:00:00,Paycheck,2000.0,Oviedo FL,32765,7149.91,0
2036-08-11,17:30:00,Exxon,-52.01,Winter Park FL,32789,7097.9,0
2036-08-11,18:20:00,Publix,-63.03,Orlando FL,32816,7034.87,0
2036-08-12,10:59:00,Accelerators,-2848.14,Pyongyang NK,46924,4186.73,1
2036-08-12,08:01:00,Exxon,-57.36,Winter Park FL,32789,6977.51,0
2036-08-13,08:25:00,Starbucks,-49.44,Winter Park FL,32789,6928.07,0
2036-08-14,10:37:00,McDonald's,-29.47,Winter Park FL,32789,6898.6,0
2036-08-14,11:08:00,Best Buy,-60.41,Oviedo FL,32765,6838.19,0
2036-08-14,13:05:00,Burger King,-61.83,Oviedo FL,32765,6776.36,0
2036-08-15,14:07:00,Burger King,-16.27,Winter Park FL,32789,6760.09,0
2036-08-15,13:44:00,McDonald's,-44.91,Orlando FL,32816,6715.18,0
2036-08-15,15:30:00,Target,-196.8,Orlando FL,32816,6518.38,0
2036-08-17,14:46:00,Best Buy,-268.41,Oviedo FL,32765,6249.97,0
2036-08-18,21:40:00,Publix,-172.84,Orlando FL,32816,6077.13,0
2036-08-18,20:21:00,Burger King,-32.05,Orlando FL,32816,6045.08,0
2036-08-18,20:12:00,Starbucks,-64.74,Oviedo FL,32765,5980.34,0
2036-08-19,20:19:00,Amazon,-118.74,Orlando FL,32816,5861.6,0
2036-08-19,14:22:00,Walmart,-60.96,Orlando FL,32816,5800.64,0
2036-08-19,19:28:00,Target,-99.82,Winter Park FL,32789,5700.82,0
2036-08-20,21:32:00,Magic the Gathering,-1398.71,Honolulu HI,55443,4302.11,1
2036-08-20,16:57:00,Amazon,-10.24,Orlando FL,32816,5690.58,0
2036-08-20,08:57:00,Amusement Park,-19.29,Winter Park FL,32789,5671.29,0
2036-08-21,19:55:00,Whole Foods,-97.95,Winter Park FL,32789,5573.34,0
2036-08-21,10:03:00,Amazon,-114.61,Orlando FL,32816,5458.73,0
2036-08-21,10:20:00,Walmart,-72.24,Oviedo FL,32765,5386.49,0
2036-08-22,10:37:00,Walgreens,-20.1,Winter Park FL,32789,5366.39,0
2036-08-22,21:35:00,McDonald's,-25.78,Oviedo FL,32765,5340.61,0
2036-08-24,13:47:00,IBM,-2458.83,Los Angeles CA,49569,2881.78,1
2036-08-24,19:29:00,Burger King,-10.23,Orlando FL,32816,5330.38,0
2036-08-25,08:00:00,Paycheck,2000.0,Oviedo FL,32765,7330.38,0
2036-08-26,11:51:00,McDonald's,-58.13,Oviedo FL,32765,7272.25,0
2036-08-26,14:53:00,Amusement Park,-61.28,Orlando FL,32816,7210.97,0
2036-08-26,01:19:00,Paypal,-437.2,Charleston SC,34410,6773.77,1
2036-08-27,13:43:00,Shell,-43.53,Oviedo FL,32765,7167.44,0
2036-08-28,02:18:00,Fat Joe,-2069.89,Mexico City MC,26886,5097.55,1
2036-08-28,10:29:00,Subway,-30.49,Winter Park FL,32789,7136.95,0
2036-08-29,08:42:00,Fraud,-565.68,London EN,32485,6571.27,1
2036-08-29,09:44:00,Amazon,-226.96,Oviedo FL,32765,6909.99,0
2036-08-30,20:01:00,Dollar Tree,-17.63,Winter Park FL,32789,6892.36,0
2036-08-31,16:32:00,CVS,-92.01,Orlando FL,32816,6800.35,0
2036-08-31,08:17:00,Impractical Jokers,-2777.5,Groton CT,81145,4022.85,1
2036-08-31,13:16:00,Movie Theater,-30.08,Winter Park FL,32789,6770.27,0
2036-09-01,09:00:00,Rent,-960.0,Oviedo FL,32765,5810.27,0
2036-09-01,09:00:00,Insurance,-197.46,Oviedo FL,32765,5612.81,0
2036-09-01,09:00:00,Car,-300.0,Oviedo FL,32765,5312.81,0
2036-09-01,19:02:00,Best Buy,-66.46,Orlando FL,32816,5246.35,0
2036-09-01,15:44:00,Amusement Park,-19.52,Winter Park FL,32789,5226.83,0
2036-09-01,17:34:00,Chevron,-16.24,Orlando FL,32816,5210.59,0
2036-09-02,14:31:00,Walgreens,-35.91,Orlando FL,32816,5174.68,0
2036-09-02,12:10:00,Dollar Tree,-28.34,Winter Park FL,32789,5146.34,0
2036-09-04,09:42:00,Jiffy Lube,-129.97,Winter Park FL,32789,5016.37,0
2036-09-04,20:54:00,Burger King,-10.09,Winter Park FL,32789,5006.28,0
2036-09-05,16:49:00,Best Buy,-62.22,Winter Park FL,32789,4944.06,0
2036-09-05,13:55:00,Five Below,-45.81,Oviedo FL,32765,4898.25,0
2036-09-05,11:22:00,Burger King,-18.88,Winter Park FL,32789,4879.37,0
2036-09-07,09:00:00,Spotify,-11.99,Oviedo FL,32765,4867.38,0
2036-09-07,09:00:00,Internet,-70.89,Oviedo FL,32765,4796.49,0
2036-09-07,09:00:00,ChatGPT Plus,-20.0,Oviedo FL,32765,4776.49,0
2036-09-07,09:27:00,McDonald's,-12.04,Oviedo FL,32765,4764.45,0
2036-09-08,08:00:00,Paycheck,2000.0,Oviedo FL,32765,6764.45,0
2036-09-09,15:47:00,CVS,-75.68,Oviedo FL,32765,6688.77,0
2036-09-09,22:04:00,Impractical Jokers,-2501.31,London EN,22699,4187.46,1
2036-09-10,16:28:00,Chevron,-32.14,Winter Park FL,32789,6656.63,0
2036-09-10,16:15:00,Best Buy,-247.18,Oviedo FL,32765,6409.45,0
2036-09-10,19:16:00,Accelerators,-1543.51,Los Angeles CA,68867,4865.94,1
2036-09-11,17:35:00,Chevron,-43.83,Oviedo FL,32765,6365.62,0
2036-09-12,11:07:00,Onlyfans,-1080.61,Los Angeles CA,28303,5285.01,1
2036-09-12,17:44:00,McDonald's,-78.14,Orlando FL,32816,6287.48,0
2036-09-12,19:00:00,Subway,-25.91,Winter Park FL,32789,6261.57,0
2036-09-13,11:44:00,Amusement Park,-99.82,Orlando FL,32816,6161.75,0
2036-09-14,03:50:00,Fraud,-988.68,Los Angeles CA,38306,5173.07,1
2036-09-14,08:21:00,Walgreens,-60.61,Oviedo FL,32765,6101.14,0
2036-09-14,11:39:00,Burger King,-64.86,Oviedo FL,32765,6036.28,0
2036-09-16,13:39:00,Amazon,-218.79,Orlando FL,32816,5817.49,0
2036-09-16,10:07:00,IBM,-1290.56,Anchorage AL,95314,4526.93,1
2036-09-17,22:20:00,Fat Joe,-2888.49,Anchorage AL,83149,2929.0,1
2036-09-17,09:23:00,Publix,-94.36,Oviedo FL,32765,5723.13,0
2036-09-17,11:39:00,Concert Tickets,-49.79,Orlando FL,32816,5673.34,0
2036-09-18,18:07:00,Kroger,-38.37,Orlando FL,32816,5634.97,0
2036-09-19,15:43:00,Midas,-113.54,Winter Park FL,32789,5521.43,0
2036-09-19,13:55:00,Concert Tickets,-23.27,Winter Park FL,32789,5498.16,0
2036-09-19,15:02:00,Walgreens,-43.2,Winter Park FL,32789,5454.96,0
2036-09-20,09:48:00,Subway,-22.29,Winter Park FL,32789,5432.67,0
2036-09-20,14:24:00,Movie Theater,-36.97,Orlando FL,32816,5395.7,0
2036-09-22,08:00:00,Paycheck,2000.0,Oviedo FL,32765,7395.7,0
2036-09-22,14:21:00,Whole Foods,-69.76,Winter Park FL,32789,7325.94,0
2036-09-22,09:33:00,Burger King,-30.1,Orlando FL,32816,7295.84,0
2036-09-22,02:59:00,IBM,-2720.96,Anchorage AL,41597,4574.88,1
2036-09-23,11:12:00,Movie Theater,-26.14,Orlando FL,32816,7269.7,0
2036-09-23,14:37:00,Burger King,-57.95,Oviedo FL,32765,7211.75,0
2036-09-24,16:20:00,Burger King,-63.84,Orlando FL,32816,7147.91,0
2036-09-24,18:42:00,Starbucks,-18.2,Orlando FL,32816,7129.71,0
2036-09-25,18:03:00,Paypal,-1284.73,Groton CT,42158,5844.98,1
2036-09-25,21:18:00,Movie Theater,-55.99,Winter Park FL,32789,7073.72,0
2036-09-25,20:21:00,BP,-44.95,Winter Park FL,32789,7028.77,0
2036-09-25,14:48:00,BP,-21.23,Winter Park FL,32789,7007.54,0
2036-09-26,12:44:00,Walmart,-231.46,Winter Park FL,32789,6776.08,0
2036-09-26,18:45:00,Chevron,-25.89,Oviedo FL,32765,6750.19,0
2036-09-26,08:37:00,Amazon,-221.78,Oviedo FL,32765,6528.41,0
2036-09-27,18:02:00,Target,-267.78,Orlando FL,32816,6260.63,0
2036-09-28,13:17:00,Pep Boys,-173.88,Orlando FL,32816,6086.75,0
2036-09-28,12:02:00,Shell,-55.69,Winter Park FL,32789,6031.06,0
2036-09-29,05:12:00,Fat Joe,-1569.63,Pittsburgh PA,65359,4461.43,1
2036-09-29,13:55:00,Burger King,-77.7,Orlando FL,32816,5953.36,0
2036-09-30,11:23:00,Amazon,-136.2,Orlando FL,32816,5817.16,0
2036-09-30,13:42:00,Trader Joe's,-76.93,Winter Park FL,32789,5740.23,0
2036-10-01,09:00:00,Rent,-960.0,Oviedo FL,32765,4780.23,0
2036-10-01,09:00:00,Insurance,-197.46,Oviedo FL,32765,4582.77,0
2036-10-01,09:00:00,Car,-300.0,Oviedo FL,32765,4282.77,0
2036-10-03,18:01:00,Jiffy Lube,-49.43,Oviedo FL,32765,4233.34,0
2036-10-03,20:04:00,McDonald's,-27.32,Oviedo FL,32765,4206.02,0
2036-10-04,10:15:00,Kroger,-59.4,Oviedo FL,32765,4146.62,0
2036-10-06,08:00:00,Paycheck,2000.0,Oviedo FL,32765,6146.62,0
2036-10-06,15:22:00,Starbucks,-50.05,Winter Park FL,32789,6096.57,0
2036-10-07,09:00:00,Spotify,-11.99,Oviedo FL,32765,6084.58,0
2036-10-07,09:00:00,Internet,-70.89,Oviedo FL,32765,6013.69,0
2036-10-07,09:00:00,ChatGPT Plus,-20.0,Oviedo FL,32765,5993.69,0
2036-10-07,15:49:00,Whole Foods,-65.99,Winter Park FL,32789,5927.7,0
2036-10-07,20:07:00,Walgreens,-10.96,Winter Park FL,32789,5916.74,0
2036-10-09,08:51:00,McDonald's,-24.72,Orlando FL,32816,5892.02,0
2036-10-09,21:30:00,BP,-18.06,Oviedo FL,32765,5873.96,0
2036-10-10,11:40:00,McDonald's,-8.31,Winter Park FL,32789,5865.65,0
2036-10-11,21:56:00,Dollar Tree,-29.37,Oviedo FL,32765,5836.28,0
2036-10-11,18:57:00,Chevron,-26.5,Winter Park FL,32789,5809.78,0
2036-10-11,21:23:00,Amazon,-106.03,Winter Park FL,32789,5703.75,0
2036-10-12,21:17:00,Subway,-17.53,Oviedo FL,32765,5686.22,0
2036-10-12,16:57:00,Concert Tickets,-34.89,Oviedo FL,32765,5651.33,0
2036-10-13,10:48:00,Burger King,-20.84,Oviedo FL,32765,5630.49,0
2036-10-13,14:06:00,Walgreens,-14.05,Oviedo FL,32765,5616.44,0
2036-10-13,11:20:00,Five Below,-10.54,Winter Park FL,32789,5605.9,0
2036-10-13,05:39:00,Pawn Stars,-2439.19,Pyongyang NK,83399,3166.71,1
2036-10-14,09:50:00,Shell,-19.52,Orlando FL,32816,5586.38,0
2036-10-14,10:07:00,Walmart,-124.76,Oviedo FL,32765,5461.62,0
2036-10-14,06:21:00,Accelerators,-736.21,New York NY,73956,4725.41,1
2036-10-14,20:43:00,McDonald's,-7.62,Winter Park FL,32789,5454.0,0
2036-10-14,02:45:00,Onlyfans,-1094.73,Mexico City MC,90331,4359.27,1
2036-10-15,20:58:00,Movie Theater,-54.89,Oviedo FL,32765,5399.11,0
2036-10-15,08:26:00,CVS,-28.61,Winter Park FL,32789,5370.5,0
2036-10-15,08:05:00,Five Below,-43.9,Winter Park FL,32789,5326.6,0
2036-10-16,08:33:00,McDonald's,-29.04,Oviedo FL,32765,5297.56,0
2036-10-16,15:29:00,Monster Energy,-2339.3,Mexico City MC,53742,2958.26,1
2036-10-16,21:13:00,Burger King,-28.49,Winter Park FL,32789,5269.07,0
2036-10-16,20:40:00,Chevron,-13.71,Oviedo FL,32765,5255.36,0
2036-10-17,17:52:00,Amazon,-118.41,Winter Park FL,32789,5136.95,0
2036-10-18,12:28:00,Subway,-22.83,Oviedo FL,32765,5114.12,0
2036-10-18,13:53:00,Onlyfans,-2844.22,Groton CT,12535,2269.9,1
2036-10-18,17:35:00,McDonald's,-30.69,Oviedo FL,32765,5083.43,0
2036-10-18,16:37:00,Burger King,-22.31,Orlando FL,32816,5061.12,0
2036-10-19,20:21:00,Walgreens,-8.46,Oviedo FL,32765,5052.66,0
2036-10-20,08:00:00,Paycheck,2000.0,Oviedo FL,32765,7052.66,0
2036-10-20,08:56:00,Starbucks,-19.24,Orlando FL,32816,7033.42,0
2036-10-20,13:07:00,Kroger,-173.96,Winter Park FL,32789,6859.46,0
2036-10-20,10:27:00,Trader Joe's,-64.68,Winter Park FL,32789,6794.78,0
2036-10-21,09:29:00,Trader Joe's,-166.58,Oviedo FL,32765,6628.2,0
2036-10-22,20:20:00,Walmart,-262.82,Oviedo FL,32765,6365.38,0
2036-10-23,08:29:00,Pawn Stars,-1089.76,Pyongyang NK,61000,5275.62,1
2036-10-23,14:15:00,Pep Boys,-227.51,Oviedo FL,32765,6137.87,0
2036-10-23,15:12:00,Starbucks,-47.43,Orlando FL,32816,6090.44,0
2036-10-24,19:41:00,BP,-58.64,Winter Park FL,32789,6031.8,0
2036-10-24,21:13:00,Best Buy,-229.99,Oviedo FL,32765,5801.81,0
2036-10-24,20:07:00,Burger King,-19.53,Oviedo FL,32765,5782.28,0
2036-10-25,17:09:00,Best Buy,-70.28,Orlando FL,32816,5712.0,0
2036-10-25,12:04:00,Best Buy,-132.66,Winter Park FL,32789,5579.34,0
2036-10-25,20:16:00,Amazon,-29.56,Oviedo FL,32765,5549.78,0
2036-10-27,17:44:00,Chevron,-28.87,Oviedo FL,32765,5520.91,0
2036-10-28,19:36:00,Subway,-38.69,Winter Park FL,32789,5482.22,0
2036-10-29,11:07:00,Five Below,-34.84,Winter Park FL,32789,5447.38,0
2036-10-29,14:36:00,Amazon,-86.77,Winter Park FL,32789,5360.61,0
2036-10-29,12:47:00,Magic the Gathering,-2297.15,Anchorage AL,11283,3063.46,1
2036-10-29,21:16:00,McDonald's,-28.93,Orlando FL,32816,5331.68,0
2036-10-30,17:52:00,Netflix,-50.27,Winter Park FL,32789,5281.41,0
2036-11-01,09:00:00,Rent,-960.0,Oviedo FL,32765,4321.41,0
2036-11-01,09:00:00,Insurance,-197.46,Oviedo FL,32765,4123.95,0
2036-11-01,09:00:00,Car,-300.0,Oviedo FL,32765,3823.95,0
2036-11-02,12:34:00,Starbucks,-14.75,Oviedo FL,32765,3809.2,0
2036-11-02,15:47:00,Publix,-91.76,Oviedo FL,32765,3717.44,0
2036-11-02,16:58:00,Best Buy,-12.25,Orlando FL,32816,3705.19,0
2036-11-03,08:00:00,Paycheck,2000.0,Oviedo FL,32765,5705.19,0
2036-11-03,20:28:00,McDonald's,-5.37,Oviedo FL,32765,5699.82,0
2036-11-03,10:44:00,Fat Joe,-1516.6,Pyongyang NK,19534,4183.22,1
2036-11-04,13:52:00,Starbucks,-29.98,Winter Park FL,32789,5669.84,0
2036-11-04,10:02:00,Subway,-19.93,Orlando FL,32816,5649.91,0
2036-11-05,11:37:00,Netflix,-40.64,Winter Park FL,32789,5609.27,0
2036-11-05,16:42:00,Chevron,-24.42,Winter Park FL,32789,5584.85,0
2036-11-05,17:12:00,Starbucks,-27.78,Orlando FL,32816,5557.07,0
2036-11-06,15:13:00,Best Buy,-126.68,Winter Park FL,32789,5430.39,0
2036-11-07,09:00:00,Spotify,-11.99,Oviedo FL,32765,5418.4,0
2036-11-07,09:00:00,Internet,-70.89,Oviedo FL,32765,5347.51,0
2036-11-07,09:00:00,ChatGPT Plus,-20.0,Oviedo FL,32765,5327.51,0
2036-11-07,11:28:00,Walmart,-65.54,Winter Park FL,32789,5261.97,0
2036-11-07,18:23:00,Jiffy Lube,-89.59,Winter Park FL,32789,5172.38,0
2036-11-08,12:11:00,Magic the Gathering,-1663.76,Mexico City MC,66570,3508.62,1
2036-11-08,17:25:00,Best Buy,-76.1,Orlando FL,32816,5096.28,0
2036-11-08,21:25:00,Best Buy,-65.19,Winter Park FL,32789,5031.09,0
2036-11-09,12:44:00,Subway,-31.72,Orlando FL,32816,4999.37,0
2036-11-10,17:32:00,Dollar Tree,-49.28,Winter Park FL,32789,4950.09,0
2036-11-10,16:45:00,Midas,-158.58,Orlando FL,32816,4791.51,0
2036-11-10,08:23:00,Whole Foods,-61.55,Orlando FL,32816,4729.96,0
2036-11-11,16:21:00,Walmart,-59.04,Winter Park FL,32789,4670.92,0
2036-11-12,08:34:00,Subway,-16.72,Orlando FL,32816,4654.2,0
2036-11-12,20:10:00,Impractical Jokers,-430.98,Groton CT,42024,4223.22,1
2036-11-13,19:44:00,Concert Tickets,-35.63,Winter Park FL,32789,4618.57,0
2036-11-13,06:23:00,Impractical Jokers,-1198.23,Honolulu HI,78214,3420.34,1
2036-11-14,15:46:00,Impractical Jokers,-1977.99,Pyongyang NK,14497,2640.58,1
2036-11-14,08:35:00,Jiffy Lube,-194.49,Oviedo FL,32765,4424.08,0
2036-11-14,15:27:00,Burger King,-33.98,Orlando FL,32816,4390.1,0
2036-11-14,10:42:00,Subway,-20.37,Winter Park FL,32789,4369.73,0
2036-11-15,03:58:00,Pawn Stars,-2898.34,Honolulu HI,22984,1471.39,1
2036-11-15,17:59:00,Trader Joe's,-95.06,Oviedo FL,32765,4274.67,0
2036-11-17,08:00:00,Paycheck,2000.0,Oviedo FL,32765,6274.67,0
2036-11-18,15:43:00,Monster Energy,-1696.94,Charleston SC,12325,4577.73,1
2036-11-18,17:13:00,Subway,-27.64,Oviedo FL,32765,6247.03,0
2036-11-19,19:13:00,Best Buy,-226.45,Oviedo FL,32765,6020.58,0
2036-11-20,09:24:00,Best Buy,-260.77,Oviedo FL,32765,5759.81,0
2036-11-20,16:52:00,Target,-68.74,Oviedo FL,32765,5691.07,0
2036-11-23,14:56:00,Whole Foods,-91.32,Oviedo FL,32765,5599.75,0
2036-11-23,12:04:00,McDonald's,-25.28,Orlando FL,32816,5574.47,0
2036-11-24,13:22:00,Concert Tickets,-16.94,Orlando FL,32816,5557.53,0
2036-11-24,08:02:00,Burger King,-19.11,Orlando FL,32816,5538.42,0
2036-11-25,19:14:00,McDonald's,-35.08,Orlando FL,32816,5503.34,0
2036-11-26,10:57:00,Burger King,-39.93,Oviedo FL,32765,5463.41,0
2036-11-26,20:33:00,Burger King,-5.05,Oviedo FL,32765,5458.36,0
2036-11-28,09:23:00,Pep Boys,-91.76,Orlando FL,32816,5366.6,0
2036-11-28,19:24:00,Target,-113.36,Orlando FL,32816,5253.24,0
2036-11-28,20:36:00,Publix,-35.69,Oviedo FL,32765,5217.55,0
2036-11-29,16:07:00,Jiffy Lube,-182.19,Winter Park FL,32789,5035.36,0
2036-11-29,09:41:00,Chevron,-20.98,Orlando FL,32816,5014.38,0
2036-11-29,17:07:00,Shell,-21.98,Oviedo FL,32765,4992.4,0
2036-11-30,18:06:00,Dollar Tree,-34.13,Winter Park FL,32789,4958.27,0
2036-12-01,08:00:00,Paycheck,2000.0,Oviedo FL,32765,6958.27,0
2036-12-01,09:00:00,Rent,-960.0,Oviedo FL,32765,5998.27,0
2036-12-01,09:00:00,Insurance,-197.46,Oviedo FL,32765,5800.81,0
2036-12-01,09:00:00,Car,-300.0,Oviedo FL,32765,5500.81,0
2036-12-01,19:57:00,Best Buy,-33.7,Oviedo FL,32765,5467.11,0
2036-12-01,21:27:00,Movie Theater,-30.86,Winter Park FL,32789,5436.25,0
2036-12-02,12:28:00,Subway,-27.39,Orlando FL,32816,5408.86,0
2036-12-02,19:04:00,McDonald's,-13.19,Oviedo FL,32765,5395.67,0
2036-12-03,10:33:00,Walmart,-118.95,Oviedo FL,32765,5276.72,0
2036-12-04,19:39:00,Pawn Stars,-2891.91,Groton CT,35835,2384.81,1
2036-12-04,10:25:00,Starbucks,-37.48,Orlando FL,32816,5239.24,0
2036-12-05,16:31:00,Walgreens,-16.69,Winter Park FL,32789,5222.55,0
2036-12-05,13:12:00,Burger King,-5.74,Winter Park FL,32789,5216.81,0
2036-12-05,08:03:00,Starbucks,-39.84,Winter Park FL,32789,5176.97,0
2036-12-07,09:00:00,Spotify,-11.99,Oviedo FL,32765,5164.98,0
2036-12-07,09:00:00,Internet,-70.89,Oviedo FL,32765,5094.09,0
2036-12-07,09:00:00,ChatGPT Plus,-20.0,Oviedo FL,32765,5074.09,0
2036-12-07,17:22:00,Subway,-26.16,Oviedo FL,32765,5047.93,0
2036-12-07,16:48:00,Amusement Park,-13.82,Orlando FL,32816,5034.11,0
2036-12-07,17:48:00,Subway,-23.68,Oviedo FL,32765,5010.43,0
2036-12-11,17:08:00,Shell,-24.32,Orlando FL,32816,4986.11,0
2036-12-11,18:40:00,McDonald's,-10.33,Oviedo FL,32765,4975.78,0
2036-12-11,11:39:00,Best Buy,-33.89,Oviedo FL,32765,4941.89,0
2036-12-12,09:49:00,Starbucks,-24.64,Oviedo FL,32765,4917.25,0
2036-12-13,14:30:00,Whole Foods,-40.36,Winter Park FL,32789,4876.89,0
2036-12-14,20:19:00,Whole Foods,-62.83,Winter Park FL,32789,4814.06,0
2036-12-14,14:37:00,Pawn Stars,-449.24,Pyongyang NK,71936,4364.82,1
2036-12-14,18:34:00,Best Buy,-12.02,Orlando FL,32816,4802.04,0
2036-12-14,21:04:00,Walgreens,-36.38,Oviedo FL,32765,4765.66,0
2036-12-15,08:00:00,Paycheck,2000.0,Oviedo FL,32765,6765.66,0
2036-12-15,08:57:00,Dollar Tree,-58.84,Winter Park FL,32789,6706.82,0
2036-12-17,17:56:00,Netflix,-70.62,Orlando FL,32816,6636.2,0
2036-12-20,21:27:00,Walgreens,-81.21,Orlando FL,32816,6554.99,0
2036-12-20,23:19:00,Accelerators,-2124.23,Honolulu HI,66783,4430.76,1
2036-12-20,18:49:00,Starbucks,-27.62,Orlando FL,32816,6527.37,0
2036-12-20,14:34:00,Shell,-19.79,Orlando FL,32816,6507.58,0
2036-12-21,09:28:00,Exxon,-38.05,Oviedo FL,32765,6469.53,0
2036-12-21,21:21:00,Amazon,-264.45,Orlando FL,32816,6205.08,0
2036-12-23,17:36:00,Starbucks,-21.54,Orlando FL,32816,6183.54,0
2036-12-23,11:45:00,Kroger,-149.47,Orlando FL,32816,6034.07,0
2036-12-24,11:44:00,Walgreens,-47.23,Orlando FL,32816,5986.84,0
2036-12-24,09:56:00,Subway,-5.53,Oviedo FL,32765,5981.31,0
2036-12-24,19:15:00,Concert Tickets,-23.5,Orlando FL,32816,5957.81,0
2036-12-25,08:22:00,Burger King,-7.85,Oviedo FL,32765,5949.96,0
2036-12-25,12:21:00,Paypal,-2366.96,New York NY,53507,3583.0,1
2036-12-26,21:09:00,Target,-21.96,Oviedo FL,32765,5928.0,0
2036-12-27,10:23:00,McDonald's,-39.82,Oviedo FL,32765,5888.18,0
2036-12-27,05:21:00,Impractical Jokers,-2897.76,Charleston SC,89492,2990.42,1
2036-12-27,17:27:00,Subway,-14.79,Winter Park FL,32789,5873.39,0
2036-12-27,18:27:00,CVS,-12.14,Orlando FL,32816,5861.25,0
2036-12-28,21:55:00,Starbucks,-23.87,Winter Park FL,32789,5837.38,0
2036-12-28,13:13:00,Burger King,-22.04,Orlando FL,32816,5815.34,0
2036-12-28,09:49:00,Dollar Tree,-38.59,Orlando FL,32816,5776.75,0
2036-12-29,08:00:00,Paycheck,2000.0,Oviedo FL,32765,7776.75,0
2036-12-29,17:11:00,Starbucks,-78.2,Orlando FL,32816,7698.55,0
2036-12-29,21:39:00,Starbucks,-11.02,Oviedo FL,32765,7687.53,0
2036-12-30,13:45:00,Dollar Tree,-21.82,Orlando FL,32816,7665.71,0
2037-01-01,09:00:00,Rent,-960.0,Oviedo FL,32765,6705.71,0
2037-01-01,09:00:00,Insurance,-197.46,Oviedo FL,32765,6508.25,0
2037-01-01,09:00:00,Car,-300.0,Oviedo FL,32765,6208.25,0
2037-01-01,21:58:00,Subway,-78.3,Winter Park FL,32789,6129.95,0
2037-01-02,11:21:00,Shell,-23.78,Orlando FL,32816,6106.17,0
2037-01-02,18:59:00,Burger King,-31.32,Oviedo FL,32765,6074.85,0
2037-01-02,23:47:00,Pawn Stars,-260.96,Honolulu HI,95299,5813.89,1
2037-01-02,09:12:00,Amusement Park,-55.04,Winter Park FL,32789,6019.81,0
2037-01-03,10:01:00,Pep Boys,-391.1,Winter Park FL,32789,5628.71,0
2037-01-03,00:04:00,Paypal,-1890.78,New York NY,74419,3737.93,1
2037-01-04,16:04:00,Walmart,-122.4,Orlando FL,32816,5506.31,0
2037-01-04,09:18:00,Starbucks,-36.23,Winter Park FL,32789,5470.08,0
2037-01-05,19:47:00,Paypal,-2336.07,Groton CT,56298,3134.01,1
2037-01-05,21:50:00,Exxon,-28.0,Oviedo FL,32765,5442.08,0
2037-01-05,18:23:00,Five Below,-14.62,Orlando FL,32816,5427.46,0
2037-01-07,09:00:00,Spotify,-11.99,Oviedo FL,32765,5415.47,0
2037-01-07,09:00:00,Internet,-70.89,Oviedo FL,32765,5344.58,0
2037-01-07,09:00:00,ChatGPT Plus,-20.0,Oviedo FL,32765,5324.58,0
2037-01-07,12:43:00,Movie Theater,-46.19,Winter Park FL,32789,5278.39,0
2037-01-07,11:09:00,CVS,-13.01,Orlando FL,32816,5265.38,0
2037-01-08,10:39:00,Publix,-79.25,Oviedo FL,32765,5186.13,0
2037-01-08,10:19:00,Whole Foods,-89.65,Oviedo FL,32765,5096.48,0
2037-01-08,04:42:00,Servicenow,-1506.62,Pittsburgh PA,79503,3589.86,1
2037-01-08,08:52:00,BP,-22.35,Oviedo FL,32765,5074.13,0
2037-01-09,08:08:00,Subway,-5.33,Winter Park FL,32789,5068.8,0
2037-01-09,16:09:00,McDonald's,-25.24,Oviedo FL,32765,5043.56,0
2037-01-10,18:26:00,Fat Joe,-663.37,Pittsburgh PA,46589,4380.19,1
2037-01-10,11:03:00,Walmart,-58.74,Orlando FL,32816,4984.82,0
2037-01-11,15:10:00,Shell,-25.46,Oviedo FL,32765,4959.36,0
2037-01-11,10:18:00,Whole Foods,-78.89,Oviedo FL,32765,4880.47,0
2037-01-12,08:00:00,Paycheck,2000.0,Oviedo FL,32765,6880.47,0
2037-01-12,19:15:00,Walmart,-97.12,Winter Park FL,32789,6783.35,0
2037-01-13,14:30:00,Amazon,-69.3,Oviedo FL,32765,6714.05,0
2037-01-13,08:18:00,Amazon,-68.22,Oviedo FL,32765,6645.83,0
2037-01-15,00:48:00,IBM,-1625.54,Honolulu HI,65054,5020.29,1
2037-01-15,19:24:00,McDonald's,-60.61,Orlando FL,32816,6585.22,0
2037-01-16,17:25:00,Walgreens,-50.48,Oviedo FL,32765,6534.74,0
2037-01-16,17:15:00,McDonald's,-27.34,Winter Park FL,32789,6507.4,0
2037-01-16,11:59:00,Burger King,-33.54,Winter Park FL,32789,6473.86,0
2037-01-17,18:03:00,Amusement Park,-84.12,Oviedo FL,32765,6389.74,0
2037-01-17,20:26:00,Concert Tickets,-33.62,Oviedo FL,32765,6356.12,0
2037-01-17,18:39:00,Target,-227.0,Orlando FL,32816,6129.12,0
2037-01-18,12:36:00,Accelerators,-1738.7,Mexico City MC,11265,4390.42,1
2037-01-18,17:38:00,McDonald's,-54.24,Oviedo FL,32765,6074.88,0
2037-01-18,12:43:00,Target,-190.58,Winter Park FL,32789,5884.3,0
2037-01-18,14:22:00,Subway,-38.69,Winter Park FL,32789,5845.61,0
2037-01-20,14:11:00,Impractical Jokers,-1410.46,Charleston SC,38823,4435.15,1
2037-01-21,20:57:00,Burger King,-10.03,Orlando FL,32816,5835.58,0
2037-01-21,08:15:00,Amazon,-113.54,Orlando FL,32816,5722.04,0
2037-01-21,16:04:00,Dollar Tree,-18.54,Oviedo FL,32765,5703.5,0
2037-01-22,19:53:00,Target,-29.61,Orlando FL,32816,5673.89,0
2037-01-24,17:30:00,Onlyfans,-2354.8,Honolulu HI,59773,3319.09,1
2037-01-24,15:09:00,Kroger,-54.38,Orlando FL,32816,5619.51,0
2037-01-24,18:43:00,Walmart,-97.38,Oviedo FL,32765,5522.13,0
2037-01-24,02:46:00,Impractical Jokers,-1749.4,Tokyo JP,22697,3772.73,1
2037-01-25,08:39:00,Five Below,-21.49,Oviedo FL,32765,5500.64,0
2037-01-25,08:52:00,Accelerators,-1719.65,Anchorage AL,80466,3780.99,1
2037-01-25,11:54:00,Dollar Tree,-43.38,Winter Park FL,32789,5457.26,0
2037-01-25,02:09:00,Lockheed Martin,-2662.49,Groton CT,95948,2794.77,1
2037-01-26,08:00:00,Paycheck,2000.0,Oviedo FL,32765,7457.26,0
2037-01-26,18:33:00,Walmart,-198.14,Winter Park FL,32789,7259.12,0
2037-01-26,19:57:00,Trader Joe's,-146.48,Oviedo FL,32765,7112.64,0
2037-01-26,02:10:00,Accelerators,-2306.06,Anchorage AL,32028,4806.58,1
2037-01-26,20:12:00,BP,-45.5,Orlando FL,32816,7067.14,0
2037-01-27,16:59:00,Dollar Tree,-38.22,Orlando FL,32816,7028.92,0
2037-01-27,11:58:00,Subway,-10.33,Winter Park FL,32789,7018.59,0
2037-01-28,10:49:00,Kroger,-105.95,Oviedo FL,32765,6912.64,0
2037-01-28,09:52:00,Subway,-22.11,Orlando FL,32816,6890.53,0
2037-01-30,20:41:00,Starbucks,-54.9,Orlando FL,32816,6835.63,0
2037-01-30,10:08:00,Lockheed Martin,-2174.82,Groton CT,66475,4660.81,1
2037-01-31,16:25:00,Concert Tickets,-67.46,Orlando FL,32816,6768.17,0
2037-01-31,10:13:00,Publix,-91.77,Orlando FL,32816,6676.4,0
2037-02-01,09:00:00,Rent,-960.0,Oviedo FL,32765,5716.4,0
2037-02-01,09:00:00,Insurance,-197.46,Oviedo FL,32765,5518.94,0
2037-02-01,09:00:00,Car,-300.0,Oviedo FL,32765,5218.94,0
2037-02-02,15:37:00,Burger King,-23.6,Winter Park FL,32789,5195.34,0
2037-02-02,22:01:00,Fat Joe,-2653.45,London EN,45240,2541.89,1
2037-02-02,14:38:00,Chevron,-10.84,Oviedo FL,32765,5184.5,0
2037-02-02,12:32:00,Fat Joe,-1084.42,Pittsburgh PA,42679,4100.08,1
2037-02-02,12:26:00,Starbucks,-20.27,Oviedo FL,32765,5164.23,0
2037-02-02,15:44:00,Impractical Jokers,-2177.92,Honolulu HI,54737,2986.31,1
2037-02-03,15:52:00,Whole Foods,-40.81,Oviedo FL,32765,5123.42,0
2037-02-05,17:22:00,Dollar Tree,-44.86,Orlando FL,32816,5078.56,0
2037-02-05,18:44:00,Whole Foods,-87.13,Winter Park FL,32789,4991.43,0
2037-02-05,08:12:00,Starbucks,-18.66,Oviedo FL,32765,4972.77,0
2037-02-06,11:16:00,McDonald's,-19.86,Winter Park FL,32789,4952.91,0
2037-02-07,09:00:00,Spotify,-11.99,Oviedo FL,32765,4940.92,0
2037-02-07,09:00:00,Internet,-70.89,Oviedo FL,32765,4870.03,0
2037-02-07,09:00:00,ChatGPT Plus,-20.0,Oviedo FL,32765,4850.03,0
2037-02-08,17:55:00,Burger King,-35.38,Oviedo FL,32765,4814.65,0
2037-02-08,13:38:00,Burger King,-5.88,Oviedo FL,32765,4808.77,0
2037-02-08,17:41:00,Walgreens,-21.1,Oviedo FL,32765,4787.67,0
2037-02-09,08:00:00,Paycheck,2000.0,Oviedo FL,32765,6787.67,0
2037-02-09,14:42:00,Starbucks,-62.48,Orlando FL,32816,6725.19,0
2037-02-09,18:08:00,Subway,-50.7,Oviedo FL,32765,6674.49,0
2037-02-09,00:17:00,Monster Energy,-2134.47,Pittsburgh PA,93537,4540.02,1
2037-02-11,14:39:00,Amusement Park,-76.58,Oviedo FL,32765,6597.91,0
2037-02-12,21:25:00,Burger King,-26.16,Orlando FL,32816,6571.75,0
2037-02-12,15:51:00,Walmart,-207.86,Orlando FL,32816,6363.89,0
2037-02-12,15:57:00,IBM,-1549.51,Los Angeles CA,50048,4814.38,1
2037-02-14,16:04:00,Netflix,-100.01,Orlando FL,32816,6263.88,0
2037-02-14,21:42:00,BP,-32.42,Winter Park FL,32789,6231.46,0
2037-02-15,11:06:00,Impractical Jokers,-685.98,Mexico City MC,39339,5545.48,1
2037-02-15,08:05:00,Walmart,-167.9,Orlando FL,32816,6063.56,0
2037-02-15,15:29:00,Subway,-37.79,Winter Park FL,32789,6025.77,0
2037-02-15,21:43:00,IBM,-1002.91,Anchorage AL,57261,5022.86,1
2037-02-16,14:13:00,Pawn Stars,-1076.87,Charleston SC,15579,4948.9,1
2037-02-16,12:39:00,Subway,-58.94,Orlando FL,32816,5966.83,0
2037-02-17,14:23:00,Subway,-31.15,Winter Park FL,32789,5935.68,0
2037-02-17,09:41:00,Starbucks,-14.76,Winter Park FL,32789,5920.92,0
2037-02-17,15:55:00,Starbucks,-7.18,Oviedo FL,32765,5913.74,0
2037-02-18,18:04:00,Pawn Stars,-919.68,Mexico City MC,11967,4994.06,1
2037-02-18,08:00:00,Midas,-136.38,Oviedo FL,32765,5777.36,0
2037-02-18,11:11:00,Whole Foods,-76.98,Oviedo FL,32765,5700.38,0
2037-02-18,19:51:00,Best Buy,-29.32,Winter Park FL,32789,5671.06,0
2037-02-19,20:55:00,Lockheed Martin,-1848.1,Honolulu HI,61180,3822.96,1
2037-02-19,10:51:00,Publix,-90.3,Oviedo FL,32765,5580.76,0
2037-02-20,20:48:00,Whole Foods,-54.12,Oviedo FL,32765,5526.64,0
2037-02-20,11:11:00,Pep Boys,-179.24,Winter Park FL,32789,5347.4,0
2037-02-20,13:57:00,Walgreens,-19.21,Orlando FL,32816,5328.19,0
2037-02-21,18:45:00,McDonald's,-22.86,Winter Park FL,32789,5305.33,0
2037-02-22,11:49:00,Amazon,-103.13,Orlando FL,32816,5202.2,0
2037-02-22,13:44:00,Walmart,-75.2,Winter Park FL,32789,5127.0,0
2037-02-22,11:01:00,Amazon,-51.41,Oviedo FL,32765,5075.59,0
2037-02-23,08:00:00,Paycheck,2000.0,Oviedo FL,32765,7075.59,0
2037-02-24,16:03:00,Fraud,-877.32,Tokyo JP,99968,6198.27,1
2037-02-26,08:14:00,Impractical Jokers,-2875.85,Groton CT,85852,4199.74,1
2037-02-26,12:30:00,BP,-20.6,Oviedo FL,32765,7054.99,0
2037-02-26,11:00:00,Jiffy Lube,-324.59,Orlando FL,32816,6730.4,0
2037-02-26,17:52:00,Monster Energy,-1830.14,London EN,63520,4900.26,1
2037-02-26,09:03:00,Amazon,-154.84,Orlando FL,32816,6575.56,0
2037-02-28,04:31:00,Magic the Gathering,-2768.93,Groton CT,14552,3806.63,1
2037-02-28,16:14:00,Target,-202.09,Oviedo FL,32765,6373.47,0
2037-03-01,09:00:00,Rent,-960.0,Oviedo FL,32765,5413.47,0
2037-03-01,09:00:00,Insurance,-197.46,Oviedo FL,32765,5216.01,0
2037-03-01,09:00:00,Car,-300.0,Oviedo FL,32765,4916.01,0
2037-03-01,11:32:00,McDonald's,-16.2,Winter Park FL,32789,4899.81,0
2037-03-01,19:22:00,Subway,-7.56,Winter Park FL,32789,4892.25,0
2037-03-01,17:58:00,Subway,-22.0,Oviedo FL,32765,4870.25,0
2037-03-03,11:12:00,CVS,-11.98,Oviedo FL,32765,4858.27,0
2037-03-04,11:05:00,Amazon,-140.3,Orlando FL,32816,4717.97,0
2037-03-04,20:34:00,Target,-112.16,Oviedo FL,32765,4605.81,0
2037-03-06,14:34:00,Starbucks,-15.87,Orlando FL,32816,4589.94,0
2037-03-06,20:46:00,Target,-105.46,Winter Park FL,32789,4484.48,0
2037-03-07,09:00:00,Spotify,-11.99,Oviedo FL,32765,4472.49,0
2037-03-07,09:00:00,Internet,-70.89,Oviedo FL,32765,4401.6,0
2037-03-07,09:00:00,ChatGPT Plus,-20.0,Oviedo FL,32765,4381.6,0
2037-03-07,18:04:00,Trader Joe's,-33.24,Winter Park FL,32789,4348.36,0
2037-03-07,17:07:00,Kroger,-78.09,Orlando FL,32816,4270.27,0
2037-03-07,12:09:00,McDonald's,-13.73,Oviedo FL,32765,4256.54,0
2037-03-08,18:05:00,Best Buy,-82.85,Winter Park FL,32789,4173.69,0
2037-03-08,18:08:00,Impractical Jokers,-2255.87,Pittsburgh PA,83247,1917.82,1
2037-03-08,16:07:00,CVS,-35.83,Orlando FL,32816,4137.86,0
2037-03-08,21:51:00,Burger King,-8.63,Winter Park FL,32789,4129.23,0
2037-03-09,08:00:00,Paycheck,2000.0,Oviedo FL,32765,6129.23,0
2037-03-09,16:53:00,Amusement Park,-104.26,Oviedo FL,32765,6024.97,0
2037-03-10,18:39:00,BP,-29.88,Orlando FL,32816,5995.09,0
2037-03-10,11:10:00,McDonald's,-7.97,Oviedo FL,32765,5987.12,0
2037-03-10,08:35:00,Best Buy,-137.07,Orlando FL,32816,5850.05,0
2037-03-11,15:58:00,Concert Tickets,-43.98,Orlando FL,32816,5806.07,0
2037-03-11,04:58:00,Paypal,-1044.51,London EN,67172,4761.56,1
2037-03-12,22:09:00,Monster Energy,-2185.99,Mexico City MC,26121,3620.08,1
2037-03-12,10:44:00,McDonald's,-17.15,Winter Park FL,32789,5788.92,0
2037-03-12,10:43:00,Subway,-8.5,Oviedo FL,32765,5780.42,0
2037-03-12,15:40:00,Trader Joe's,-87.57,Oviedo FL,32765,5692.85,0
2037-03-12,09:20:00,Monster Energy,-1774.46,New York NY,28113,3918.39,1
2037-03-13,14:16:00,IBM,-2017.13,Los Angeles CA,57795,3675.72,1
2037-03-13,15:05:00,Dollar Tree,-28.1,Orlando FL,32816,5664.75,0
2037-03-13,20:02:00,Trader Joe's,-63.32,Oviedo FL,32765,5601.43,0
2037-03-13,09:21:00,Best Buy,-141.06,Orlando FL,32816,5460.37,0
2037-03-16,08:16:00,Starbucks,-29.47,Winter Park FL,32789,5430.9,0
2037-03-16,20:40:00,Monster Energy,-2557.8,New York NY,77785,2873.1,1
2037-03-16,12:20:00,BP,-11.55,Orlando FL,32816,5419.35,0
2037-03-18,13:04:00,Paypal,-366.91,Honolulu HI,95186,5052.44,1
2037-03-18,10:42:00,Dollar Tree,-9.76,Orlando FL,32816,5409.59,0
2037-03-18,11:41:00,Starbucks,-33.46,Orlando FL,32816,5376.13,0
2037-03-19,13:14:00,Walmart,-45.41,Winter Park FL,32789,5330.72,0
2037-03-19,13:20:00,Amusement Park,-32.18,Winter Park FL,32789,5298.54,0
2037-03-19,12:47:00,Amazon,-68.24,Winter Park FL,32789,5230.3,0
2037-03-20,18:56:00,Five Below,-47.79,Winter Park FL,32789,5182.51,0
2037-03-21,18:30:00,Target,-144.01,Orlando FL,32816,5038.5,0
2037-03-21,07:35:00,Impractical Jokers,-168.7,Tokyo JP,40620,4869.8,1
2037-03-21,17:57:00,Walgreens,-30.24,Winter Park FL,32789,5008.26,0
2037-03-21,14:00:00,CVS,-26.89,Winter Park FL,32789,4981.37,0
2037-03-22,09:19:00,Burger King,-16.67,Oviedo FL,32765,4964.7,0
2037-03-22,10:55:00,Midas,-51.62,Orlando FL,32816,4913.08,0
2037-03-23,08:00:00,Paycheck,2000.0,Oviedo FL,32765,6913.08,0
2037-03-25,14:38:00,Amusement Park,-41.53,Orlando FL,32816,6871.55,0
2037-03-25,11:34:00,Amusement Park,-113.78,Winter Park FL,32789,6757.77,0
2037-03-26,19:24:00,Starbucks,-52.78,Oviedo FL,32765,6704.99,0
2037-03-26,08:02:00,Kroger,-65.69,Winter Park FL,32789,6639.3,0
2037-03-27,12:20:00,Starbucks,-43.38,Oviedo FL,32765,6595.92,0
2037-03-27,09:06:00,Subway,-24.08,Winter Park FL,32789,6571.84,0
2037-03-27,08:40:00,Amusement Park,-111.01,Oviedo FL,32765,6460.83,0
2037-03-28,19:16:00,Walgreens,-90.96,Oviedo FL,32765,6369.87,0
2037-03-28,00:10:00,Onlyfans,-2405.29,Los Angeles CA,44477,3964.58,1
2037-03-28,17:07:00,Pep Boys,-122.44,Orlando FL,32816,6247.43,0
2037-03-28,10:35:00,Starbucks,-22.64,Orlando FL,32816,6224.79,0
2037-03-29,13:13:00,Walgreens,-34.58,Winter Park FL,32789,6190.21,0
2037-03-30,19:19:00,Walmart,-50.66,Winter Park FL,32789,6139.55,0
2037-03-30,09:15:00,Subway,-23.29,Winter Park FL,32789,6116.26,0
2037-03-31,19:36:00,McDonald's,-35.72,Winter Park FL,32789,6080.54,0
2037-03-31,16:49:00,Fraud,-1198.47,Pittsburgh PA,22926,4882.07,1
2037-03-31,20:36:00,Subway,-73.0,Winter Park FL,32789,6007.54,0
2037-04-01,09:00:00,Rent,-960.0,Oviedo FL,32765,5047.54,0
2037-04-01,09:00:00,Insurance,-197.46,Oviedo FL,32765,4850.08,0
2037-04-01,09:00:00,Car,-300.0,Oviedo FL,32765,4550.08,0
2037-04-01,14:18:00,McDonald's,-5.7,Oviedo FL,32765,4544.38,0
2037-04-01,18:50:00,Subway,-34.85,Oviedo FL,32765,4509.53,0
2037-04-01,13:41:00,Subway,-32.39,Winter Park FL,32789,4477.14,0
2037-04-02,16:26:00,Target,-17.66,Winter Park FL,32789,4459.48,0
2037-04-02,20:23:00,Shell,-17.94,Oviedo FL,32765,4441.54,0
2037-04-05,15:35:00,Subway,-34.88,Orlando FL,32816,4406.66,0
2037-04-05,11:39:00,Dollar Tree,-24.52,Orlando FL,32816,4382.14,0
2037-04-05,08:17:00,McDonald's,-7.17,Oviedo FL,32765,4374.97,0
2037-04-06,08:00:00,Paycheck,2000.0,Oviedo FL,32765,6374.97,0
2037-04-06,08:30:00,Starbucks,-29.59,Oviedo FL,32765,6345.38,0
2037-04-06,20:58:00,Starbucks,-73.26,Winter Park FL,32789,6272.12,0
2037-04-07,09:00:00,Spotify,-11.99,Oviedo FL,32765,6260.13,0
2037-04-07,09:00:00,Internet,-70.89,Oviedo FL,32765,6189.24,0
2037-04-07,09:00:00,ChatGPT Plus,-20.0,Oviedo FL,32765,6169.24,0
2037-04-09,19:03:00,Amusement Park,-96.39,Oviedo FL,32765,6072.85,0
2037-04-09,15:25:00,Shell,-54.59,Orlando FL,32816,6018.26,0
2037-04-09,10:03:00,Walgreens,-92.42,Oviedo FL,32765,5925.84,0
2037-04-10,16:07:00,Best Buy,-121.23,Winter Park FL,32789,5804.61,0
2037-04-11,21:32:00,McDonald's,-9.71,Winter Park FL,32789,5794.9,0
2037-04-11,18:02:00,Five Below,-38.35,Orlando FL,32816,5756.55,0
2037-04-11,19:07:00,Trader Joe's,-37.78,Orlando FL,32816,5718.77,0
2037-04-13,19:24:00,BP,-11.1,Winter Park FL,32789,5707.67,0
2037-04-13,03:41:00,Accelerators,-2004.17,Honolulu HI,18226,3703.5,1
2037-04-17,13:17:00,CVS,-6.43,Orlando FL,32816,5701.24,0
2037-04-17,21:41:00,Kroger,-78.02,Orlando FL,32816,5623.22,0
2037-04-17,14:57:00,Publix,-46.09,Orlando FL,32816,5577.13,0
2037-04-18,21:23:00,Walgreens,-32.82,Winter Park FL,32789,5544.31,0
2037-04-18,09:01:00,Subway,-24.68,Winter Park FL,32789,5519.63,0
2037-04-19,21:52:00,Walmart,-143.95,Oviedo FL,32765,5375.68,0
2037-04-19,13:43:00,Midas,-195.69,Orlando FL,32816,5179.99,0
2037-04-19,21:59:00,Shell,-27.69,Oviedo FL,32765,5152.3,0
2037-04-20,08:00:00,Paycheck,2000.0,Oviedo FL,32765,7152.3,0
2037-04-20,13:17:00,Kroger,-187.5,Orlando FL,32816,6964.8,0
2037-04-20,11:37:00,Exxon,-56.89,Oviedo FL,32765,6907.91,0
2037-04-20,14:24:00,Starbucks,-74.48,Orlando FL,32816,6833.43,0
2037-04-22,13:32:00,Dollar Tree,-26.4,Oviedo FL,32765,6807.03,0
2037-04-23,03:20:00,Pawn Stars,-326.26,Los Angeles CA,78257,6480.77,1
2037-04-23,17:22:00,Burger King,-60.96,Oviedo FL,32765,6746.07,0
2037-04-23,19:59:00,Impractical Jokers,-1115.72,Pyongyang NK,42747,5630.35,1
2037-04-24,18:14:00,IBM,-2800.44,Mexico City MC,85651,3945.63,1
2037-04-25,11:47:00,Burger King,-11.78,Winter Park FL,32789,6734.29,0
2037-04-25,16:09:00,Amusement Park,-64.01,Winter Park FL,32789,6670.28,0
2037-04-26,08:14:00,Kroger,-158.56,Winter Park FL,32789,6511.72,0
2037-04-27,19:37:00,Publix,-195.05,Winter Park FL,32789,6316.67,0
2037-04-27,21:31:00,Midas,-262.49,Orlando FL,32816,6054.18,0
2037-04-27,08:10:00,IBM,-1362.83,Groton CT,94986,4691.35,1
2037-04-27,18:33:00,McDonald's,-25.79,Winter Park FL,32789,6028.39,0
2037-04-28,15:29:00,Shell,-41.23,Oviedo FL,32765,5987.16,0
2037-04-28,21:33:00,Best Buy,-33.41,Orlando FL,32816,5953.75,0
2037-04-28,09:20:00,Trader Joe's,-80.54,Oviedo FL,32765,5873.21,0
2037-04-30,12:10:00,Walmart,-100.57,Orlando FL,32816,5772.64,0
2037-05-01,09:00:00,Rent,-960.0,Oviedo FL,32765,4812.64,0
2037-05-01,09:00:00,Insurance,-197.46,Oviedo FL,32765,4615.18,0
2037-05-01,09:00:00,Car,-300.0,Oviedo FL,32765,4315.18,0
2037-05-01,21:56:00,Accelerators,-2529.82,Pyongyang NK,49682,1785.36,1
2037-05-01,08:00:00,BP,-12.76,Orlando FL,32816,4302.42,0
2037-05-01,12:28:00,Best Buy,-66.29,Orlando FL,32816,4236.13,0
2037-05-01,06:29:00,Monster Energy,-2104.67,Anchorage AL,53344,2131.46,1
2037-05-02,17:55:00,CVS,-15.61,Winter Park FL,32789,4220.52,0
2037-05-02,21:35:00,Servicenow,-235.34,Charleston SC,79337,3985.18,1
2037-05-02,14:16:00,Walmart,-117.84,Oviedo FL,32765,4102.68,0
2037-05-04,08:00:00,Paycheck,2000.0,Oviedo FL,32765,6102.68,0
2037-05-04,21:00:00,Starbucks,-28.74,Orlando FL,32816,6073.94,0
2037-05-05,16:39:00,Subway,-67.22,Winter Park FL,32789,6006.72,0
2037-05-05,08:45:00,Exxon,-26.16,Winter Park FL,32789,5980.56,0
2037-05-05,18:24:00,BP,-19.97,Winter Park FL,32789,5960.59,0
2037-05-06,19:39:00,Jiffy Lube,-184.41,Oviedo FL,32765,5776.18,0
2037-05-06,14:01:00,Amazon,-98.82,Oviedo FL,32765,5677.36,0
2037-05-06,09:29:00,McDonald's,-34.15,Orlando FL,32816,5643.21,0
2037-05-07,09:00:00,Spotify,-11.99,Oviedo FL,32765,5631.22,0
2037-05-07,09:00:00,Internet,-70.89,Oviedo FL,32765,5560.33,0
2037-05-07,09:00:00,ChatGPT Plus,-20.0,Oviedo FL,32765,5540.33,0
2037-05-07,18:13:00,Burger King,-12.4,Winter Park FL,32789,5527.93,0
2037-05-07,21:12:00,Jiffy Lube,-170.31,Oviedo FL,32765,5357.62,0
2037-05-07,16:43:00,Accelerators,-954.39,Honolulu HI,54558,4403.23,1
2037-05-07,17:56:00,Jiffy Lube,-186.73,Oviedo FL,32765,5170.89,0
2037-05-08,08:38:00,Starbucks,-22.41,Orlando FL,32816,5148.48,0
2037-05-08,08:48:00,Paypal,-772.33,Los Angeles CA,67138,4376.15,1
2037-05-08,17:42:00,McDonald's,-30.19,Oviedo FL,32765,5118.29,0
2037-05-09,21:14:00,Starbucks,-31.93,Oviedo FL,32765,5086.36,0
2037-05-09,11:34:00,Paypal,-489.64,Pittsburgh PA,63798,4596.72,1
2037-05-09,20:02:00,Kroger,-30.07,Winter Park FL,32789,5056.29,0
2037-05-09,01:15:00,Servicenow,-394.25,New York NY,13469,4662.04,1
2037-05-09,16:36:00,Starbucks,-34.36,Winter Park FL,32789,5021.93,0
2037-05-11,14:32:00,Chevron,-28.26,Orlando FL,32816,4993.67,0
2037-05-13,10:06:00,Five Below,-17.41,Oviedo FL,32765,4976.26,0
2037-05-14,12:36:00,Concert Tickets,-59.69,Orlando FL,32816,4916.57,0
2037-05-15,21:43:00,Starbucks,-19.35,Orlando FL,32816,4897.22,0
2037-05-15,14:54:00,Starbucks,-20.05,Winter Park FL,32789,4877.17,0
2037-05-16,10:16:00,Amusement Park,-48.24,Winter Park FL,32789,4828.93,0
2037-05-16,20:15:00,Midas,-102.86,Oviedo FL,32765,4726.07,0
2037-05-16,18:07:00,Starbucks,-21.02,Oviedo FL,32765,4705.05,0
2037-05-17,17:57:00,Chevron,-18.25,Oviedo FL,32765,4686.8,0
2037-05-18,08:00:00,Paycheck,2000.0,Oviedo FL,32765,6686.8,0
2037-05-18,11:42:00,Starbucks,-67.95,Oviedo FL,32765,6618.85,0
2037-05-18,16:58:00,Concert Tickets,-85.57,Oviedo FL,32765,6533.28,0
2037-05-19,14:45:00,Chevron,-29.88,Winter Park FL,32789,6503.4,0
2037-05-19,17:25:00,Subway,-35.86,Oviedo FL,32765,6467.54,0
2037-05-20,07:49:00,Paypal,-723.21,Pittsburgh PA,50944,5744.33,1
2037-05-20,18:17:00,Subway,-14.28,Orlando FL,32816,6453.26,0
2037-05-20,19:45:00,Exxon,-49.63,Orlando FL,32816,6403.63,0
2037-05-21,13:37:00,Amusement Park,-59.65,Orlando FL,32816,6343.98,0
2037-05-21,19:40:00,Burger King,-49.59,Oviedo FL,32765,6294.39,0
2037-05-21,19:59:00,Whole Foods,-168.77,Oviedo FL,32765,6125.62,0
2037-05-21,06:45:00,Monster Energy,-2734.79,Los Angeles CA,85463,3390.83,1
2037-05-22,11:56:00,McDonald's,-69.44,Winter Park FL,32789,6056.18,0
2037-05-22,10:11:00,Exxon,-34.64,Oviedo FL,32765,6021.54,0
2037-05-23,02:31:00,Accelerators,-2237.44,Pyongyang NK,82862,3784.1,1
2037-05-25,22:56:00,Pawn Stars,-223.24,Pyongyang NK,27962,5798.3,1
2037-05-25,20:53:00,Kroger,-95.13,Oviedo FL,32765,5926.41,0
2037-05-25,12:45:00,Exxon,-18.53,Orlando FL,32816,5907.88,0
2037-05-26,17:07:00,Burger King,-7.26,Winter Park FL,32789,5900.62,0
2037-05-26,12:30:00,Amazon,-15.86,Winter Park FL,32789,5884.76,0
2037-05-27,17:55:00,BP,-26.53,Oviedo FL,32765,5858.23,0
2037-05-27,18:40:00,CVS,-21.52,Orlando FL,32816,5836.71,0
2037-05-27,16:29:00,BP,-17.28,Winter Park FL,32789,5819.43,0
2037-05-28,20:09:00,Whole Foods,-78.38,Winter Park FL,32789,5741.05,0
2037-05-28,23:48:00,IBM,-2344.75,Honolulu HI,82100,3396.3,1
2037-05-28,18:48:00,Trader Joe's,-68.82,Winter Park FL,32789,5672.23,0
2037-05-28,12:17:00,Amazon,-58.54,Winter Park FL,32789,5613.69,0
2037-05-29,01:13:00,Lockheed Martin,-2610.54,Mexico City MC,93526,3003.15,1
2037-05-29,10:33:00,Exxon,-17.73,Winter Park FL,32789,5595.96,0
2037-05-30,12:43:00,Subway,-29.06,Orlando FL,32816,5566.9,0
2037-05-30,14:42:00,BP,-16.96,Oviedo FL,32765,5549.94,0
2037-05-30,19:10:00,Midas,-194.78,Winter Park FL,32789,5355.16,0
2037-05-31,08:59:00,Servicenow,-2471.91,Charleston SC,41403,2883.25,1
2037-05-31,12:40:00,McDonald's,-14.5,Winter Park FL,32789,5340.66,0
2037-05-31,17:41:00,Subway,-5.43,Winter Park FL,32789,5335.23,0
